timestamp,socket_0,socket_0_TSENT,socket_0_TSENTSEC,socket_0_TTHSENTSEC,socket_0_TTHSENT,socket_status_0,TMSG,TOSEND,SENT,TMSGSEC,TTHMSGSEC,AVG,THtotalsent,ackSent,state,globalState,THloss
1,0,0,0,0.00,0.00,2,0,0,0,0,0.00,0.00,0.00,0,0.00,8.00,0.00
2,0,0,0,0.00,0.00,2,0,0,0,0,0.00,0.00,0.00,0,0.00,8.00,0.00
3,0,0,0,0.00,0.00,2,0,0,0,0,0.00,0.00,0.00,0,0.00,8.00,0.00
4,0,0,0,0.00,0.00,2,0,0,0,0,0.00,0.00,0.00,0,0.00,8.00,0.00
5,0,0,0,0.00,0.00,2,0,0,0,0,0.00,0.00,0.00,0,0.00,8.00,0.00
6,0,0,0,0.00,0.00,2,0,0,0,0,0.00,0.00,0.00,0,0.00,8.00,0.00
7,0,0,0,0.00,0.00,2,0,0,0,0,0.00,0.00,0.00,0,0.00,8.00,0.00
8,0,0,0,0.00,0.00,2,0,0,0,0,0.00,0.00,0.00,0,0.00,8.00,0.00
9,0,0,0,0.00,0.00,2,0,0,0,0,0.00,0.00,0.00,0,0.00,8.00,0.00
10,0,0,0,0.00,0.00,2,0,0,0,0,0.00,0.00,0.00,0,0.00,8.00,0.00
11,0,0,0,0.00,0.00,2,0,0,0,0,0.00,0.00,0.00,0,0.00,8.00,0.00
12,0,0,0,0.00,0.00,2,0,0,0,0,0.00,0.00,0.00,0,0.00,8.00,0.00
13,0,0,0,0.00,0.00,2,0,0,0,0,0.00,0.00,0.00,0,0.00,8.00,0.00
14,0,0,0,0.00,0.00,2,0,0,0,0,0.00,0.00,0.00,0,0.00,8.00,0.00
15,0,0,0,0.00,0.00,2,0,0,0,0,0.00,0.00,0.00,0,0.00,8.00,0.00
16,0,0,0,0.00,0.00,2,0,0,0,0,0.00,0.00,0.00,0,0.00,8.00,0.00
17,0,0,0,0.00,0.00,2,0,0,0,0,0.00,0.00,0.00,0,0.00,8.00,0.00
18,0,510,510,4.67,4.67,2,510,0,510,510,4.67,0.26,4.67,0,0.00,8.00,0.00
19,0,33498,32988,302.14,306.81,2,33498,0,33498,32988,302.14,16.15,306.81,0,0.53,8.00,0.00
20,0,68708,35210,322.49,629.30,2,68708,0,68708,35210,322.49,31.47,629.30,1,0.82,8.00,0.00
21,0,104894,36186,331.43,960.73,2,104894,0,104894,36186,331.43,45.75,960.73,1,1.11,8.00,0.00
22,0,141452,36558,334.84,1295.57,2,141452,0,141452,36558,334.84,58.89,1295.57,0,1.44,8.00,4.76
23,0,176761,35309,323.40,1618.97,2,176761,0,176761,35309,323.40,70.39,1618.97,1,9.06,10.06,9.09
24,0,176761,0,0.00,1618.97,2,187674,10913,176761,0,0.00,67.46,1618.97,0,13.47,12.47,9.09
25,0,176761,0,0.00,1618.97,2,193344,16583,176761,0,0.00,64.76,1618.97,1,13.47,12.47,4.17
26,0,176761,0,0.00,1618.97,2,197735,20974,176761,0,0.00,62.27,1618.97,0,14.36,13.36,4.17
27,0,176761,0,0.00,1618.97,2,201602,24841,176761,0,0.00,59.96,1618.97,1,14.36,13.36,3.85
28,0,176761,0,0.00,1618.97,2,205247,28486,176761,0,0.00,57.82,1618.97,0,15.59,14.59,3.85
29,0,176761,0,0.00,1618.97,2,208589,31828,176761,0,0.00,55.83,1618.97,1,15.59,14.59,3.57
30,0,176761,0,0.00,1618.97,2,211675,34914,176761,0,0.00,53.97,1618.97,0,15.22,14.22,3.57
31,0,176761,0,0.00,1618.97,2,214550,37789,176761,0,0.00,52.22,1618.97,1,15.22,14.22,3.33
32,0,176957,196,1.80,1620.76,2,217280,40323,176957,196,1.80,50.65,1620.76,0,15.02,14.02,3.33
33,0,176957,0,0.00,1620.76,2,219855,42898,176957,0,0.00,49.11,1620.76,1,15.02,14.02,3.12
34,0,181069,4112,37.66,1658.43,2,222323,41254,181069,4112,37.66,48.78,1658.43,0,14.15,13.15,3.12
35,0,181069,0,0.00,1658.43,2,224573,43504,181069,0,0.00,47.38,1658.43,0,14.19,13.19,2.94
36,0,181069,0,0.00,1658.43,2,226668,45599,181069,0,0.00,46.07,1658.43,1,14.19,13.19,5.71
37,0,185281,4212,38.58,1697.01,2,228774,43493,185281,4212,38.58,45.87,1697.01,0,12.34,13.19,5.71
38,0,189623,4342,39.77,1736.77,2,230945,41322,189623,4342,39.77,45.70,1736.77,0,12.38,13.19,2.70
39,0,193805,4182,38.30,1775.08,2,233036,39231,193805,4182,38.30,45.51,1775.08,0,13.00,13.19,5.26
40,0,198091,4286,39.26,1814.33,2,235179,37088,198091,4286,39.26,45.36,1814.33,1,13.12,13.19,7.69
41,0,202227,4136,37.88,1852.21,2,237247,35020,202227,4136,37.88,45.18,1852.21,0,11.16,13.19,7.69
42,0,206427,4200,38.47,1890.68,2,239347,32920,206427,4200,38.47,45.02,1890.68,1,11.20,13.19,2.44
43,0,210561,4134,37.86,1928.55,2,241414,30853,210561,4134,37.86,44.85,1928.55,0,9.66,13.19,2.44
44,0,214685,4124,37.77,1966.32,2,243476,28791,214685,4124,37.77,44.69,1966.32,1,9.70,13.19,2.33
45,0,218819,4134,37.86,2004.18,2,245543,26724,218819,4134,37.86,44.54,2004.18,1,7.82,13.19,2.33
46,0,222845,4026,36.87,2041.06,2,247556,24711,222845,4026,36.87,44.37,2041.06,0,7.86,13.19,2.22
47,0,227075,4230,38.74,2079.80,2,249671,22596,227075,4230,38.74,44.25,2079.80,1,8.43,13.19,4.35
48,0,231447,4372,40.04,2119.84,2,251857,20410,231447,4372,40.04,44.16,2119.84,0,7.45,13.19,4.35
49,0,236135,4688,42.94,2162.78,2,254201,18066,236135,4688,42.94,44.14,2162.78,1,7.49,13.19,2.08
50,0,241101,4966,45.48,2208.27,2,256684,15583,241101,4966,45.48,44.17,2208.27,1,5.96,13.19,2.08
51,0,248807,7706,70.58,2278.85,2,260537,11730,248807,7706,70.58,44.68,2278.85,0,6.00,13.19,2.00
52,0,266263,17456,159.88,2438.73,2,269265,3002,266263,17456,159.88,46.90,2438.73,1,6.07,13.19,3.92
53,0,298007,31744,290.75,2729.47,2,298007,0,298007,31744,290.75,51.50,2729.47,0,8.84,13.19,3.92
54,0,331630,33623,307.96,3037.43,2,331630,0,331630,33623,307.96,56.25,3037.43,1,9.12,13.19,1.89
55,0,365333,33703,308.69,3346.12,2,365333,0,365333,33703,308.69,60.84,3346.12,0,12.07,13.19,1.89
56,0,396437,31104,284.88,3631.00,2,396437,0,396437,31104,284.88,64.84,3631.00,0,12.37,13.19,1.82
57,0,396437,0,0.00,3631.00,2,406434,9997,396437,0,0.00,63.70,3631.00,1,14.65,13.65,3.57
58,0,396437,0,0.00,3631.00,2,412275,15838,396437,0,0.00,62.60,3631.00,0,15.36,14.36,3.57
59,0,396437,0,0.00,3631.00,2,416763,20326,396437,0,0.00,61.54,3631.00,1,15.36,14.36,1.72
60,0,404443,8006,73.33,3704.33,2,420766,16323,404443,8006,73.33,61.74,3704.33,0,13.88,14.36,1.72
61,0,412995,8552,78.33,3782.66,2,425042,12047,412995,8552,78.33,62.01,3782.66,1,13.95,14.36,1.67
62,0,412995,0,0.00,3782.66,2,429028,16033,412995,0,0.00,61.01,3782.66,0,14.56,13.56,1.67
63,0,412995,0,0.00,3782.66,2,432309,19314,412995,0,0.00,60.04,3782.66,1,14.56,13.56,1.61
64,0,416211,3216,29.46,3812.11,2,435291,19080,416211,3216,29.46,59.56,3812.11,1,12.91,12.99,1.61
65,0,422571,6360,58.25,3870.36,2,438471,15900,422571,6360,58.25,59.54,3870.36,0,12.93,12.99,1.56
66,0,432927,10356,94.85,3965.22,2,443649,10722,432927,10356,94.85,60.08,3965.22,1,12.93,12.99,1.56
67,0,441115,8188,74.99,4040.21,2,451584,10469,441115,8188,74.99,60.30,4040.21,0,13.38,12.38,1.56
68,0,441115,0,0.00,4040.21,2,457212,16097,441115,0,0.00,59.41,4040.21,1,13.45,12.45,1.49
69,0,452979,11864,108.66,4148.87,2,463144,10165,452979,11864,108.66,60.13,4148.87,0,11.56,12.45,1.49
70,0,474343,21364,195.67,4344.55,2,474343,0,474343,21364,195.67,62.06,4344.55,1,11.67,12.45,1.45
71,0,507936,33593,307.68,4652.23,2,507936,0,507936,33593,307.68,65.52,4652.23,0,11.37,12.45,0.02
72,0,507936,0,0.00,4652.23,2,518548,10612,507936,0,0.00,64.61,4652.23,1,13.27,12.27,1.43
73,0,523633,15697,143.77,4796.00,2,528663,5030,523633,15697,143.77,65.70,4796.00,0,13.71,12.71,1.43
74,0,523633,0,0.00,4796.00,2,536930,13297,523633,0,0.00,64.81,4796.00,1,13.85,12.85,1.37
75,0,539065,15432,141.34,4937.34,2,544646,5581,539065,15432,141.34,65.83,4937.34,1,11.08,12.85,1.37
76,0,568697,29632,271.40,5208.75,2,568697,0,568697,29632,271.40,68.54,5208.75,0,11.22,12.85,1.33
77,0,568697,0,0.00,5208.75,2,579541,10844,568697,0,0.00,67.65,5208.75,0,13.79,12.79,2.63
78,0,568697,0,0.00,5208.75,2,585341,16644,568697,0,0.00,66.78,5208.75,0,15.49,14.49,3.90
79,0,568697,0,0.00,5208.75,2,589953,21256,568697,0,0.00,65.93,5208.75,1,15.49,14.49,5.13
80,0,576801,8104,74.23,5282.97,2,594005,17204,576801,8104,74.23,66.04,5282.97,0,13.75,14.49,1.75
81,0,584627,7826,71.68,5354.65,2,597918,13291,584627,7826,71.68,66.11,5354.65,1,14.26,14.49,2.98
82,0,594105,9478,86.81,5441.46,2,602657,8552,594105,9478,86.81,66.36,5441.46,0,12.96,14.49,0.67
83,0,618411,24306,222.62,5664.08,2,618411,0,618411,24306,222.62,68.24,5664.08,0,13.04,14.49,1.88
84,0,618411,0,0.00,5664.08,2,629364,10953,618411,0,0.00,67.43,5664.08,1,14.82,13.82,3.06
85,0,638041,19630,179.79,5843.87,2,639179,1138,638041,19630,179.79,68.75,5843.87,1,13.19,13.82,0.18
86,0,639478,1437,13.16,5857.04,2,649470,9992,639478,1437,13.16,68.11,5857.04,0,14.34,13.34,0.18
87,0,639478,0,0.00,5857.04,2,654679,15201,639478,0,0.00,67.32,5857.04,1,14.35,13.35,1.16
88,0,650340,10862,99.49,5956.52,2,660110,9770,650340,10862,99.49,67.69,5956.52,0,12.96,13.35,1.16
89,0,673280,22940,210.11,6166.63,2,673280,0,673280,22940,210.11,69.29,6166.63,1,13.05,13.35,1.14
90,0,705158,31878,291.97,6458.60,2,705158,0,705158,31878,291.97,71.76,6458.60,0,12.78,13.35,0.27
91,0,705158,0,0.00,6458.60,2,715479,10321,705158,0,0.00,70.97,6458.60,1,14.80,13.80,1.38
92,0,719956,14798,135.54,6594.14,2,725046,5090,719956,14798,135.54,71.68,6594.14,1,13.63,13.67,1.38
93,0,719956,0,0.00,6594.14,2,733232,13276,719956,0,0.00,70.90,6594.14,0,13.76,12.76,1.09
94,0,719956,0,0.00,6594.14,2,737580,17624,719956,0,0.00,70.15,6594.14,1,14.30,13.30,2.15
95,0,719956,0,0.00,6594.14,2,740627,20671,719956,0,0.00,69.41,6594.14,0,13.32,12.32,1.13
96,0,719956,0,0.00,6594.14,2,743430,23474,719956,0,0.00,68.69,6594.14,1,13.32,12.32,2.18
97,0,719956,0,0.00,6594.14,2,746039,26083,719956,0,0.00,67.98,6594.14,0,12.47,11.47,0.51
98,0,719956,0,0.00,6594.14,2,748481,28525,719956,0,0.00,67.29,6594.14,0,12.56,11.56,1.54
99,0,719956,0,0.00,6594.14,2,750746,30790,719956,0,0.00,66.61,6594.14,1,12.56,11.56,2.54
100,0,724552,4596,42.10,6636.24,2,753044,28492,724552,4596,42.10,66.36,6636.24,0,11.38,11.56,1.19
101,0,724552,0,0.00,6636.24,2,755327,30775,724552,0,0.00,65.71,6636.24,1,12.61,11.61,2.18
102,0,729066,4514,41.34,6677.58,2,757584,28518,729066,4514,41.34,65.47,6677.58,1,11.32,11.61,0.66
103,0,733832,4766,43.65,6721.23,2,759967,26135,733832,4766,43.65,65.25,6721.23,1,9.19,11.61,0.66
104,0,738600,4768,43.67,6764.90,2,762351,23751,738600,4768,43.67,65.05,6764.90,0,9.23,11.61,0.97
105,0,743482,4882,44.71,6809.62,2,764792,21310,743482,4882,44.71,64.85,6809.62,0,9.28,11.61,1.92
106,0,748354,4872,44.62,6854.24,2,767228,18874,748354,4872,44.62,64.66,6854.24,1,9.32,11.61,2.86
107,0,752848,4494,41.16,6895.40,2,769475,16627,752848,4494,41.16,64.44,6895.40,0,7.65,11.61,0.69
108,0,758392,5544,50.78,6946.18,2,772247,13855,758392,5544,50.78,64.32,6946.18,1,9.70,11.61,1.62
109,0,767882,9490,86.92,7033.10,2,776992,9110,767882,9490,86.92,64.52,7033.10,0,8.34,11.61,0.05
110,0,791481,23599,216.15,7249.24,2,791481,0,791481,23599,216.15,65.90,7249.24,1,8.42,11.61,0.96
111,0,825216,33735,308.98,7558.23,2,825216,0,825216,33735,308.98,68.09,7558.23,0,7.90,11.61,0.96
112,0,857198,31982,292.93,7851.15,2,857198,0,857198,31982,292.93,70.10,7851.15,1,8.20,11.61,0.90
113,0,890012,32814,300.55,8151.70,2,890012,0,890012,32814,300.55,72.14,8151.70,0,7.76,11.61,0.90
114,0,923711,33699,308.65,8460.35,2,923711,0,923711,33699,308.65,74.21,8460.35,0,8.05,11.61,0.88
115,0,956265,32554,298.16,8758.52,2,956265,0,956265,32554,298.16,76.16,8758.52,1,10.35,11.61,1.75
116,0,960576,4311,39.48,8798.00,2,969835,9259,960576,4311,39.48,75.84,8798.00,1,11.02,11.69,1.75
117,0,984413,23837,218.33,9016.33,2,984413,0,984413,23837,218.33,77.06,9016.33,0,11.06,11.69,0.86
118,0,984413,0,0.00,9016.33,2,995014,10601,984413,0,0.00,76.41,9016.33,0,13.27,12.27,1.71
119,0,984413,0,0.00,9016.33,2,1000668,16255,984413,0,0.00,75.77,9016.33,0,15.23,14.23,2.54
120,0,984413,0,0.00,9016.33,2,1005180,20767,984413,0,0.00,75.14,9016.33,1,15.23,14.23,3.36
121,0,992689,8276,75.80,9092.13,2,1009318,16629,992689,8276,75.80,75.14,9092.13,0,14.12,14.23,1.88
122,0,992689,0,0.00,9092.13,2,1013129,20440,992689,0,0.00,74.53,9092.13,1,14.66,13.66,2.69
123,0,992689,0,0.00,9092.13,2,1016385,23696,992689,0,0.00,73.92,9092.13,0,14.32,13.32,1.23
124,0,992689,0,0.00,9092.13,2,1019342,26653,992689,0,0.00,73.32,9092.13,0,14.32,13.32,2.03
125,0,992689,0,0.00,9092.13,2,1022072,29383,992689,0,0.00,72.74,9092.13,1,14.32,13.32,2.82
126,0,997815,5126,46.95,9139.08,2,1024635,26820,997815,5126,46.95,72.53,9139.08,0,12.75,13.32,1.33
127,0,1002727,4912,44.99,9184.07,2,1027091,24364,1002727,4912,44.99,72.32,9184.07,1,12.79,13.32,2.12
128,0,1002727,0,0.00,9184.07,2,1029620,26893,1002727,0,0.00,71.75,9184.07,0,13.80,12.80,1.39
129,0,1002727,0,0.00,9184.07,2,1031990,29263,1002727,0,0.00,71.19,9184.07,1,13.80,12.80,2.16
130,0,1002727,0,0.00,9184.07,2,1034188,31461,1002727,0,0.00,70.65,9184.07,1,12.91,11.91,1.67
131,0,1002727,0,0.00,9184.07,2,1036268,33541,1002727,0,0.00,70.11,9184.07,0,11.94,10.94,1.08
132,0,1002727,0,0.00,9184.07,2,1038232,35505,1002727,0,0.00,69.58,9184.07,1,11.94,10.94,1.83
133,0,1002727,0,0.00,9184.07,2,1040123,37396,1002727,0,0.00,69.05,9184.07,1,11.10,10.10,1.18
134,0,1002727,0,0.00,9184.07,2,1041953,39226,1002727,0,0.00,68.54,9184.07,0,10.72,9.72,1.03
135,0,1002727,0,0.00,9184.07,2,1043733,41006,1002727,0,0.00,68.03,9184.07,1,10.90,9.90,1.77
136,0,1002727,0,0.00,9184.07,2,1045461,42734,1002727,0,0.00,67.53,9184.07,1,10.17,9.17,1.51
137,0,1002727,0,0.00,9184.07,2,1047151,44424,1002727,0,0.00,67.04,9184.07,0,9.18,8.18,0.92
138,0,1002727,0,0.00,9184.07,2,1048796,46069,1002727,0,0.00,66.55,9184.07,1,9.18,8.18,1.65
139,0,1002727,0,0.00,9184.07,2,1050402,47675,1002727,0,0.00,66.07,9184.07,0,8.51,8.00,1.48
140,0,1005901,3174,29.07,9213.14,2,1051989,46088,1005901,3174,29.07,65.81,9213.14,1,8.51,9.51,2.19
141,0,1009025,3124,28.61,9241.75,2,1053551,44526,1009025,3124,28.61,65.54,9241.75,1,7.55,9.51,1.62
142,0,1012121,3096,28.36,9270.11,2,1055099,42978,1012121,3096,28.36,65.28,9270.11,0,7.55,9.51,1.62
143,0,1015193,3072,28.14,9298.24,2,1056635,41442,1015193,3072,28.14,65.02,9298.24,1,7.08,9.51,0.61
144,0,1018327,3134,28.70,9326.95,2,1058202,39875,1018327,3134,28.70,64.77,9326.95,0,7.11,9.51,1.31
145,0,1021519,3192,29.24,9356.18,2,1059798,38279,1021519,3192,29.24,64.53,9356.18,0,7.14,9.51,1.99
146,0,1024765,3246,29.73,9385.91,2,1061421,36656,1024765,3246,29.73,64.29,9385.91,1,7.17,9.51,2.67
147,0,1028075,3310,30.32,9416.23,2,1063076,35001,1028075,3310,30.32,64.06,9416.23,0,5.67,9.51,1.45
148,0,1031535,3460,31.69,9447.92,2,1064806,33271,1031535,3460,31.69,63.84,9447.92,1,5.70,9.51,2.12
149,0,1035137,3602,32.99,9480.91,2,1066607,31470,1035137,3602,32.99,63.63,9480.91,0,4.10,9.51,0.79
150,0,1038797,3660,33.52,9514.43,2,1068437,29640,1038797,3660,33.52,63.43,9514.43,1,4.13,9.51,1.45
151,0,1042379,3582,32.81,9547.24,2,1070228,27849,1042379,3582,32.81,63.23,9547.24,1,2.93,9.51,0.49
152,0,1046043,3664,33.56,9580.80,2,1072060,26017,1046043,3664,33.56,63.03,9580.80,0,2.48,9.51,0.52
153,0,1049683,3640,33.34,9614.14,2,1073880,24197,1049683,3640,33.34,62.84,9614.14,1,2.51,9.51,1.17
154,0,1053357,3674,33.65,9647.79,2,1075717,22360,1053357,3674,33.65,62.65,9647.79,0,2.26,9.51,1.48
155,0,1057365,4008,36.71,9684.50,2,1077721,20356,1057365,4008,36.71,62.48,9684.50,1,2.29,9.51,2.12
156,0,1061703,4338,39.73,9724.23,2,1079890,18187,1061703,4338,39.73,62.33,9724.23,0,2.01,9.51,2.39
157,0,1066637,4934,45.19,9769.42,2,1082357,15720,1066637,4934,45.19,62.23,9769.42,1,2.05,9.51,3.01
158,0,1074217,7580,69.43,9838.85,2,1086147,11930,1074217,7580,69.43,62.27,9838.85,0,1.85,9.51,3.35
159,0,1089569,15352,140.61,9979.46,2,1093823,4254,1089569,15352,140.61,62.76,9979.46,1,2.44,9.51,3.96
160,0,1123158,33589,307.64,10287.10,2,1123158,0,1123158,33589,307.64,64.29,10287.10,0,2.12,9.51,4.05
161,0,1157079,33921,310.69,10597.79,2,1157079,0,1157079,33921,310.69,65.82,10597.79,1,2.42,9.51,4.65
162,0,1191238,34159,312.87,10910.65,2,1191238,0,1191238,34159,312.87,67.35,10910.65,0,1.29,9.51,3.64
163,0,1225328,34090,312.23,11222.89,2,1225328,0,1225328,34090,312.23,68.85,11222.89,0,2.93,9.51,4.23
164,0,1258756,33428,306.17,11529.06,2,1258756,0,1258756,33428,306.17,70.30,11529.06,1,6.53,9.51,4.82
165,0,1292420,33664,308.33,11837.39,2,1292420,0,1292420,33664,308.33,71.74,11837.39,0,7.52,9.51,3.56
166,0,1292420,0,0.00,11837.39,2,1303213,10793,1292420,0,0.00,71.31,11837.39,0,10.23,9.23,4.15
167,0,1292420,0,0.00,11837.39,2,1308680,16260,1292420,0,0.00,70.88,11837.39,1,10.86,9.86,4.73
168,0,1292420,0,0.00,11837.39,2,1313013,20593,1292420,0,0.00,70.46,11837.39,0,10.84,9.84,3.82
169,0,1292420,0,0.00,11837.39,2,1316777,24357,1292420,0,0.00,70.04,11837.39,1,10.84,9.84,4.39
170,0,1299880,7460,68.33,11905.72,2,1320507,20627,1299880,7460,68.33,70.03,11905.72,0,9.18,9.84,3.19
171,0,1307344,7464,68.36,11974.08,2,1324239,16895,1307344,7464,68.36,70.02,11974.08,1,9.24,9.84,3.76
172,0,1314572,7228,66.20,12040.28,2,1327853,13281,1314572,7228,66.20,70.00,12040.28,0,9.82,9.84,2.72
173,0,1314572,0,0.00,12040.28,2,1331266,16694,1314572,0,0.00,69.60,12040.28,1,10.00,9.00,3.29
174,0,1314572,0,0.00,12040.28,2,1334157,19585,1314572,0,0.00,69.20,12040.28,0,9.24,8.24,2.81
175,0,1314572,0,0.00,12040.28,2,1336684,22112,1314572,0,0.00,68.80,12040.28,1,9.24,8.24,3.37
176,0,1319430,4858,44.49,12084.78,2,1339113,19683,1319430,4858,44.49,68.66,12084.78,1,8.08,8.24,2.73
177,0,1319430,0,0.00,12084.78,2,1341511,22081,1319430,0,0.00,68.28,12084.78,0,8.47,8.00,1.97
178,0,1324106,4676,42.83,12127.60,2,1343849,19743,1324106,4676,42.83,68.13,12127.60,0,8.47,9.47,2.52
179,0,1328790,4684,42.90,12170.50,2,1346191,17401,1328790,4684,42.90,67.99,12170.50,1,8.51,9.47,3.07
180,0,1336478,7688,70.42,12240.92,2,1350035,13557,1336478,7688,70.42,68.01,12240.92,0,7.45,9.47,2.49
181,0,1351924,15446,141.47,12382.39,2,1357758,5834,1351924,15446,141.47,68.41,12382.39,1,7.52,9.47,3.03
182,0,1382267,30343,277.91,12660.31,2,1382267,0,1382267,30343,277.91,69.56,12660.31,0,8.46,9.47,2.35
183,0,1410724,28457,260.64,12920.95,2,1410724,0,1410724,28457,260.64,70.61,12920.95,1,8.74,9.47,2.88
184,0,1440832,30108,275.76,13196.71,2,1440832,0,1440832,30108,275.76,71.72,13196.71,1,7.63,9.47,2.08
185,0,1470557,29725,272.25,13468.96,2,1470557,0,1470557,29725,272.25,72.81,13468.96,0,9.16,9.47,1.91
186,0,1470557,0,0.00,13468.96,2,1480660,10103,1470557,0,0.00,72.41,13468.96,1,10.22,9.22,2.44
187,0,1470557,0,0.00,13468.96,2,1486595,16038,1470557,0,0.00,72.03,13468.96,0,9.85,8.85,1.74
188,0,1470557,0,0.00,13468.96,2,1491202,20645,1470557,0,0.00,71.64,13468.96,1,10.79,9.79,2.27
189,0,1479123,8566,78.46,13547.42,2,1495485,16362,1479123,8566,78.46,71.68,13547.42,1,9.68,9.79,1.72
190,0,1487387,8264,75.69,13623.11,2,1499617,12230,1487387,8264,75.69,71.70,13623.11,0,9.75,9.79,1.22
191,0,1487387,0,0.00,13623.11,2,1503373,15986,1487387,0,0.00,71.33,13623.11,1,10.62,9.62,1.74
192,0,1494097,6710,61.46,13684.57,2,1506728,12631,1494097,6710,61.46,71.27,13684.57,0,9.33,9.62,1.04
193,0,1507189,13092,119.91,13804.48,2,1513274,6085,1507189,13092,119.91,71.53,13804.48,1,9.39,9.62,1.55
194,0,1507189,0,0.00,13804.48,2,1520686,13497,1507189,0,0.00,71.16,13804.48,0,10.11,9.11,1.13
195,0,1507189,0,0.00,13804.48,2,1525146,17957,1507189,0,0.00,70.79,13804.48,1,10.11,9.11,1.64
196,0,1507189,0,0.00,13804.48,2,1528181,20992,1507189,0,0.00,70.43,13804.48,0,10.75,9.75,0.94
197,0,1507189,0,0.00,13804.48,2,1530563,23374,1507189,0,0.00,70.07,13804.48,0,10.75,9.75,1.44
198,0,1507189,0,0.00,13804.48,2,1532668,25479,1507189,0,0.00,69.72,13804.48,0,10.75,9.75,1.94
199,0,1507189,0,0.00,13804.48,2,1534624,27435,1507189,0,0.00,69.37,13804.48,1,10.75,9.75,2.44
200,0,1510991,3802,34.82,13839.30,2,1536525,25534,1510991,3802,34.82,69.20,13839.30,1,9.07,9.75,1.40
201,0,1515117,4126,37.79,13877.09,2,1538588,23471,1515117,4126,37.79,69.04,13877.09,0,8.01,9.75,0.92
202,0,1519753,4636,42.46,13919.55,2,1540906,21153,1519753,4636,42.46,68.91,13919.55,0,8.05,9.75,1.41
203,0,1519753,0,0.00,13919.55,2,1543258,23505,1519753,0,0.00,68.57,13919.55,1,10.10,9.10,1.90
204,0,1524521,4768,43.67,13963.22,2,1545642,21121,1524521,4768,43.67,68.45,13963.22,0,8.79,9.10,1.22
205,0,1530079,5558,50.91,14014.13,2,1548421,18342,1530079,5558,50.91,68.36,14014.13,0,8.84,9.10,1.71
206,0,1536903,6824,62.50,14076.63,2,1551833,14930,1536903,6824,62.50,68.33,14076.63,1,8.89,9.10,2.18
207,0,1547503,10600,97.09,14173.72,2,1557133,9630,1547503,10600,97.09,68.47,14173.72,0,8.09,9.10,1.57
208,0,1568566,21063,192.92,14366.63,2,1568566,0,1568566,21063,192.92,69.07,14366.63,1,8.34,9.10,2.05
209,0,1602776,34210,313.33,14679.97,2,1602776,0,1602776,34210,313.33,70.24,14679.97,1,7.27,9.10,1.43
210,0,1632935,30159,276.23,14956.20,2,1632935,0,1632935,30159,276.23,71.22,14956.20,0,7.99,9.10,0.80
211,0,1663412,30477,279.14,15235.34,2,1663412,0,1663412,30477,279.14,72.21,15235.34,1,8.62,9.10,1.27
212,0,1690238,26826,245.70,15481.04,2,1690238,0,1690238,26826,245.70,73.02,15481.04,1,8.53,9.10,1.01
213,0,1719153,28915,264.84,15745.87,2,1719153,0,1719153,28915,264.84,73.92,15745.87,0,8.51,9.10,0.79
214,0,1719153,0,0.00,15745.87,2,1729912,10759,1719153,0,0.00,73.58,15745.87,1,9.25,8.25,1.26
215,0,1719153,0,0.00,15745.87,2,1735509,16356,1719153,0,0.00,73.24,15745.87,0,9.62,8.62,0.88
216,0,1719153,0,0.00,15745.87,2,1739952,20799,1719153,0,0.00,72.90,15745.87,1,9.62,8.62,1.34
217,0,1719153,0,0.00,15745.87,2,1743884,24731,1719153,0,0.00,72.56,15745.87,0,8.68,8.00,1.01
218,0,1726657,7504,68.73,15814.60,2,1747636,20979,1726657,7504,68.73,72.54,15814.60,1,8.68,9.68,1.47
219,0,1734195,7538,69.04,15883.64,2,1751405,17210,1734195,7538,69.04,72.53,15883.64,0,7.64,9.68,1.00
220,0,1741607,7412,67.89,15951.53,2,1755111,13504,1741607,7412,67.89,72.51,15951.53,1,8.43,9.68,1.46
221,0,1750555,8948,81.96,16033.49,2,1759585,9030,1750555,8948,81.96,72.55,16033.49,1,7.44,9.68,1.03
222,0,1774685,24130,221.01,16254.50,2,1774685,0,1774685,24130,221.01,73.22,16254.50,0,6.29,9.68,0.48
223,0,1810850,36165,331.24,16585.73,2,1810850,0,1810850,36165,331.24,74.38,16585.73,1,6.51,9.68,0.92
224,0,1810850,0,0.00,16585.73,2,1821917,11067,1810850,0,0.00,74.04,16585.73,0,9.76,8.76,0.40
225,0,1810850,0,0.00,16585.73,2,1827473,16623,1810850,0,0.00,73.71,16585.73,0,13.63,12.63,0.84
226,0,1810850,0,0.00,16585.73,2,1831737,20887,1810850,0,0.00,73.39,16585.73,1,14.72,13.72,1.28
227,0,1819040,8190,75.01,16660.75,2,1835832,16792,1819040,8190,75.01,73.40,16660.75,0,13.68,13.72,0.29
228,0,1819040,0,0.00,16660.75,2,1839523,20483,1819040,0,0.00,73.07,16660.75,1,13.76,12.76,0.73
229,0,1825938,6898,63.18,16723.93,2,1842972,17034,1825938,6898,63.18,73.03,16723.93,0,11.82,12.76,0.73
230,0,1833290,7352,67.34,16791.27,2,1846648,13358,1833290,7352,67.34,73.01,16791.27,1,11.88,12.76,0.44
231,0,1846356,13066,119.67,16910.94,2,1853181,6825,1846356,13066,119.67,73.21,16910.94,0,10.46,12.76,0.44
232,0,1873175,26819,245.64,17156.57,2,1873175,0,1873175,26819,245.64,73.95,17156.57,1,10.58,12.76,0.43
233,0,1906136,32961,301.89,17458.47,2,1906136,0,1906136,32961,301.89,74.93,17458.47,0,11.14,12.76,0.43
234,0,1939416,33280,304.81,17763.28,2,1939416,0,1939416,33280,304.81,75.91,17763.28,1,11.43,12.76,0.43
235,0,1972340,32924,301.55,18064.84,2,1972340,0,1972340,32924,301.55,76.87,18064.84,0,12.01,12.76,0.43
236,0,2004917,32577,298.38,18363.21,2,2004917,0,2004917,32577,298.38,77.81,18363.21,1,12.30,12.76,0.43
237,0,2015297,10380,95.07,18458.28,2,2023307,8010,2015297,10380,95.07,77.88,18458.28,0,14.64,13.64,0.43
238,0,2015297,0,0.00,18458.28,2,2029931,14634,2015297,0,0.00,77.56,18458.28,0,14.74,13.74,0.42
239,0,2015297,0,0.00,18458.28,2,2034434,19137,2015297,0,0.00,77.23,18458.28,1,14.74,13.74,0.84
240,0,2015297,0,0.00,18458.28,2,2038330,23033,2015297,0,0.00,76.91,18458.28,0,14.36,13.36,0.13
241,0,2015297,0,0.00,18458.28,2,2041934,26637,2015297,0,0.00,76.59,18458.28,1,15.22,14.22,0.55
242,0,2022013,6716,61.51,18519.79,2,2045292,23279,2022013,6716,61.51,76.53,18519.79,0,13.60,14.22,0.55
243,0,2028473,6460,59.17,18578.96,2,2048522,20049,2028473,6460,59.17,76.46,18578.96,0,13.66,14.22,0.41
244,0,2028473,0,0.00,18578.96,2,2051459,22986,2028473,0,0.00,76.14,18578.96,1,14.29,13.29,0.82
245,0,2028473,0,0.00,18578.96,2,2054133,25660,2028473,0,0.00,75.83,18578.96,0,13.63,12.63,0.82
246,0,2028473,0,0.00,18578.96,2,2056628,28155,2028473,0,0.00,75.52,18578.96,1,13.63,12.63,0.41
247,0,2028473,0,0.00,18578.96,2,2058979,30506,2028473,0,0.00,75.22,18578.96,1,12.69,11.69,0.15
248,0,2033073,4600,42.13,18621.10,2,2061279,28206,2033073,4600,42.13,75.09,18621.10,0,11.53,11.69,0.15
249,0,2037641,4568,41.84,18662.93,2,2063563,25922,2037641,4568,41.84,74.95,18662.93,1,11.58,11.69,0.40
250,0,2042121,4480,41.03,18703.97,2,2065803,23682,2042121,4480,41.03,74.82,18703.97,0,10.92,11.69,0.40
251,0,2046777,4656,42.64,18746.61,2,2068131,21354,2046777,4656,42.64,74.69,18746.61,1,10.96,11.69,0.40
252,0,2051555,4778,43.76,18790.37,2,2070520,18965,2051555,4778,43.76,74.56,18790.37,1,11.11,11.69,0.07
253,0,2056967,5412,49.57,18839.94,2,2073226,16259,2056967,5412,49.57,74.47,18839.94,0,10.59,11.69,0.07
254,0,2063397,6430,58.89,18898.84,2,2076441,13044,2063397,6430,58.89,74.40,18898.84,1,10.63,11.69,0.47
255,0,2077173,13776,126.18,19025.01,2,2083329,6156,2077173,13776,126.18,74.61,19025.01,1,10.02,11.69,0.40
256,0,2104551,27378,250.76,19275.77,2,2104551,0,2104551,27378,250.76,75.30,19275.77,0,11.55,11.69,0.58
257,0,2104551,0,0.00,19275.77,2,2114965,10414,2104551,0,0.00,75.00,19275.77,0,13.23,12.23,0.97
258,0,2104551,0,0.00,19275.77,2,2120571,16020,2104551,0,0.00,74.71,19275.77,1,14.08,13.08,1.35
259,0,2104551,0,0.00,19275.77,2,2124961,20410,2104551,0,0.00,74.42,19275.77,1,14.32,13.32,1.56
260,0,2104551,0,0.00,19275.77,2,2128883,24332,2104551,0,0.00,74.14,19275.77,0,13.75,12.75,1.50
261,0,2104551,0,0.00,19275.77,2,2132509,27958,2104551,0,0.00,73.85,19275.77,1,13.75,12.75,1.88
262,0,2104551,0,0.00,19275.77,2,2135828,31277,2104551,0,0.00,73.57,19275.77,0,13.09,12.09,1.81
263,0,2104551,0,0.00,19275.77,2,2138836,34285,2104551,0,0.00,73.29,19275.77,1,13.09,12.09,2.19
264,0,2104551,0,0.00,19275.77,2,2141608,37057,2104551,0,0.00,73.01,19275.77,0,12.13,11.13,1.92
265,0,2104551,0,0.00,19275.77,2,2144182,39631,2104551,0,0.00,72.74,19275.77,1,12.13,11.13,2.29
266,0,2109219,4668,42.75,19318.52,2,2146516,37297,2109219,4668,42.75,72.63,19318.52,0,11.06,11.13,1.85
267,0,2109219,0,0.00,19318.52,2,2148841,39622,2109219,0,0.00,72.35,19318.52,1,11.33,10.33,2.22
268,0,2113967,4748,43.49,19362.01,2,2151215,37248,2113967,4748,43.49,72.25,19362.01,0,10.17,10.33,1.62
269,0,2118733,4766,43.65,19405.66,2,2153598,34865,2118733,4766,43.65,72.14,19405.66,1,10.22,10.33,1.99
270,0,2123479,4746,43.47,19449.13,2,2155971,32492,2123479,4746,43.47,72.03,19449.13,0,8.60,10.33,1.27
271,0,2128179,4700,43.05,19492.18,2,2158321,30142,2128179,4700,43.05,71.93,19492.18,0,8.66,10.33,1.64
272,0,2132807,4628,42.39,19534.57,2,2160635,27828,2132807,4628,42.39,71.82,19534.57,1,8.87,10.33,2.00
273,0,2137391,4584,41.99,19576.55,2,2162927,25536,2137391,4584,41.99,71.71,19576.55,0,6.70,10.33,0.78
274,0,2141929,4538,41.56,19618.12,2,2165196,23267,2141929,4538,41.56,71.60,19618.12,1,6.92,10.33,1.15
275,0,2146471,4542,41.60,19659.72,2,2167467,20996,2146471,4542,41.60,71.49,19659.72,0,5.66,10.33,0.60
276,0,2151223,4752,43.52,19703.24,2,2169843,18620,2151223,4752,43.52,71.39,19703.24,1,5.90,10.33,0.97
277,0,2156369,5146,47.13,19750.37,2,2172416,16047,2156369,5146,47.13,71.30,19750.37,0,4.89,10.33,0.61
278,0,2162751,6382,58.45,19808.83,2,2175607,12856,2162751,6382,58.45,71.25,19808.83,0,5.29,10.33,0.97
279,0,2175169,12418,113.74,19922.56,2,2181816,6647,2175169,12418,113.74,71.41,19922.56,1,6.49,10.33,1.33
280,0,2203306,28137,257.71,20180.27,2,2203306,0,2203306,28137,257.71,72.07,20180.27,0,6.26,10.33,1.12
281,0,2237353,34047,311.84,20492.11,2,2237353,0,2237353,34047,311.84,72.93,20492.11,1,8.22,10.33,1.47
282,0,2267877,30524,279.57,20771.69,2,2267877,0,2267877,30524,279.57,73.66,20771.69,1,8.23,10.33,1.56
283,0,2294722,26845,245.88,21017.56,2,2294722,0,2294722,26845,245.88,74.27,21017.56,0,7.87,10.33,1.52
284,0,2321630,26908,246.45,21264.01,2,2321630,0,2321630,26908,246.45,74.87,21264.01,1,7.79,10.33,1.67
285,0,2348260,26630,243.91,21507.92,2,2348260,0,2348260,26630,243.91,75.47,21507.92,1,8.03,10.33,2.02
286,0,2375339,27079,248.02,21755.94,2,2375339,0,2375339,27079,248.02,76.07,21755.94,0,7.79,10.33,2.04
287,0,2401990,26651,244.10,22000.04,2,2401990,0,2401990,26651,244.10,76.66,22000.04,1,8.28,10.33,2.38
288,0,2428884,26894,246.32,22246.36,2,2428884,0,2428884,26894,246.32,77.24,22246.36,0,8.73,10.33,2.46
289,0,2455668,26784,245.32,22491.68,2,2455668,0,2455668,26784,245.32,77.83,22491.68,1,9.37,10.33,2.80
290,0,2482525,26857,245.99,22737.67,2,2482525,0,2482525,26857,245.99,78.41,22737.67,0,9.28,10.33,2.69
291,0,2509436,26911,246.48,22984.14,2,2509436,0,2509436,26911,246.48,78.98,22984.14,0,9.28,10.33,2.69
292,0,2536573,27137,248.55,23232.70,2,2536573,0,2536573,27137,248.55,79.56,23232.70,1,9.68,10.33,2.86
293,0,2560527,23954,219.40,23452.09,2,2560527,0,2560527,23954,219.40,80.04,23452.09,0,10.19,10.33,3.19
294,0,2560576,49,0.45,23452.54,2,2560576,0,2560576,49,0.45,79.77,23452.54,1,9.32,10.33,2.81
295,0,2581412,20836,190.84,23643.38,2,2581412,0,2581412,20836,190.84,80.15,23643.38,1,9.32,10.33,3.14
296,0,2610958,29546,270.61,23913.99,2,2610958,0,2610958,29546,270.61,80.79,23913.99,0,9.69,10.33,3.02
297,0,2610958,0,0.00,23913.99,2,2621878,10920,2610958,0,0.00,80.52,23913.99,0,10.51,9.51,3.35
298,0,2610958,0,0.00,23913.99,2,2627459,16501,2610958,0,0.00,80.25,23913.99,0,11.00,10.00,3.67
299,0,2610958,0,0.00,23913.99,2,2631858,20900,2610958,0,0.00,79.98,23913.99,1,11.00,10.00,4.00
300,0,2610958,0,0.00,23913.99,2,2635677,24719,2610958,0,0.00,79.71,23913.99,0,10.38,9.38,3.52
301,0,2610958,0,0.00,23913.99,2,2639088,28130,2610958,0,0.00,79.45,23913.99,1,10.38,9.38,3.84
302,0,2610958,0,0.00,23913.99,2,2642224,31266,2610958,0,0.00,79.19,23913.99,0,9.63,8.63,3.72
303,0,2610958,0,0.00,23913.99,2,2645139,34181,2610958,0,0.00,78.92,23913.99,0,9.63,8.63,4.04
304,0,2610958,0,0.00,23913.99,2,2647989,37031,2610958,0,0.00,78.66,23913.99,1,9.63,8.63,4.36
305,0,2610958,0,0.00,23913.99,2,2650655,39697,2610958,0,0.00,78.41,23913.99,1,9.49,8.49,4.04
306,0,2610958,0,0.00,23913.99,2,2653171,42213,2610958,0,0.00,78.15,23913.99,0,8.92,8.00,4.03
307,0,2615762,4804,44.00,23957.99,2,2655573,39811,2615762,4804,44.00,78.04,23957.99,1,8.92,9.92,4.34
308,0,2620298,4536,41.55,23999.54,2,2657841,37543,2620298,4536,41.55,77.92,23999.54,0,8.04,9.92,4.12
309,0,2625010,4712,43.16,24042.70,2,2660197,35187,2625010,4712,43.16,77.81,24042.70,1,8.08,9.92,4.44
310,0,2629764,4754,43.54,24086.24,2,2662574,32810,2629764,4754,43.54,77.70,24086.24,1,7.28,9.92,4.27
311,0,2634530,4766,43.65,24129.89,2,2664957,30427,2634530,4766,43.65,77.59,24129.89,0,6.89,9.92,4.33
312,0,2639264,4734,43.36,24173.25,2,2667324,28060,2639264,4734,43.36,77.48,24173.25,1,6.93,9.92,4.64
313,0,2643906,4642,42.52,24215.77,2,2669645,25739,2643906,4642,42.52,77.37,24215.77,1,6.11,9.92,4.46
314,0,2648422,4516,41.36,24257.13,2,2671903,23481,2648422,4516,41.36,77.25,24257.13,0,6.72,9.92,4.35
315,0,2652872,4450,40.76,24297.89,2,2674128,21256,2652872,4450,40.76,77.14,24297.89,0,6.76,9.92,4.66
316,0,2657614,4742,43.43,24341.32,2,2676499,18885,2657614,4742,43.43,77.03,24341.32,1,6.80,9.92,4.96
317,0,2662708,5094,46.66,24387.98,2,2679046,16338,2662708,5094,46.66,76.93,24387.98,0,5.74,9.92,4.65
318,0,2668518,5810,53.21,24441.19,2,2681951,13433,2668518,5810,53.21,76.86,24441.19,1,5.79,9.92,4.96
319,0,2680666,12148,111.26,24552.46,2,2688025,7359,2680666,12148,111.26,76.97,24552.46,0,4.88,9.92,4.73
320,0,2680666,0,0.00,24552.46,2,2694487,13821,2680666,0,0.00,76.73,24552.46,1,10.49,9.49,5.03
321,0,2680666,0,0.00,24552.46,2,2698803,18137,2680666,0,0.00,76.49,24552.46,0,9.49,8.49,4.78
322,0,2680666,0,0.00,24552.46,2,2701809,21143,2680666,0,0.00,76.25,24552.46,1,9.49,8.49,5.08
323,0,2686232,5566,50.98,24603.44,2,2704592,18360,2686232,5566,50.98,76.17,24603.44,0,8.44,8.49,4.80
324,0,2694244,8012,73.38,24676.82,2,2708598,14354,2694244,8012,73.38,76.16,24676.82,1,8.49,8.49,5.09
325,0,2707114,12870,117.88,24794.70,2,2715033,7919,2707114,12870,117.88,76.29,24794.70,0,7.54,8.49,4.83
326,0,2707114,0,0.00,24794.70,2,2721492,14378,2707114,0,0.00,76.06,24794.70,1,9.50,8.50,5.13
327,0,2719548,12434,113.88,24908.58,2,2727709,8161,2719548,12434,113.88,76.17,24908.58,0,8.47,8.50,4.86
328,0,2719548,0,0.00,24908.58,2,2734109,14561,2719548,0,0.00,75.94,24908.58,1,13.00,12.00,5.15
329,0,2719548,0,0.00,24908.58,2,2738275,18727,2719548,0,0.00,75.71,24908.58,0,12.50,11.50,4.76
330,0,2719548,0,0.00,24908.58,2,2741103,21555,2719548,0,0.00,75.48,24908.58,1,12.50,11.50,5.05
331,0,2719548,0,0.00,24908.58,2,2743328,23780,2719548,0,0.00,75.25,24908.58,0,11.64,10.64,4.89
332,0,2719548,0,0.00,24908.58,2,2745231,25683,2719548,0,0.00,75.03,24908.58,0,11.64,10.64,5.17
333,0,2719548,0,0.00,24908.58,2,2746945,27397,2719548,0,0.00,74.80,24908.58,1,11.64,10.64,5.46
334,0,2722946,3398,31.12,24939.70,2,2748644,25698,2722946,3398,31.12,74.67,24939.70,0,10.43,10.64,5.11
335,0,2722946,0,0.00,24939.70,2,2750317,27371,2722946,0,0.00,74.45,24939.70,1,10.84,9.84,5.39
336,0,2722946,0,0.00,24939.70,2,2751872,28926,2722946,0,0.00,74.23,24939.70,0,10.71,9.71,5.13
337,0,2722946,0,0.00,24939.70,2,2753301,30355,2722946,0,0.00,74.01,24939.70,1,12.15,11.15,5.41
338,0,2722946,0,0.00,24939.70,2,2754674,31728,2722946,0,0.00,73.79,24939.70,0,11.93,10.93,5.22
339,0,2722946,0,0.00,24939.70,2,2756019,33073,2722946,0,0.00,73.57,24939.70,1,11.93,10.93,5.50
340,0,2722946,0,0.00,24939.70,2,2757354,34408,2722946,0,0.00,73.35,24939.70,1,11.16,10.16,5.38
341,0,2722946,0,0.00,24939.70,2,2758668,35722,2722946,0,0.00,73.14,24939.70,0,10.42,9.42,5.27
342,0,2722946,0,0.00,24939.70,2,2759950,37004,2722946,0,0.00,72.92,24939.70,1,10.42,9.42,5.55
343,0,2722946,0,0.00,24939.70,2,2761209,38263,2722946,0,0.00,72.71,24939.70,1,9.77,8.77,5.49
344,0,2722946,0,0.00,24939.70,2,2762442,39496,2722946,0,0.00,72.50,24939.70,0,9.07,8.07,5.41
345,0,2722946,0,0.00,24939.70,2,2763653,40707,2722946,0,0.00,72.29,24939.70,1,9.07,8.07,5.69
346,0,2722946,0,0.00,24939.70,2,2764845,41899,2722946,0,0.00,72.08,24939.70,0,8.40,8.00,5.62
347,0,2725344,2398,21.96,24961.67,2,2766044,40700,2725344,2398,21.96,71.94,24961.67,1,8.69,9.69,5.89
348,0,2727812,2468,22.60,24984.27,2,2767278,39466,2727812,2468,22.60,71.79,24984.27,0,8.60,9.69,5.97
349,0,2730358,2546,23.32,25007.59,2,2768551,38193,2730358,2546,23.32,71.65,25007.59,1,9.48,9.69,6.24
350,0,2732998,2640,24.18,25031.77,2,2769871,36873,2732998,2640,24.18,71.52,25031.77,0,8.94,9.69,6.08
351,0,2735736,2738,25.08,25056.85,2,2771240,35504,2735736,2738,25.08,71.39,25056.85,1,9.25,9.69,6.35
352,0,2738562,2826,25.88,25082.73,2,2772653,34091,2738562,2826,25.88,71.26,25082.73,0,8.34,9.69,6.15
353,0,2741522,2960,27.11,25109.84,2,2774133,32611,2741522,2960,27.11,71.13,25109.84,1,8.36,9.69,6.42
354,0,2744616,3094,28.34,25138.18,2,2775680,31064,2744616,3094,28.34,71.01,25138.18,0,7.11,9.69,6.05
355,0,2747830,3214,29.44,25167.62,2,2777287,29457,2747830,3214,29.44,70.89,25167.62,1,7.14,9.69,6.31
356,0,2751208,3378,30.94,25198.56,2,2778976,27768,2751208,3378,30.94,70.78,25198.56,0,5.79,9.69,5.90
357,0,2754748,3540,32.42,25230.98,2,2780746,25998,2754748,3540,32.42,70.68,25230.98,0,5.82,9.69,6.16
358,0,2758372,3624,33.19,25264.17,2,2782558,24186,2758372,3624,33.19,70.57,25264.17,1,6.13,9.69,6.43
359,0,2761998,3626,33.21,25297.38,2,2784371,22373,2761998,3626,33.21,70.47,25297.38,0,4.99,9.69,5.69
360,0,2765880,3882,35.56,25332.94,2,2786312,20432,2765880,3882,35.56,70.37,25332.94,1,5.61,9.69,5.95
361,0,2770440,4560,41.77,25374.71,2,2788592,18152,2770440,4560,41.77,70.29,25374.71,0,4.65,9.69,5.59
362,0,2776396,5956,54.55,25429.26,2,2791570,15174,2776396,5956,54.55,70.25,25429.26,1,4.69,9.69,5.85
363,0,2785700,9304,85.22,25514.47,2,2796222,10522,2785700,9304,85.22,70.29,25514.47,0,3.47,9.69,5.50
364,0,2805158,19458,178.22,25692.69,2,2805951,793,2805158,19458,178.22,70.58,25692.69,1,3.55,9.69,5.76
365,0,2840394,35236,322.73,26015.42,2,2840394,0,2840394,35236,322.73,71.28,26015.42,0,3.96,9.69,5.16
366,0,2876053,35659,326.60,26342.02,2,2876053,0,2876053,35659,326.60,71.97,26342.02,1,4.27,9.69,5.42
367,0,2912196,36143,331.04,26673.06,2,2912196,0,2912196,36143,331.04,72.68,26673.06,0,3.89,9.69,5.34
368,0,2948532,36336,332.80,27005.87,2,2948532,0,2948532,36336,332.80,73.39,27005.87,1,5.94,9.69,5.60
369,0,2984493,35961,329.37,27335.23,2,2984493,0,2984493,35961,329.37,74.08,27335.23,0,7.91,9.69,5.55
370,0,2984493,0,0.00,27335.23,2,2995377,10884,2984493,0,0.00,73.88,27335.23,1,10.23,9.23,5.81
371,0,3006670,22177,203.12,27538.36,2,3006670,0,3006670,22177,203.12,74.23,27538.36,0,8.60,9.23,5.15
372,0,3042114,35444,324.63,27862.99,2,3042114,0,3042114,35444,324.63,74.90,27862.99,1,8.86,9.23,5.40
373,0,3042114,0,0.00,27862.99,2,3053219,11105,3042114,0,0.00,74.70,27862.99,0,9.82,8.82,5.19
374,0,3042114,0,0.00,27862.99,2,3059273,17159,3042114,0,0.00,74.50,27862.99,1,10.32,9.32,5.44
375,0,3052434,10320,94.52,27957.51,2,3064433,11999,3052434,10320,94.52,74.55,27957.51,0,9.07,9.32,5.00
376,0,3069934,17500,160.28,28117.80,2,3073183,3249,3069934,17500,160.28,74.78,28117.80,1,9.23,9.32,5.25
377,0,3104022,34088,312.21,28430.01,2,3104022,0,3104022,34088,312.21,75.41,28430.01,0,8.23,9.32,4.89
378,0,3104022,0,0.00,28430.01,2,3114963,10941,3104022,0,0.00,75.21,28430.01,0,9.56,8.56,5.15
379,0,3104022,0,0.00,28430.01,2,3120674,16652,3104022,0,0.00,75.01,28430.01,1,11.26,10.26,5.40
380,0,3114402,10380,95.07,28525.08,2,3125864,11462,3114402,10380,95.07,75.07,28525.08,0,10.12,10.26,4.99
381,0,3133398,18996,173.99,28699.07,2,3135362,1964,3133398,18996,173.99,75.33,28699.07,1,10.22,10.26,5.24
382,0,3133398,0,0.00,28699.07,2,3144804,11406,3133398,0,0.00,75.13,28699.07,0,11.03,10.03,4.88
383,0,3133398,0,0.00,28699.07,2,3150217,16819,3133398,0,0.00,74.93,28699.07,1,11.90,10.90,5.13
384,0,3133398,0,0.00,28699.07,2,3153269,19871,3133398,0,0.00,74.74,28699.07,1,11.83,10.83,4.81
385,0,3133398,0,0.00,28699.07,2,3155786,22388,3133398,0,0.00,74.54,28699.07,0,10.90,9.90,4.64
386,0,3133398,0,0.00,28699.07,2,3158107,24709,3133398,0,0.00,74.35,28699.07,1,10.90,9.90,4.89
387,0,3138124,4726,43.29,28742.35,2,3160470,22346,3138124,4726,43.29,74.27,28742.35,1,9.62,9.90,4.56
388,0,3143462,5338,48.89,28791.25,2,3163139,19677,3143462,5338,48.89,74.20,28791.25,0,9.32,9.90,4.39
389,0,3143462,0,0.00,28791.25,2,3165805,22343,3143462,0,0.00,74.01,28791.25,1,10.51,9.51,4.64
390,0,3143462,0,0.00,28791.25,2,3168101,24639,3143462,0,0.00,73.82,28791.25,0,9.78,8.78,4.42
391,0,3143462,0,0.00,28791.25,2,3170108,26646,3143462,0,0.00,73.63,28791.25,1,9.78,8.78,4.67
392,0,3147582,4120,37.74,28828.98,2,3172168,24586,3147582,4120,37.74,73.54,28828.98,0,8.54,8.78,4.36
393,0,3152046,4464,40.89,28869.87,2,3174400,22354,3152046,4464,40.89,73.46,28869.87,0,8.58,8.78,4.60
394,0,3156820,4774,43.73,28913.59,2,3176787,19967,3156820,4774,43.73,73.38,28913.59,1,8.62,8.78,4.84
395,0,3162058,5238,47.98,28961.57,2,3179406,17348,3162058,5238,47.98,73.32,28961.57,0,7.83,8.78,4.33
396,0,3168902,6844,62.68,29024.25,2,3182828,13926,3168902,6844,62.68,73.29,29024.25,0,8.74,8.78,4.58
397,0,3168902,0,0.00,29024.25,2,3186384,17482,3168902,0,0.00,73.11,29024.25,1,9.08,8.08,4.82
398,0,3176630,7728,70.78,29095.03,2,3190248,13618,3176630,7728,70.78,73.10,29095.03,0,7.81,8.08,4.50
399,0,3191544,14914,136.60,29231.63,2,3197705,6161,3191544,14914,136.60,73.26,29231.63,0,7.88,8.08,4.74
400,0,3191544,0,0.00,29231.63,2,3204646,13102,3191544,0,0.00,73.08,29231.63,1,10.02,9.02,4.97
401,0,3206444,14900,136.47,29368.10,2,3212096,5652,3206444,14900,136.47,73.24,29368.10,0,8.68,9.02,4.63
402,0,3206444,0,0.00,29368.10,2,3219677,13233,3206444,0,0.00,73.05,29368.10,1,10.81,9.81,4.87
403,0,3220292,13848,126.84,29494.94,2,3226601,6309,3220292,13848,126.84,73.19,29494.94,0,9.33,9.81,4.46
404,0,3220292,0,0.00,29494.94,2,3233493,13201,3220292,0,0.00,73.01,29494.94,1,11.17,10.17,4.70
405,0,3220292,0,0.00,29494.94,2,3237865,17573,3220292,0,0.00,72.83,29494.94,1,10.73,9.73,4.62
406,0,3220292,0,0.00,29494.94,2,3240994,20702,3220292,0,0.00,72.65,29494.94,0,9.93,8.93,4.50
407,0,3220292,0,0.00,29494.94,2,3243276,22984,3220292,0,0.00,72.47,29494.94,1,10.09,9.09,4.74
408,0,3220292,0,0.00,29494.94,2,3245217,24925,3220292,0,0.00,72.29,29494.94,1,9.35,8.35,4.47
409,0,3220292,0,0.00,29494.94,2,3246980,26688,3220292,0,0.00,72.11,29494.94,0,8.80,8.00,4.41
410,0,3223814,3522,32.26,29527.20,2,3248741,24927,3223814,3522,32.26,72.02,29527.20,1,8.80,9.80,4.65
411,0,3227620,3806,34.86,29562.06,2,3250644,23024,3227620,3806,34.86,71.93,29562.06,0,7.84,9.80,4.46
412,0,3231746,4126,37.79,29599.85,2,3252707,20961,3231746,4126,37.79,71.84,29599.85,1,8.24,9.80,4.69
413,0,3236564,4818,44.13,29643.97,2,3255116,18552,3236564,4818,44.13,71.78,29643.97,1,7.84,9.80,4.49
414,0,3242614,6050,55.41,29699.39,2,3258141,15527,3242614,6050,55.41,71.74,29699.39,0,7.32,9.80,4.34
415,0,3252158,9544,87.41,29786.80,2,3262913,10755,3252158,9544,87.41,71.78,29786.80,0,7.37,9.80,4.57
416,0,3269434,17276,158.23,29945.03,2,3271551,2117,3269434,17276,158.23,71.98,29945.03,1,7.46,9.80,4.80
417,0,3304073,34639,317.26,30262.29,2,3304073,0,3304073,34639,317.26,72.57,30262.29,0,6.47,9.80,4.55
418,0,3339148,35075,321.26,30583.55,2,3339148,0,3339148,35075,321.26,73.17,30583.55,0,8.77,9.80,4.77
419,0,3339148,0,0.00,30583.55,2,3350076,10928,3339148,0,0.00,72.99,30583.55,1,11.09,10.09,5.00
420,0,3339148,0,0.00,30583.55,2,3356163,17015,3339148,0,0.00,72.82,30583.55,1,10.32,9.32,4.91
421,0,3349192,10044,91.99,30675.54,2,3361185,11993,3349192,10044,91.99,72.86,30675.54,0,9.00,9.32,4.58
422,0,3365616,16424,150.43,30825.97,2,3369397,3781,3365616,16424,150.43,73.05,30825.97,1,9.09,9.32,4.81
423,0,3365616,0,0.00,30825.97,2,3378532,12916,3365616,0,0.00,72.87,30825.97,0,10.14,9.14,4.58
424,0,3365616,0,0.00,30825.97,2,3383878,18262,3365616,0,0.00,72.70,30825.97,1,10.14,9.14,4.80
425,0,3365616,0,0.00,30825.97,2,3387084,21468,3365616,0,0.00,72.53,30825.97,0,9.57,8.57,4.60
426,0,3365616,0,0.00,30825.97,2,3389585,23969,3365616,0,0.00,72.36,30825.97,1,10.04,9.04,4.82
427,0,3370402,4786,43.84,30869.81,2,3391978,21576,3370402,4786,43.84,72.29,30869.81,0,8.71,9.04,4.40
428,0,3375814,5412,49.57,30919.38,2,3394684,18870,3375814,5412,49.57,72.24,30919.38,1,8.75,9.04,4.63
429,0,3382854,7040,64.48,30983.86,2,3398204,15350,3382854,7040,64.48,72.22,30983.86,1,7.72,9.04,4.31
430,0,3394066,11212,102.69,31086.55,2,3403810,9744,3394066,11212,102.69,72.29,31086.55,0,6.73,9.04,4.01
431,0,3418983,24917,228.22,31314.77,2,3418983,0,3418983,24917,228.22,72.66,31314.77,1,6.88,9.04,4.24
432,0,3454170,35187,322.28,31637.05,2,3454170,0,3454170,35187,322.28,73.23,31637.05,0,6.01,9.04,3.89
433,0,3488475,34305,314.20,31951.25,2,3488475,0,3488475,34305,314.20,73.79,31951.25,1,8.33,9.04,4.12
434,0,3523701,35226,322.64,32273.89,2,3523701,0,3523701,35226,322.64,74.36,32273.89,0,7.02,9.04,3.67
435,0,3523701,0,0.00,32273.89,2,3534611,10910,3523701,0,0.00,74.19,32273.89,0,9.31,8.31,3.89
436,0,3523701,0,0.00,32273.89,2,3540366,16665,3523701,0,0.00,74.02,32273.89,0,10.35,9.35,4.12
437,0,3523701,0,0.00,32273.89,2,3544916,21215,3523701,0,0.00,73.85,32273.89,1,10.35,9.35,4.34
438,0,3531963,8262,75.67,32349.56,2,3549047,17084,3531963,8262,75.67,73.86,32349.56,0,8.29,9.35,3.73
439,0,3540247,8284,75.87,32425.43,2,3553189,12942,3540247,8284,75.87,73.86,32425.43,1,8.36,9.35,3.95
440,0,3551583,11336,103.83,32529.26,2,3558857,7274,3551583,11336,103.83,73.93,32529.26,0,7.25,9.35,3.59
441,0,3582251,30668,280.89,32810.15,2,3582251,0,3582251,30668,280.89,74.40,32810.15,1,8.06,9.35,3.81
442,0,3617623,35372,323.98,33134.13,2,3617623,0,3617623,35372,323.98,74.96,33134.13,0,8.42,9.35,3.25
443,0,3617623,0,0.00,33134.13,2,3628334,10711,3617623,0,0.00,74.79,33134.13,0,10.78,9.78,3.47
444,0,3617623,0,0.00,33134.13,2,3633947,16324,3617623,0,0.00,74.63,33134.13,1,12.48,11.48,3.68
445,0,3627611,9988,91.48,33225.61,2,3638941,11330,3627611,9988,91.48,74.66,33225.61,1,11.31,11.48,3.36
446,0,3646381,18770,171.92,33397.52,2,3648326,1945,3646381,18770,171.92,74.88,33397.52,0,10.29,11.48,3.14
447,0,3679459,33078,302.96,33700.49,2,3679459,0,3679459,33078,302.96,75.39,33700.49,1,10.96,11.48,3.36
448,0,3712114,32655,299.09,33999.58,2,3712114,0,3712114,32655,299.09,75.89,33999.58,0,11.17,11.48,2.96
449,0,3712114,0,0.00,33999.58,2,3722764,10650,3712114,0,0.00,75.72,33999.58,1,11.63,10.63,3.17
450,0,3712114,0,0.00,33999.58,2,3728675,16561,3712114,0,0.00,75.55,33999.58,0,11.07,10.07,2.88
451,0,3712114,0,0.00,33999.58,2,3733045,20931,3712114,0,0.00,75.39,33999.58,1,11.23,10.23,3.09
452,0,3712114,0,0.00,33999.58,2,3736956,24842,3712114,0,0.00,75.22,33999.58,1,10.66,9.66,2.86
453,0,3712114,0,0.00,33999.58,2,3740512,28398,3712114,0,0.00,75.05,33999.58,0,10.16,9.16,2.64
454,0,3712114,0,0.00,33999.58,2,3743751,31637,3712114,0,0.00,74.89,33999.58,1,10.16,9.16,2.86
455,0,3712114,0,0.00,33999.58,2,3746427,34313,3712114,0,0.00,74.72,33999.58,0,9.29,8.29,2.56
456,0,3712114,0,0.00,33999.58,2,3749175,37061,3712114,0,0.00,74.56,33999.58,1,9.29,8.29,2.77
457,0,3717558,5444,49.86,34049.44,2,3751897,34339,3717558,5444,49.86,74.51,34049.44,0,7.99,8.29,2.49
458,0,3723032,5474,50.14,34099.58,2,3754634,31602,3723032,5474,50.14,74.45,34099.58,0,8.04,8.29,2.70
459,0,3728470,5438,49.81,34149.39,2,3757353,28883,3728470,5438,49.81,74.40,34149.39,1,8.08,8.29,2.91
460,0,3733898,5428,49.72,34199.10,2,3760067,26169,3733898,5428,49.72,74.35,34199.10,0,6.38,8.29,2.46
461,0,3739114,5216,47.77,34246.88,2,3762675,23561,3739114,5216,47.77,74.29,34246.88,1,6.43,8.29,2.67
462,0,3744300,5186,47.50,34294.38,2,3765268,20968,3744300,5186,47.50,74.23,34294.38,1,5.37,8.29,2.46
463,0,3749470,5170,47.35,34341.73,2,3767853,18383,3749470,5170,47.35,74.17,34341.73,1,4.29,8.29,2.25
464,0,3754946,5476,50.16,34391.88,2,3770591,15645,3754946,5476,50.16,74.12,34391.88,0,3.41,8.29,2.11
465,0,3761428,6482,59.37,34451.25,2,3773832,12404,3761428,6482,59.37,74.09,34451.25,1,3.46,8.29,2.32
466,0,3775464,14036,128.56,34579.81,2,3780850,5386,3775464,14036,128.56,74.21,34579.81,0,2.48,8.29,1.94
467,0,3807919,32455,297.26,34877.07,2,3807919,0,3807919,32455,297.26,74.68,34877.07,0,7.37,8.29,2.15
468,0,3807919,0,0.00,34877.07,2,3818863,10944,3807919,0,0.00,74.52,34877.07,1,9.63,8.63,2.36
469,0,3831411,23492,215.17,35092.23,2,3831411,0,3831411,23492,215.17,74.82,35092.23,0,8.30,8.63,2.05
470,0,3831411,0,0.00,35092.23,2,3842606,11195,3831411,0,0.00,74.66,35092.23,1,9.06,8.06,2.26
471,0,3831411,0,0.00,35092.23,2,3847934,16523,3831411,0,0.00,74.51,35092.23,0,8.25,8.00,1.80
472,0,3841727,10316,94.49,35186.71,2,3853092,11365,3841727,10316,94.49,74.55,35186.71,0,8.67,9.67,2.01
473,0,3862393,20666,189.28,35376.00,2,3863425,1032,3862393,20666,189.28,74.79,35376.00,1,9.09,9.67,2.22
474,0,3897195,34802,318.75,35694.75,2,3897195,0,3897195,34802,318.75,75.31,35694.75,0,8.81,9.67,1.63
475,0,3932062,34867,319.35,36014.10,2,3932062,0,3932062,34867,319.35,75.82,36014.10,1,9.12,9.67,1.83
476,0,3932062,0,0.00,36014.10,2,3943046,10984,3932062,0,0.00,75.66,36014.10,0,9.87,8.87,1.47
477,0,3932062,0,0.00,36014.10,2,3948995,16933,3932062,0,0.00,75.50,36014.10,1,11.87,10.87,1.68
478,0,3942330,10268,94.05,36108.15,2,3954129,11799,3942330,10268,94.05,75.54,36108.15,0,10.20,10.87,1.27
479,0,3960622,18292,167.54,36275.69,2,3963275,2653,3960622,18292,167.54,75.73,36275.69,0,10.86,10.87,1.47
480,0,3960622,0,0.00,36275.69,2,3972142,11520,3960622,0,0.00,75.57,36275.69,1,12.46,11.46,1.68
481,0,3978114,17492,160.21,36435.90,2,3980888,2774,3978114,17492,160.21,75.75,36435.90,1,10.97,11.46,1.34
482,0,4011328,33214,304.21,36740.11,2,4011328,0,4011328,33214,304.21,76.22,36740.11,0,10.13,11.46,1.00
483,0,4011328,0,0.00,36740.11,2,4022039,10711,4011328,0,0.00,76.07,36740.11,0,11.47,10.47,1.20
484,0,4011328,0,0.00,36740.11,2,4028155,16827,4011328,0,0.00,75.91,36740.11,1,11.91,10.91,1.41
485,0,4021246,9918,90.84,36830.95,2,4033114,11868,4021246,9918,90.84,75.94,36830.95,1,10.11,10.91,0.96
486,0,4038360,17114,156.75,36987.70,2,4041671,3311,4038360,17114,156.75,76.11,36987.70,0,9.45,10.91,0.90
487,0,4038360,0,0.00,36987.70,2,4050437,12077,4038360,0,0.00,75.95,36987.70,1,11.61,10.61,1.10
488,0,4056728,18368,168.23,37155.93,2,4059621,2893,4056728,18368,168.23,76.14,37155.93,1,9.84,10.61,0.67
489,0,4056728,0,0.00,37155.93,2,4068160,11432,4056728,0,0.00,75.98,37155.93,0,10.98,9.98,0.50
490,0,4056728,0,0.00,37155.93,2,4073310,16582,4056728,0,0.00,75.83,37155.93,1,12.11,11.11,0.71
491,0,4056728,0,0.00,37155.93,2,4076651,19923,4056728,0,0.00,75.67,37155.93,0,11.23,10.23,0.50
492,0,4056728,0,0.00,37155.93,2,4079228,22500,4056728,0,0.00,75.52,37155.93,1,11.23,10.23,0.70
493,0,4061702,4974,45.56,37201.49,2,4081715,20013,4061702,4974,45.56,75.46,37201.49,0,9.96,10.23,0.39
494,0,4061702,0,0.00,37201.49,2,4084219,22517,4061702,0,0.00,75.31,37201.49,1,10.42,9.42,0.59
495,0,4066668,4966,45.48,37246.97,2,4086702,20034,4066668,4966,45.48,75.25,37246.97,0,9.19,9.42,0.35
496,0,4072806,6138,56.22,37303.19,2,4089771,16965,4072806,6138,56.22,75.21,37303.19,1,9.23,9.42,0.55
497,0,4081298,8492,77.78,37380.97,2,4094017,12719,4081298,8492,77.78,75.21,37380.97,0,7.96,9.42,0.29
498,0,4094930,13632,124.86,37505.82,2,4100833,5903,4094930,13632,124.86,75.31,37505.82,0,8.03,9.42,0.49
499,0,4124676,29746,272.45,37778.27,2,4124676,0,4124676,29746,272.45,75.71,37778.27,1,8.78,9.42,0.69
500,0,4159469,34793,318.67,38096.94,2,4159469,0,4159469,34793,318.67,76.19,38096.94,1,9.27,9.42,0.62
501,0,4159469,0,0.00,38096.94,2,4170305,10836,4159469,0,0.00,76.04,38096.94,0,11.29,10.29,0.58
502,0,4159469,0,0.00,38096.94,2,4176353,16884,4159469,0,0.00,75.89,38096.94,1,11.86,10.86,0.78
503,0,4159469,0,0.00,38096.94,2,4180957,21488,4159469,0,0.00,75.74,38096.94,1,12.49,11.49,0.69
504,0,4167909,8440,77.30,38174.25,2,4185177,17268,4167909,8440,77.30,75.74,38174.25,0,11.39,11.49,0.51
505,0,4176173,8264,75.69,38249.94,2,4189309,13136,4176173,8264,75.69,75.74,38249.94,1,11.47,11.49,0.71
506,0,4186193,10020,91.77,38341.71,2,4194319,8126,4186193,10020,91.77,75.77,38341.71,0,10.81,11.49,0.56
507,0,4211553,25360,232.27,38573.98,2,4211553,0,4211553,25360,232.27,76.08,38573.98,1,11.15,11.49,0.76
508,0,4211553,0,0.00,38573.98,2,4222766,11213,4211553,0,0.00,75.93,38573.98,0,11.56,10.56,0.46
509,0,4211553,0,0.00,38573.98,2,4228438,16885,4211553,0,0.00,75.78,38573.98,0,11.71,10.71,0.66
510,0,4211553,0,0.00,38573.98,2,4233133,21580,4211553,0,0.00,75.64,38573.98,1,11.71,10.71,0.85
511,0,4219885,8332,76.31,38650.30,2,4237299,17414,4219885,8332,76.31,75.64,38650.30,0,10.37,10.71,0.42
512,0,4219885,0,0.00,38650.30,2,4241077,21192,4219885,0,0.00,75.49,38650.30,1,11.77,10.77,0.61
513,0,4226725,6840,62.65,38712.95,2,4244497,17772,4226725,6840,62.65,75.46,38712.95,0,10.13,10.77,0.22
514,0,4233545,6820,62.46,38775.41,2,4247907,14362,4233545,6820,62.46,75.44,38775.41,1,10.19,10.77,0.42
515,0,4242039,8494,77.80,38853.21,2,4252154,10115,4242039,8494,77.80,75.44,38853.21,0,8.92,10.77,0.08
516,0,4262253,20214,185.14,39038.35,2,4262261,8,4262253,20214,185.14,75.66,39038.35,1,10.61,10.77,0.27
517,0,4296150,33897,310.47,39348.82,2,4296150,0,4296150,33897,310.47,76.11,39348.82,0,9.90,10.77,0.27
518,0,4329560,33410,306.01,39654.82,2,4329560,0,4329560,33410,306.01,76.55,39654.82,0,10.20,10.77,0.19
519,0,4329560,0,0.00,39654.82,2,4340435,10875,4329560,0,0.00,76.41,39654.82,1,11.90,10.90,0.39
520,0,4329560,0,0.00,39654.82,2,4346479,16919,4329560,0,0.00,76.26,39654.82,0,10.98,9.98,0.21
521,0,4329560,0,0.00,39654.82,2,4351172,21612,4329560,0,0.00,76.11,39654.82,1,10.98,9.98,0.40
522,0,4337486,7926,72.59,39727.42,2,4355135,17649,4337486,7926,72.59,76.11,39727.42,0,9.49,9.98,0.09
523,0,4345506,8020,73.46,39800.87,2,4359145,13639,4345506,8020,73.46,76.10,39800.87,1,9.56,9.98,0.29
524,0,4355058,9552,87.49,39888.36,2,4363921,8863,4355058,9552,87.49,76.12,39888.36,1,8.33,9.98,0.29
525,0,4381963,26905,246.43,40134.79,2,4381963,0,4381963,26905,246.43,76.45,40134.79,0,8.42,9.98,0.19
526,0,4416370,34407,315.14,40449.92,2,4416370,0,4416370,34407,315.14,76.90,40449.92,1,9.13,9.98,0.38
527,0,4416370,0,0.00,40449.92,2,4426975,10605,4416370,0,0.00,76.76,40449.92,0,10.65,9.65,0.12
528,0,4416370,0,0.00,40449.92,2,4432766,16396,4416370,0,0.00,76.61,40449.92,1,12.58,11.58,0.31
529,0,4426644,10274,94.10,40544.02,2,4437903,11259,4426644,10274,94.10,76.64,40544.02,0,11.49,11.58,0.07
530,0,4426644,0,0.00,40544.02,2,4442625,15981,4426644,0,0.00,76.50,40544.02,0,11.59,10.59,0.26
531,0,4426644,0,0.00,40544.02,2,4446234,19590,4426644,0,0.00,76.35,40544.02,1,11.59,10.59,0.44
532,0,4433070,6426,58.86,40602.88,2,4449447,16377,4433070,6426,58.86,76.32,40602.88,0,10.23,10.59,0.19
533,0,4441090,8020,73.46,40676.34,2,4453457,12367,4441090,8020,73.46,76.32,40676.34,1,10.29,10.59,0.38
534,0,4458288,17198,157.52,40833.85,2,4462056,3768,4458288,17198,157.52,76.47,40833.85,0,9.29,10.59,0.12
535,0,4490942,32654,299.08,41132.93,2,4490942,0,4490942,32654,299.08,76.88,41132.93,1,10.15,10.59,0.31
536,0,4490942,0,0.00,41132.93,2,4501405,10463,4490942,0,0.00,76.74,41132.93,1,11.01,10.01,0.03
537,0,4490942,0,0.00,41132.93,2,4506998,16056,4490942,0,0.00,76.60,41132.93,0,11.09,10.09,0.03
538,0,4490942,0,0.00,41132.93,2,4511293,20351,4490942,0,0.00,76.46,41132.93,1,11.09,10.09,0.19
539,0,4498568,7626,69.85,41202.78,2,4515106,16538,4498568,7626,69.85,76.44,41202.78,0,9.98,10.09,0.01
540,0,4507142,8574,78.53,41281.31,2,4519393,12251,4507142,8574,78.53,76.45,41281.31,1,10.05,10.09,0.20
541,0,4521914,14772,135.30,41416.61,2,4526779,4865,4521914,14772,135.30,76.56,41416.61,1,8.33,10.09,0.20
542,0,4554638,32724,299.72,41716.33,2,4554638,0,4554638,32724,299.72,76.97,41716.33,0,8.47,10.09,0.18
543,0,4588269,33631,308.03,42024.36,2,4588269,0,4588269,33631,308.03,77.39,42024.36,1,9.46,10.09,0.37
544,0,4588269,0,0.00,42024.36,2,4598738,10469,4588269,0,0.00,77.25,42024.36,0,11.43,10.43,0.00
545,0,4588269,0,0.00,42024.36,2,4604436,16167,4588269,0,0.00,77.11,42024.36,0,11.72,10.72,0.19
546,0,4588269,0,0.00,42024.36,2,4608719,20450,4588269,0,0.00,76.97,42024.36,1,13.43,12.43,0.37
547,0,4596119,7850,71.90,42096.26,2,4612644,16525,4596119,7850,71.90,76.96,42096.26,0,11.77,12.43,0.03
548,0,4604635,8516,78.00,42174.26,2,4616902,12267,4604635,8516,78.00,76.96,42174.26,1,11.84,12.43,0.21
549,0,4617917,13282,121.65,42295.91,2,4623543,5626,4617917,13282,121.65,77.04,42295.91,0,10.87,12.43,0.21
550,0,4648168,30251,277.07,42572.98,2,4648168,0,4648168,30251,277.07,77.41,42572.98,1,10.99,12.43,0.18
551,0,4679739,31571,289.16,42862.14,2,4679739,0,4679739,31571,289.16,77.79,42862.14,0,12.07,12.43,0.18
552,0,4711701,31962,292.74,43154.88,2,4711701,0,4711701,31962,292.74,78.18,43154.88,1,12.36,12.43,0.18
553,0,4711701,0,0.00,43154.88,2,4722031,10330,4711701,0,0.00,78.04,43154.88,0,13.68,12.68,0.18
554,0,4711701,0,0.00,43154.88,2,4727545,15844,4711701,0,0.00,77.90,43154.88,1,13.68,12.68,0.18
555,0,4721945,10244,93.83,43248.71,2,4732667,10722,4721945,10244,93.83,77.93,43248.71,0,11.68,12.68,0.18
556,0,4740489,18544,169.85,43418.55,2,4741939,1450,4740489,18544,169.85,78.09,43418.55,1,11.77,12.68,0.18
557,0,4774213,33724,308.88,43727.44,2,4774213,0,4774213,33724,308.88,78.51,43727.44,0,12.19,12.68,0.18
558,0,4805324,31111,284.95,44012.39,2,4805324,0,4805324,31111,284.95,78.88,44012.39,1,12.49,12.68,0.18
559,0,4805324,0,0.00,44012.39,2,4815639,10315,4805324,0,0.00,78.73,44012.39,0,13.65,12.65,0.18
560,0,4805324,0,0.00,44012.39,2,4821488,16164,4805324,0,0.00,78.59,44012.39,0,13.65,12.65,0.18
561,0,4805324,0,0.00,44012.39,2,4826095,20771,4805324,0,0.00,78.45,44012.39,1,13.83,12.83,0.36
562,0,4813790,8466,77.54,44089.93,2,4830328,16538,4813790,8466,77.54,78.45,44089.93,0,12.17,12.83,0.03
563,0,4821632,7842,71.83,44161.75,2,4834249,12617,4821632,7842,71.83,78.44,44161.75,1,12.61,12.83,0.21
564,0,4833524,11892,108.92,44270.67,2,4840195,6671,4833524,11892,108.92,78.49,44270.67,0,12.16,12.83,0.21
565,0,4861679,28155,257.87,44528.55,2,4861679,0,4861679,28155,257.87,78.81,44528.55,1,12.27,12.83,0.18
566,0,4861679,0,0.00,44528.55,2,4872015,10336,4861679,0,0.00,78.67,44528.55,0,13.08,12.08,0.18
567,0,4861679,0,0.00,44528.55,2,4877569,15890,4861679,0,0.00,78.53,44528.55,1,13.08,12.08,0.18
568,0,4862656,977,8.95,44537.50,2,4881762,19106,4862656,977,8.95,78.41,44537.50,1,12.31,12.81,0.18
569,0,4870832,8176,74.88,44612.38,2,4885850,15018,4870832,8176,74.88,78.40,44612.38,0,12.32,12.81,0.18
570,0,4880060,9228,84.52,44696.90,2,4890464,10404,4880060,9228,84.52,78.42,44696.90,1,12.39,12.81,0.35
571,0,4899344,19284,176.62,44873.52,2,4900106,762,4899344,19284,176.62,78.59,44873.52,0,11.23,12.81,0.16
572,0,4931539,32195,294.88,45168.40,2,4931539,0,4931539,32195,294.88,78.97,45168.40,1,12.13,12.81,0.33
573,0,4963127,31588,289.32,45457.72,2,4963127,0,4963127,31588,289.32,79.33,45457.72,0,12.01,12.81,0.08
574,0,4995706,32579,298.39,45756.11,2,4995706,0,4995706,32579,298.39,79.71,45756.11,1,12.29,12.81,0.25
575,0,4995706,0,0.00,45756.11,2,5006318,10612,4995706,0,0.00,79.58,45756.11,0,16.24,15.24,0.25
576,0,4995706,0,0.00,45756.11,2,5012562,16856,4995706,0,0.00,79.44,45756.11,1,16.24,15.24,0.17
577,0,4995706,0,0.00,45756.11,2,5017303,21597,4995706,0,0.00,79.30,45756.11,0,15.58,14.58,0.17
578,0,4995706,0,0.00,45756.11,2,5021348,25642,4995706,0,0.00,79.16,45756.11,0,15.58,14.58,0.17
579,0,4995706,0,0.00,45756.11,2,5024760,29054,4995706,0,0.00,79.03,45756.11,1,15.58,14.58,0.35
580,0,5002102,6396,58.58,45814.69,2,5027958,25856,5002102,6396,58.58,78.99,45814.69,0,14.41,14.58,0.16
581,0,5002102,0,0.00,45814.69,2,5031192,29090,5002102,0,0.00,78.85,45814.69,1,14.78,13.78,0.33
582,0,5008046,5944,54.44,45869.13,2,5034164,26118,5008046,5944,54.44,78.81,45869.13,0,13.21,13.78,0.03
583,0,5013912,5866,53.73,45922.86,2,5037097,23185,5013912,5866,53.73,78.77,45922.86,0,13.26,13.78,0.20
584,0,5019662,5750,52.66,45975.53,2,5039972,20310,5019662,5750,52.66,78.73,45975.53,1,13.50,13.78,0.38
585,0,5025356,5694,52.15,46027.68,2,5042819,17463,5025356,5694,52.15,78.68,46027.68,1,12.17,13.78,0.01
586,0,5031248,5892,53.97,46081.64,2,5045765,14517,5031248,5892,53.97,78.64,46081.64,1,10.20,13.78,0.01
587,0,5039042,7794,71.39,46153.03,2,5049662,10620,5039042,7794,71.39,78.63,46153.03,0,10.25,13.78,0.17
588,0,5056668,17626,161.44,46314.47,2,5058475,1807,5056668,17626,161.44,78.77,46314.47,1,10.65,13.78,0.34
589,0,5088484,31816,291.41,46605.88,2,5088484,0,5088484,31816,291.41,79.13,46605.88,0,11.84,13.78,0.24
590,0,5088484,0,0.00,46605.88,2,5098976,10492,5088484,0,0.00,78.99,46605.88,1,14.13,13.13,0.40
591,0,5108746,20262,185.58,46791.45,2,5109107,361,5108746,20262,185.58,79.17,46791.45,0,12.73,13.13,0.17
592,0,5108746,0,0.00,46791.45,2,5119408,10662,5108746,0,0.00,79.04,46791.45,1,13.29,12.29,0.34
593,0,5111907,3161,28.95,46820.41,2,5125899,13992,5111907,3161,28.95,78.96,46820.41,0,13.10,12.10,0.34
594,0,5111907,0,0.00,46820.41,2,5129952,18045,5111907,0,0.00,78.82,46820.41,1,13.13,12.13,0.17
595,0,5118031,6124,56.09,46876.50,2,5133788,15757,5118031,6124,56.09,78.78,46876.50,0,12.30,11.30,0.17
596,0,5118031,0,0.00,46876.50,2,5137229,19198,5118031,0,0.00,78.65,46876.50,1,12.36,11.36,0.17
597,0,5121856,3825,35.03,46911.53,2,5140432,18576,5121856,3825,35.03,78.58,46911.53,0,11.48,10.48,0.17
598,0,5121856,0,0.00,46911.53,2,5143294,21438,5121856,0,0.00,78.45,46911.53,0,11.51,10.51,0.17
599,0,5121856,0,0.00,46911.53,2,5145875,24019,5121856,0,0.00,78.32,46911.53,1,11.78,10.78,0.33
600,0,5127102,5246,48.05,46959.58,2,5148498,21396,5127102,5246,48.05,78.27,46959.58,1,10.50,10.78,0.14
601,0,5132660,5558,50.91,47010.48,2,5151277,18617,5132660,5558,50.91,78.22,47010.48,0,9.43,10.78,0.14
602,0,5138702,6042,55.34,47065.82,2,5154298,15596,5138702,6042,55.34,78.18,47065.82,1,9.48,10.78,0.17
603,0,5146760,8058,73.80,47139.63,2,5158327,11567,5146760,8058,73.80,78.18,47139.63,0,8.45,10.78,0.17
604,0,5164066,17306,158.51,47298.14,2,5166980,2914,5164066,17306,158.51,78.31,47298.14,1,8.52,10.78,0.17
605,0,5197470,33404,305.95,47604.09,2,5197470,0,5197470,33404,305.95,78.68,47604.09,0,9.43,10.78,0.17
606,0,5231329,33859,310.12,47914.20,2,5231329,0,5231329,33859,310.12,79.07,47914.20,1,9.73,10.78,0.17
607,0,5237453,6124,56.09,47970.29,2,5247240,9787,5237453,6124,56.09,79.03,47970.29,0,12.23,11.23,0.17
608,0,5237453,0,0.00,47970.29,2,5253350,15897,5237453,0,0.00,78.90,47970.29,1,12.28,11.28,0.16
609,0,5237453,0,0.00,47970.29,2,5258365,20912,5237453,0,0.00,78.77,47970.29,0,13.03,12.03,0.16
610,0,5237453,0,0.00,47970.29,2,5262647,25194,5237453,0,0.00,78.64,47970.29,1,13.03,12.03,0.16
611,0,5245163,7710,70.62,48040.91,2,5266502,21339,5245163,7710,70.62,78.63,48040.91,0,11.57,12.03,0.16
612,0,5252621,7458,68.31,48109.22,2,5270231,17610,5252621,7458,68.31,78.61,48109.22,1,11.64,12.03,0.16
613,0,5259933,7312,66.97,48176.19,2,5273887,13954,5259933,7312,66.97,78.59,48176.19,0,10.23,12.03,0.16
614,0,5268313,8380,76.75,48252.94,2,5278077,9764,5268313,8380,76.75,78.59,48252.94,1,10.29,12.03,0.16
615,0,5289696,21383,195.85,48448.79,2,5289696,0,5289696,21383,195.85,78.78,48448.79,0,8.56,12.03,0.16
616,0,5323522,33826,309.82,48758.61,2,5323522,0,5323522,33826,309.82,79.15,48758.61,1,8.75,12.03,0.16
617,0,5356896,33374,305.68,49064.28,2,5356896,0,5356896,33374,305.68,79.52,49064.28,0,10.50,12.03,0.16
618,0,5390170,33274,304.76,49369.04,2,5390170,0,5390170,33274,304.76,79.89,49369.04,0,10.80,12.03,0.16
619,0,5390170,0,0.00,49369.04,2,5400961,10791,5390170,0,0.00,79.76,49369.04,1,14.08,13.08,0.32
620,0,5411072,20902,191.44,49560.48,2,5411412,340,5411072,20902,191.44,79.94,49560.48,0,12.33,13.08,0.01
621,0,5443952,32880,301.15,49861.64,2,5443952,0,5443952,32880,301.15,80.29,49861.64,1,12.89,13.08,0.17
622,0,5461170,17218,157.70,50019.34,2,5467105,5935,5461170,17218,157.70,80.42,50019.34,0,13.29,12.29,0.17
623,0,5461170,0,0.00,50019.34,2,5474611,13441,5461170,0,0.00,80.29,50019.34,1,13.45,12.45,0.16
624,0,5476000,14830,135.83,50155.17,2,5482026,6026,5476000,14830,135.83,80.38,50155.17,0,12.32,12.45,0.16
625,0,5476000,0,0.00,50155.17,2,5489782,13782,5476000,0,0.00,80.25,50155.17,1,12.46,11.46,0.16
626,0,5491812,15812,144.82,50299.99,2,5497688,5876,5491812,15812,144.82,80.35,50299.99,0,11.39,11.46,0.04
627,0,5491812,0,0.00,50299.99,2,5505256,13444,5491812,0,0.00,80.22,50299.99,1,12.06,11.06,0.19
628,0,5491940,128,1.17,50301.16,2,5509561,17621,5491940,128,1.17,80.10,50301.16,1,12.51,12.87,0.19
629,0,5500920,8980,82.25,50383.41,2,5514051,13131,5500920,8980,82.25,80.10,50383.41,0,12.51,12.87,0.16
630,0,5500920,0,0.00,50383.41,2,5518705,17785,5500920,0,0.00,79.97,50383.41,1,12.88,11.88,0.32
631,0,5500920,0,0.00,50383.41,2,5521801,20881,5500920,0,0.00,79.85,50383.41,0,13.55,12.55,0.20
632,0,5500920,0,0.00,50383.41,2,5524325,23405,5500920,0,0.00,79.72,50383.41,1,13.55,12.55,0.36
633,0,5505914,4994,45.74,50429.15,2,5526822,20908,5505914,4994,45.74,79.67,50429.15,0,12.20,12.55,0.16
634,0,5511454,5540,50.74,50479.89,2,5529592,18138,5511454,5540,50.74,79.62,50479.89,1,12.25,12.55,0.32
635,0,5518412,6958,63.73,50543.62,2,5533071,14659,5518412,6958,63.73,79.60,50543.62,0,10.65,12.55,0.05
636,0,5528852,10440,95.62,50639.24,2,5538291,9439,5528852,10440,95.62,79.62,50639.24,1,10.71,12.55,0.20
637,0,5548068,19216,176.00,50815.24,2,5548068,0,5548068,19216,176.00,79.77,50815.24,0,10.57,12.55,0.10
638,0,5581721,33653,308.23,51123.47,2,5581721,0,5581721,33653,308.23,80.13,51123.47,0,11.12,12.55,0.26
639,0,5614178,32457,297.28,51420.75,2,5614178,0,5614178,32457,297.28,80.47,51420.75,1,12.35,12.55,0.41
640,0,5646321,32143,294.40,51715.15,2,5646321,0,5646321,32143,294.40,80.80,51715.15,0,11.83,12.55,0.15
641,0,5646321,0,0.00,51715.15,2,5657038,10717,5646321,0,0.00,80.68,51715.15,0,15.13,14.13,0.30
642,0,5646321,0,0.00,51715.15,2,5662811,16490,5646321,0,0.00,80.55,51715.15,1,17.28,16.28,0.46
643,0,5655739,9418,86.26,51801.41,2,5667520,11781,5655739,9418,86.26,80.56,51801.41,0,16.24,16.28,0.34
644,0,5655739,0,0.00,51801.41,2,5672024,16285,5655739,0,0.00,80.44,51801.41,1,16.32,15.32,0.50
645,0,5655739,0,0.00,51801.41,2,5675609,19870,5655739,0,0.00,80.31,51801.41,0,16.59,15.59,0.28
646,0,5655739,0,0.00,51801.41,2,5678814,23075,5655739,0,0.00,80.19,51801.41,1,16.88,15.88,0.44
647,0,5661773,6034,55.27,51856.68,2,5681831,20058,5661773,6034,55.27,80.15,51856.68,1,15.13,15.88,0.14
648,0,5667963,6190,56.69,51913.37,2,5684926,16963,5667963,6190,56.69,80.11,51913.37,0,14.62,15.88,0.15
649,0,5675399,7436,68.11,51981.48,2,5688644,13245,5675399,7436,68.11,80.09,51981.48,1,14.68,15.88,0.31
650,0,5688505,13106,120.04,52101.52,2,5695197,6692,5688505,13106,120.04,80.16,52101.52,1,13.76,15.88,0.21
651,0,5714983,26478,242.51,52344.03,2,5714983,0,5714983,26478,242.51,80.41,52344.03,0,14.18,15.88,0.15
652,0,5747057,32074,293.77,52637.80,2,5747057,0,5747057,32074,293.77,80.73,52637.80,1,15.44,15.88,0.30
653,0,5747057,0,0.00,52637.80,2,5758070,11013,5747057,0,0.00,80.61,52637.80,0,17.06,16.06,0.27
654,0,5747057,0,0.00,52637.80,2,5763694,16637,5747057,0,0.00,80.49,52637.80,1,17.06,16.06,0.42
655,0,5747057,0,0.00,52637.80,2,5768155,21098,5747057,0,0.00,80.36,52637.80,0,16.32,15.32,0.26
656,0,5747057,0,0.00,52637.80,2,5772285,25228,5747057,0,0.00,80.24,52637.80,0,17.60,16.60,0.41
657,0,5747057,0,0.00,52637.80,2,5775964,28907,5747057,0,0.00,80.12,52637.80,1,17.63,16.63,0.56
658,0,5753915,6858,62.81,52700.61,2,5779393,25478,5753915,6858,62.81,80.09,52700.61,0,16.48,16.63,0.38
659,0,5760393,6478,59.33,52759.95,2,5782632,22239,5760393,6478,59.33,80.06,52759.95,1,16.57,16.63,0.53
660,0,5766937,6544,59.94,52819.88,2,5785904,18967,5766937,6544,59.94,80.03,52819.88,0,15.44,16.63,0.38
661,0,5773359,6422,58.82,52878.70,2,5789115,15756,5773359,6422,58.82,80.00,52878.70,1,15.49,16.63,0.53
662,0,5779771,6412,58.73,52937.43,2,5792321,12550,5779771,6412,58.73,79.97,52937.43,1,14.16,16.63,0.33
663,0,5790569,10798,98.90,53036.33,2,5797720,7151,5790569,10798,98.90,79.99,53036.33,0,13.30,16.63,0.25
664,0,5817553,26984,247.15,53283.48,2,5817553,0,5817553,26984,247.15,80.25,53283.48,1,13.39,16.63,0.40
665,0,5849621,32068,293.71,53577.20,2,5849621,0,5849621,32068,293.71,80.57,53577.20,1,14.22,16.63,0.32
666,0,5881632,32011,293.19,53870.39,2,5881632,0,5881632,32011,293.19,80.89,53870.39,0,14.37,16.63,0.14
667,0,5881632,0,0.00,53870.39,2,5892123,10491,5881632,0,0.00,80.77,53870.39,0,16.74,15.74,0.29
668,0,5881632,0,0.00,53870.39,2,5898242,16610,5881632,0,0.00,80.64,53870.39,1,18.28,17.28,0.44
669,0,5881632,0,0.00,53870.39,2,5902946,21314,5881632,0,0.00,80.52,53870.39,0,17.76,16.76,0.17
670,0,5881632,0,0.00,53870.39,2,5907033,25401,5881632,0,0.00,80.40,53870.39,1,18.06,17.06,0.32
671,0,5889006,7374,67.54,53937.93,2,5910720,21714,5889006,7374,67.54,80.38,53937.93,0,16.46,17.06,0.07
672,0,5896412,7406,67.83,54005.76,2,5914423,18011,5896412,7406,67.83,80.37,54005.76,1,16.52,17.06,0.22
673,0,5903446,7034,64.43,54070.18,2,5917940,14494,5903446,7034,64.43,80.34,54070.18,0,16.69,17.06,0.22
674,0,5910580,7134,65.34,54135.52,2,5921507,10927,5910580,7134,65.34,80.32,54135.52,1,16.75,17.06,0.15
675,0,5926136,15556,142.48,54278.00,2,5929285,3149,5926136,15556,142.48,80.41,54278.00,0,15.37,17.06,0.15
676,0,5959107,32971,301.98,54579.98,2,5959107,0,5959107,32971,301.98,80.74,54579.98,1,15.51,17.06,0.15
677,0,5991871,32764,300.09,54880.07,2,5991871,0,5991871,32764,300.09,81.06,54880.07,0,15.18,17.06,0.15
678,0,6024241,32370,296.48,55176.55,2,6024241,0,6024241,32370,296.48,81.38,55176.55,0,15.48,17.06,0.15
679,0,6024241,0,0.00,55176.55,2,6034854,10613,6024241,0,0.00,81.26,55176.55,0,18.80,17.80,0.29
680,0,6024241,0,0.00,55176.55,2,6041002,16761,6024241,0,0.00,81.14,55176.55,1,19.95,18.95,0.44
681,0,6034891,10650,97.54,55274.10,2,6046327,11436,6034891,10650,97.54,81.17,55274.10,1,18.94,18.95,0.13
682,0,6050409,15518,142.13,55416.23,2,6054086,3677,6050409,15518,142.13,81.26,55416.23,0,17.58,18.95,0.13
683,0,6081542,31133,285.15,55701.38,2,6081542,0,6081542,31133,285.15,81.55,55701.38,0,17.72,18.95,0.15
684,0,6081542,0,0.00,55701.38,2,6092008,10466,6081542,0,0.00,81.43,55701.38,1,18.99,17.99,0.29
685,0,6082502,960,8.79,55710.17,2,6097760,15258,6082502,960,8.79,81.33,55710.17,1,16.70,17.15,0.29
686,0,6094132,11630,106.52,55816.69,2,6103575,9443,6094132,11630,106.52,81.37,55816.69,0,16.71,17.15,0.15
687,0,6116647,22515,206.22,56022.91,2,6116647,0,6116647,22515,206.22,81.55,56022.91,1,16.81,17.15,0.29
688,0,6116647,0,0.00,56022.91,2,6127118,10471,6116647,0,0.00,81.43,56022.91,0,17.68,16.68,0.11
689,0,6116647,0,0.00,56022.91,2,6133107,16460,6116647,0,0.00,81.31,56022.91,1,19.40,18.40,0.26
690,0,6127159,10512,96.28,56119.19,2,6138363,11204,6127159,10512,96.28,81.33,56119.19,0,18.27,18.40,0.07
691,0,6145105,17946,164.37,56283.56,2,6147336,2231,6145105,17946,164.37,81.45,56283.56,1,18.36,18.40,0.21
692,0,6145105,0,0.00,56283.56,2,6156186,11081,6145105,0,0.00,81.33,56283.56,1,19.79,18.79,0.10
693,0,6162567,17462,159.94,56443.50,2,6164917,2350,6162567,17462,159.94,81.45,56443.50,0,18.64,18.79,0.10
694,0,6162567,0,0.00,56443.50,2,6174033,11466,6162567,0,0.00,81.33,56443.50,1,18.80,17.80,0.14
695,0,6177534,14967,137.08,56580.58,2,6181756,4222,6177534,14967,137.08,81.41,56580.58,0,17.97,16.97,0.14
696,0,6177534,0,0.00,56580.58,2,6189348,11814,6177534,0,0.00,81.29,56580.58,1,18.11,17.11,0.14
697,0,6177534,0,0.00,56580.58,2,6194177,16643,6177534,0,0.00,81.18,56580.58,0,18.15,17.15,0.14
698,0,6177534,0,0.00,56580.58,2,6197264,19730,6177534,0,0.00,81.06,56580.58,0,18.15,17.15,0.14
699,0,6177534,0,0.00,56580.58,2,6199865,22331,6177534,0,0.00,80.95,56580.58,0,18.15,17.15,0.29
700,0,6177534,0,0.00,56580.58,2,6202270,24736,6177534,0,0.00,80.83,56580.58,1,18.74,17.74,0.43
701,0,6182460,4926,45.12,56625.70,2,6204733,22273,6182460,4926,45.12,80.78,56625.70,1,17.43,17.74,0.26
702,0,6188044,5584,51.14,56676.84,2,6207525,19481,6188044,5584,51.14,80.74,56676.84,0,17.32,17.74,0.13
703,0,6194008,5964,54.62,56731.46,2,6210507,16499,6194008,5964,54.62,80.70,56731.46,1,17.72,17.74,0.27
704,0,6201094,7086,64.90,56796.37,2,6214050,12956,6201094,7086,64.90,80.68,56796.37,1,16.99,17.74,0.14
705,0,6214516,13422,122.93,56919.30,2,6220761,6245,6214516,13422,122.93,80.74,56919.30,0,16.48,17.74,0.15
706,0,6214516,0,0.00,56919.30,2,6228133,13617,6214516,0,0.00,80.62,56919.30,1,17.80,16.80,0.29
707,0,6214516,0,0.00,56919.30,2,6232718,18202,6214516,0,0.00,80.51,56919.30,0,17.61,16.61,0.18
708,0,6214516,0,0.00,56919.30,2,6235934,21418,6214516,0,0.00,80.39,56919.30,1,18.87,17.87,0.33
709,0,6220382,5866,53.73,56973.03,2,6238867,18485,6220382,5866,53.73,80.36,56973.03,0,17.86,17.87,0.20
710,0,6220382,0,0.00,56973.03,2,6241755,21373,6220382,0,0.00,80.24,56973.03,1,17.92,16.92,0.35
711,0,6226124,5742,52.59,57025.62,2,6244626,18502,6226124,5742,52.59,80.20,57025.62,1,16.58,16.92,0.17
712,0,6233808,7684,70.38,57096.00,2,6248468,14660,6233808,7684,70.38,80.19,57096.00,0,15.71,16.92,0.10
713,0,6233808,0,0.00,57096.00,2,6252359,18551,6233808,0,0.00,80.08,57096.00,1,17.50,16.50,0.24
714,0,6233808,0,0.00,57096.00,2,6255498,21690,6233808,0,0.00,79.97,57096.00,0,16.98,15.98,0.20
715,0,6233808,0,0.00,57096.00,2,6257947,24139,6233808,0,0.00,79.85,57096.00,1,16.98,15.98,0.34
716,0,6238432,4624,42.35,57138.35,2,6260259,21827,6238432,4624,42.35,79.80,57138.35,0,15.43,15.98,0.12
717,0,6244194,5762,52.77,57191.12,2,6263140,18946,6244194,5762,52.77,79.76,57191.12,0,15.47,15.98,0.26
718,0,6251606,7412,67.89,57259.01,2,6266846,15240,6251606,7412,67.89,79.75,57259.01,0,15.53,15.98,0.40
719,0,6251606,0,0.00,57259.01,2,6270723,19117,6251606,0,0.00,79.64,57259.01,1,16.03,15.03,0.54
720,0,6258208,6602,60.47,57319.48,2,6274024,15816,6258208,6602,60.47,79.61,57319.48,0,14.38,15.03,0.28
721,0,6267938,9730,89.12,57408.60,2,6278889,10951,6267938,9730,89.12,79.62,57408.60,1,14.56,15.03,0.42
722,0,6284284,16346,149.71,57558.31,2,6287062,2778,6284284,16346,149.71,79.72,57558.31,0,14.22,15.03,0.29
723,0,6284284,0,0.00,57558.31,2,6295450,11166,6284284,0,0.00,79.61,57558.31,1,15.41,14.41,0.43
724,0,6284284,0,0.00,57558.31,2,6300896,16612,6284284,0,0.00,79.50,57558.31,1,15.28,14.28,0.25
725,0,6284284,0,0.00,57558.31,2,6304175,19891,6284284,0,0.00,79.39,57558.31,0,14.41,13.41,0.11
726,0,6284284,0,0.00,57558.31,2,6306502,22218,6284284,0,0.00,79.28,57558.31,1,14.47,13.47,0.25
727,0,6289076,4792,43.89,57602.20,2,6308898,19822,6289076,4792,43.89,79.23,57602.20,0,13.11,13.47,0.07
728,0,6295184,6108,55.94,57658.14,2,6311952,16768,6295184,6108,55.94,79.20,57658.14,0,13.17,13.47,0.21
729,0,6304506,9322,85.38,57743.53,2,6316613,12107,6304506,9322,85.38,79.21,57743.53,1,13.22,13.47,0.35
730,0,6320656,16150,147.92,57891.45,2,6324688,4032,6320656,16150,147.92,79.30,57891.45,1,12.30,13.47,0.18
731,0,6351740,31084,284.70,58176.14,2,6351740,0,6351740,31084,284.70,79.58,58176.14,0,11.23,13.47,0.03
732,0,6384404,32664,299.17,58475.32,2,6384404,0,6384404,32664,299.17,79.88,58475.32,1,13.04,13.47,0.16
733,0,6416828,32424,296.97,58772.29,2,6416828,0,6416828,32424,296.97,80.18,58772.29,0,12.95,13.47,0.01
734,0,6416828,0,0.00,58772.29,2,6427226,10398,6416828,0,0.00,80.07,58772.29,1,14.49,13.49,0.14
735,0,6436716,19888,182.16,58954.45,2,6437170,454,6436716,19888,182.16,80.21,58954.45,0,13.39,13.49,0.02
736,0,6436716,0,0.00,58954.45,2,6447483,10767,6436716,0,0.00,80.10,58954.45,1,14.31,13.31,0.16
737,0,6436716,0,0.00,58954.45,2,6452889,16173,6436716,0,0.00,79.99,58954.45,0,13.98,12.98,0.16
738,0,6436716,0,0.00,58954.45,2,6456629,19913,6436716,0,0.00,79.88,58954.45,1,13.98,12.98,0.14
739,0,6444420,7704,70.56,59025.01,2,6460481,16061,6444420,7704,70.56,79.87,59025.01,0,12.79,12.98,0.00
740,0,6453348,8928,81.77,59106.78,2,6464945,11597,6453348,8928,81.77,79.87,59106.78,1,12.86,12.98,0.14
741,0,6467106,13758,126.01,59232.79,2,6471824,4718,6467106,13758,126.01,79.94,59232.79,1,12.40,12.98,0.05
742,0,6493259,26153,239.54,59472.33,2,6493259,0,6493259,26153,239.54,80.15,59472.33,0,11.92,12.98,0.01
743,0,6493259,0,0.00,59472.33,2,6503560,10301,6493259,0,0.00,80.04,59472.33,1,13.75,12.75,0.14
744,0,6514794,21535,197.24,59669.57,2,6514794,0,6514794,21535,197.24,80.20,59669.57,0,12.74,12.75,0.14
745,0,6514794,0,0.00,59669.57,2,6525469,10675,6514794,0,0.00,80.09,59669.57,1,12.93,11.93,0.13
746,0,6515028,234,2.14,59671.71,2,6530894,15866,6515028,234,2.14,79.99,59671.71,0,12.89,11.89,0.13
747,0,6515028,0,0.00,59671.71,2,6535159,20131,6515028,0,0.00,79.88,59671.71,1,12.89,11.89,0.13
748,0,6523414,8386,76.81,59748.52,2,6539352,15938,6523414,8386,76.81,79.88,59748.52,0,11.44,11.89,0.13
749,0,6532266,8852,81.08,59829.60,2,6543778,11512,6532266,8852,81.08,79.88,59829.60,0,11.52,11.89,0.13
750,0,6548800,16534,151.44,59981.04,2,6552045,3245,6548800,16534,151.44,79.97,59981.04,1,11.60,11.89,0.27
751,0,6548800,0,0.00,59981.04,2,6560892,12092,6548800,0,0.00,79.87,59981.04,0,12.02,11.02,0.03
752,0,6548800,0,0.00,59981.04,2,6565827,17027,6548800,0,0.00,79.76,59981.04,1,12.68,11.68,0.16
753,0,6558662,9862,90.33,60071.36,2,6570758,12096,6558662,9862,90.33,79.78,60071.36,0,11.35,11.68,0.16
754,0,6575764,17102,156.64,60228.00,2,6579309,3545,6575764,17102,156.64,79.88,60228.00,0,11.43,11.68,0.13
755,0,6575764,0,0.00,60228.00,2,6587896,12132,6575764,0,0.00,79.77,60228.00,1,12.21,11.21,0.27
756,0,6591426,15662,143.45,60371.45,2,6595727,4301,6591426,15662,143.45,79.86,60371.45,1,11.21,11.21,0.16
757,0,6622135,30709,281.27,60652.72,2,6622135,0,6622135,30709,281.27,80.12,60652.72,0,10.06,11.21,0.01
758,0,6622135,0,0.00,60652.72,2,6632494,10359,6622135,0,0.00,80.02,60652.72,0,11.30,10.30,0.14
759,0,6622135,0,0.00,60652.72,2,6638177,16042,6622135,0,0.00,79.91,60652.72,1,14.52,13.52,0.27
760,0,6632307,10172,93.17,60745.88,2,6643263,10956,6632307,10172,93.17,79.93,60745.88,0,13.06,13.52,0.09
761,0,6632307,0,0.00,60745.88,2,6647946,15639,6632307,0,0.00,79.82,60745.88,1,15.05,14.05,0.22
762,0,6632307,0,0.00,60745.88,2,6651595,19288,6632307,0,0.00,79.72,60745.88,0,14.50,13.50,0.12
763,0,6632307,0,0.00,60745.88,2,6654776,22469,6632307,0,0.00,79.61,60745.88,1,14.50,13.50,0.25
764,0,6638069,5762,52.77,60798.66,2,6657657,19588,6638069,5762,52.77,79.58,60798.66,1,12.96,13.50,0.05
765,0,6643937,5868,53.75,60852.41,2,6660591,16654,6643937,5868,53.75,79.55,60852.41,0,12.47,13.50,0.06
766,0,6651425,7488,68.58,60920.99,2,6664335,12910,6651425,7488,68.58,79.53,60920.99,1,12.52,13.50,0.20
767,0,6664955,13530,123.92,61044.91,2,6671100,6145,6664955,13530,123.92,79.59,61044.91,1,11.76,13.50,0.15
768,0,6692979,28024,256.67,61301.59,2,6692979,0,6692979,28024,256.67,79.82,61301.59,0,12.68,13.50,0.03
769,0,6725370,32391,296.67,61598.26,2,6725370,0,6725370,32391,296.67,80.10,61598.26,1,13.17,13.50,0.16
770,0,6756551,31181,285.59,61883.85,2,6756551,0,6756551,31181,285.59,80.37,61883.85,0,12.79,13.50,0.02
771,0,6756551,0,0.00,61883.85,2,6767335,10784,6756551,0,0.00,80.26,61883.85,0,14.14,13.14,0.15
772,0,6756551,0,0.00,61883.85,2,6773422,16871,6756551,0,0.00,80.16,61883.85,1,15.05,14.05,0.28
773,0,6756551,0,0.00,61883.85,2,6778056,21505,6756551,0,0.00,80.06,61883.85,0,14.79,13.79,0.09
774,0,6756551,0,0.00,61883.85,2,6782056,25505,6756551,0,0.00,79.95,61883.85,1,14.79,13.79,0.22
775,0,6763669,7118,65.19,61949.04,2,6785615,21946,6763669,7118,65.19,79.93,61949.04,0,13.18,13.79,0.00
776,0,6770687,7018,64.28,62013.32,2,6789124,18437,6770687,7018,64.28,79.91,62013.32,1,13.24,13.79,0.13
777,0,6777959,7272,66.60,62079.93,2,6792760,14801,6777959,7272,66.60,79.90,62079.93,0,11.96,13.79,0.13
778,0,6785419,7460,68.33,62148.25,2,6796490,11071,6785419,7460,68.33,79.88,62148.25,0,12.02,13.79,0.13
779,0,6802721,17302,158.47,62306.72,2,6805141,2420,6802721,17302,158.47,79.98,62306.72,0,12.09,13.79,0.26
780,0,6834906,32185,294.79,62601.51,2,6834906,0,6834906,32185,294.79,80.26,62601.51,1,13.36,13.79,0.39
781,0,6867368,32462,297.32,62898.83,2,6867368,0,6867368,32462,297.32,80.54,62898.83,0,13.25,13.79,0.06
782,0,6867368,0,0.00,62898.83,2,6878238,10870,6867368,0,0.00,80.43,62898.83,1,14.52,13.52,0.19
783,0,6887412,20044,183.58,63082.41,2,6888260,848,6887412,20044,183.58,80.57,63082.41,1,13.44,13.52,0.07
784,0,6890839,3427,31.39,63113.80,2,6900881,10042,6890839,3427,31.39,80.50,63113.80,0,14.41,13.41,0.07
785,0,6890839,0,0.00,63113.80,2,6906839,16000,6890839,0,0.00,80.40,63113.80,1,14.44,13.44,0.13
786,0,6890839,0,0.00,63113.80,2,6911300,20461,6890839,0,0.00,80.30,63113.80,1,13.59,12.59,0.04
787,0,6890839,0,0.00,63113.80,2,6915041,24202,6890839,0,0.00,80.20,63113.80,0,12.68,11.68,0.04
788,0,6890839,0,0.00,63113.80,2,6918516,27677,6890839,0,0.00,80.09,63113.80,1,12.68,11.68,0.13
789,0,6897551,6712,61.48,63175.28,2,6921872,24321,6897551,6712,61.48,80.07,63175.28,0,11.56,11.68,0.02
790,0,6897551,0,0.00,63175.28,2,6925053,27502,6897551,0,0.00,79.97,63175.28,1,12.26,11.26,0.15
791,0,6897551,0,0.00,63175.28,2,6927960,30409,6897551,0,0.00,79.87,63175.28,0,11.72,10.72,0.02
792,0,6897551,0,0.00,63175.28,2,6930652,33101,6897551,0,0.00,79.77,63175.28,1,11.72,10.72,0.15
793,0,6902679,5128,46.97,63222.25,2,6933216,30537,6902679,5128,46.97,79.73,63222.25,0,10.34,10.72,0.15
794,0,6907575,4896,44.84,63267.09,2,6935664,28089,6907575,4896,44.84,79.68,63267.09,1,10.39,10.72,0.13
795,0,6912367,4792,43.89,63310.98,2,6938060,25693,6912367,4792,43.89,79.64,63310.98,0,9.26,10.72,0.01
796,0,6917127,4760,43.60,63354.57,2,6940440,23313,6917127,4760,43.60,79.59,63354.57,1,9.31,10.72,0.14
797,0,6921987,4860,44.51,63399.09,2,6942870,20883,6921987,4860,44.51,79.55,63399.09,0,7.88,10.72,0.14
798,0,6926975,4988,45.69,63444.77,2,6945364,18389,6926975,4988,45.69,79.50,63444.77,1,7.92,10.72,0.13
799,0,6932099,5124,46.93,63491.71,2,6947926,15827,6932099,5124,46.93,79.46,63491.71,0,7.03,10.72,0.02
800,0,6938331,6232,57.08,63548.79,2,6951042,12711,6938331,6232,57.08,79.44,63548.79,1,7.74,10.72,0.14
801,0,6952997,14666,134.33,63683.11,2,6958375,5378,6952997,14666,134.33,79.50,63683.11,0,6.07,10.72,0.14
802,0,6983948,30951,283.48,63966.59,2,6983948,0,6983948,30951,283.48,79.76,63966.59,1,6.20,10.72,0.12
803,0,7017756,33808,309.65,64276.25,2,7017756,0,7017756,33808,309.65,80.05,64276.25,0,7.88,10.72,0.05
804,0,7017756,0,0.00,64276.25,2,7028948,11192,7017756,0,0.00,79.95,64276.25,1,10.85,9.85,0.18
805,0,7017756,0,0.00,64276.25,2,7035106,17350,7017756,0,0.00,79.85,64276.25,0,10.44,9.44,0.18
806,0,7017756,0,0.00,64276.25,2,7039818,22062,7017756,0,0.00,79.75,64276.25,1,10.44,9.44,0.12
807,0,7017756,0,0.00,64276.25,2,7043577,25821,7017756,0,0.00,79.65,64276.25,0,9.72,8.72,0.07
808,0,7017756,0,0.00,64276.25,2,7047244,29488,7017756,0,0.00,79.55,64276.25,1,9.76,8.76,0.19
809,0,7024780,7024,64.33,64340.58,2,7050756,25976,7024780,7024,64.33,79.53,64340.58,0,8.18,8.76,0.19
810,0,7031648,6868,62.90,64403.48,2,7054190,22542,7031648,6868,62.90,79.51,64403.48,1,8.24,8.76,0.12
811,0,7038340,6692,61.29,64464.78,2,7057536,19196,7038340,6692,61.29,79.49,64464.78,0,7.29,8.76,0.12
812,0,7044868,6528,59.79,64524.57,2,7060800,15932,7044868,6528,59.79,79.46,64524.57,1,7.35,8.76,0.12
813,0,7051568,6700,61.37,64585.93,2,7064150,12582,7051568,6700,61.37,79.44,64585.93,0,6.45,8.76,0.12
814,0,7065228,13660,125.11,64711.05,2,7070980,5752,7065228,13660,125.11,79.50,64711.05,1,6.51,8.76,0.12
815,0,7095185,29957,274.38,64985.43,2,7095185,0,7095185,29957,274.38,79.74,64985.43,0,6.00,8.76,0.01
816,0,7129936,34751,318.29,65303.71,2,7129936,0,7129936,34751,318.29,80.03,65303.71,1,6.96,8.76,0.13
817,0,7160246,30310,277.61,65581.32,2,7162267,2021,7160246,30310,277.61,80.27,65581.32,0,9.95,8.95,0.13
818,0,7160246,0,0.00,65581.32,2,7171906,11660,7160246,0,0.00,80.17,65581.32,1,10.22,9.22,0.12
819,0,7160246,0,0.00,65581.32,2,7177337,17091,7160246,0,0.00,80.07,65581.32,0,10.44,9.44,0.08
820,0,7160246,0,0.00,65581.32,2,7181755,21509,7160246,0,0.00,79.98,65581.32,1,10.50,9.50,0.21
821,0,7168442,8196,75.07,65656.39,2,7185853,17411,7168442,8196,75.07,79.97,65656.39,0,9.23,9.50,0.08
822,0,7176408,7966,72.96,65729.35,2,7189836,13428,7176408,7966,72.96,79.96,65729.35,1,9.31,9.50,0.20
823,0,7186064,9656,88.44,65817.80,2,7194664,8600,7186064,9656,88.44,79.97,65817.80,1,8.66,9.50,0.07
824,0,7212145,26081,238.88,66056.67,2,7212145,0,7212145,26081,238.88,80.17,66056.67,0,7.53,9.50,0.07
825,0,7245118,32973,302.00,66358.67,2,7245118,0,7245118,32973,302.00,80.43,66358.67,1,7.76,9.50,0.12
826,0,7278783,33665,308.34,66667.02,2,7278783,0,7278783,33665,308.34,80.71,66667.02,0,9.30,9.50,0.12
827,0,7278783,0,0.00,66667.02,2,7290035,11252,7278783,0,0.00,80.61,66667.02,1,9.60,8.60,0.12
828,0,7278783,0,0.00,66667.02,2,7296066,17283,7278783,0,0.00,80.52,66667.02,0,10.57,9.57,0.12
829,0,7278783,0,0.00,66667.02,2,7300433,21650,7278783,0,0.00,80.42,66667.02,0,10.57,9.57,0.12
830,0,7278783,0,0.00,66667.02,2,7304457,25674,7278783,0,0.00,80.32,66667.02,1,10.57,9.57,0.24
831,0,7281156,2373,21.73,66688.75,2,7308175,27019,7281156,2373,21.73,80.25,66688.75,0,10.17,9.17,0.24
832,0,7281156,0,0.00,66688.75,2,7311520,30364,7281156,0,0.00,80.15,66688.75,1,10.19,9.19,0.12
833,0,7287270,6114,56.00,66744.75,2,7314577,27307,7287270,6114,56.00,80.13,66744.75,0,8.55,9.19,0.12
834,0,7293106,5836,53.45,66798.20,2,7317495,24389,7293106,5836,53.45,80.09,66798.20,1,8.60,9.19,0.12
835,0,7298858,5752,52.68,66850.88,2,7320371,21513,7298858,5752,52.68,80.06,66850.88,0,5.97,9.19,0.12
836,0,7304802,5944,54.44,66905.33,2,7323343,18541,7304802,5944,54.44,80.03,66905.33,1,6.02,9.19,0.12
837,0,7310936,6134,56.18,66961.51,2,7326410,15474,7310936,6134,56.18,80.00,66961.51,0,5.17,9.19,0.01
838,0,7317222,6286,57.57,67019.08,2,7329553,12331,7317222,6286,57.57,79.98,67019.08,0,5.49,9.19,0.13
839,0,7330248,13026,119.31,67138.39,2,7336066,5818,7330248,13026,119.31,80.02,67138.39,1,5.63,9.19,0.25
840,0,7360885,30637,280.61,67418.99,2,7360885,0,7360885,30637,280.61,80.26,67418.99,1,4.31,9.19,0.09
841,0,7395832,34947,320.08,67739.08,2,7395832,0,7395832,34947,320.08,80.55,67739.08,0,5.49,9.19,0.09
842,0,7430613,34781,318.56,68057.64,2,7430613,0,7430613,34781,318.56,80.83,68057.64,0,5.80,9.19,0.12
843,0,7465232,34619,317.08,68374.72,2,7465232,0,7465232,34619,317.08,81.11,68374.72,1,7.46,9.19,0.24
844,0,7465232,0,0.00,68374.72,2,7476133,10901,7465232,0,0.00,81.01,68374.72,1,10.49,9.49,0.13
845,0,7465232,0,0.00,68374.72,2,7482297,17065,7465232,0,0.00,80.92,68374.72,0,9.65,8.65,0.05
846,0,7465232,0,0.00,68374.72,2,7487052,21820,7465232,0,0.00,80.82,68374.72,0,10.73,9.73,0.16
847,0,7465232,0,0.00,68374.72,2,7490799,25567,7465232,0,0.00,80.73,68374.72,1,10.95,9.95,0.28
848,0,7472886,7654,70.10,68444.82,2,7494626,21740,7472886,7654,70.10,80.71,68444.82,1,9.49,9.95,0.12
849,0,7480404,7518,68.86,68513.68,2,7498385,17981,7480404,7518,68.86,80.70,68513.68,0,8.50,9.95,0.04
850,0,7487804,7400,67.78,68581.45,2,7502085,14281,7487804,7400,67.78,80.68,68581.45,1,8.57,9.95,0.15
851,0,7496240,8436,77.27,68658.73,2,7506303,10063,7496240,8436,77.27,80.68,68658.73,0,7.38,9.95,0.03
852,0,7520315,24075,220.51,68879.23,2,7520315,0,7520315,24075,220.51,80.84,68879.23,1,7.45,9.95,0.15
853,0,7554228,33913,310.61,69189.84,2,7554228,0,7554228,33913,310.61,81.11,69189.84,0,8.60,9.95,0.03
854,0,7554228,0,0.00,69189.84,2,7564835,10607,7554228,0,0.00,81.02,69189.84,1,11.22,10.22,0.14
855,0,7554228,0,0.00,69189.84,2,7570535,16307,7554228,0,0.00,80.92,69189.84,0,11.79,10.79,0.14
856,0,7554228,0,0.00,69189.84,2,7574957,20729,7554228,0,0.00,80.83,69189.84,1,11.79,10.79,0.12
857,0,7562364,8136,74.52,69264.36,2,7579025,16661,7562364,8136,74.52,80.82,69264.36,0,10.78,10.79,0.03
858,0,7562364,0,0.00,69264.36,2,7582739,20375,7562364,0,0.00,80.73,69264.36,0,10.99,9.99,0.14
859,0,7562364,0,0.00,69264.36,2,7585918,23554,7562364,0,0.00,80.63,69264.36,1,10.99,9.99,0.26
860,0,7568636,6272,57.45,69321.80,2,7589054,20418,7568636,6272,57.45,80.61,69321.80,0,9.38,9.99,0.07
861,0,7575024,6388,58.51,69380.31,2,7592248,17224,7575024,6388,58.51,80.58,69380.31,1,9.83,9.99,0.19
862,0,7581754,6730,61.64,69441.95,2,7595613,13859,7581754,6730,61.64,80.56,69441.95,0,9.00,9.99,0.13
863,0,7592208,10454,95.75,69537.70,2,7600840,8632,7592208,10454,95.75,80.58,69537.70,0,9.06,9.99,0.25
864,0,7618863,26655,244.14,69781.84,2,7618863,0,7618863,26655,244.14,80.77,69781.84,1,9.15,9.99,0.36
865,0,7653170,34307,314.22,70096.05,2,7653170,0,7653170,34307,314.22,81.04,70096.05,1,8.92,9.99,0.21
866,0,7653170,0,0.00,70096.05,2,7663948,10778,7653170,0,0.00,80.94,70096.05,0,10.07,9.07,0.13
867,0,7653170,0,0.00,70096.05,2,7669768,16598,7653170,0,0.00,80.85,70096.05,1,10.37,9.37,0.25
868,0,7653170,0,0.00,70096.05,2,7674183,21013,7653170,0,0.00,80.76,70096.05,1,11.03,10.03,0.13
869,0,7653170,0,0.00,70096.05,2,7678080,24910,7653170,0,0.00,80.66,70096.05,0,10.41,9.41,0.13
870,0,7653170,0,0.00,70096.05,2,7681424,28254,7653170,0,0.00,80.57,70096.05,1,10.79,9.79,0.25
871,0,7659614,6444,59.02,70155.08,2,7684646,25032,7659614,6444,59.02,80.55,70155.08,0,9.26,9.79,0.08
872,0,7659614,0,0.00,70155.08,2,7687935,28321,7659614,0,0.00,80.45,70155.08,1,9.95,8.95,0.19
873,0,7659614,0,0.00,70155.08,2,7690946,31332,7659614,0,0.00,80.36,70155.08,0,9.59,8.59,0.11
874,0,7659614,0,0.00,70155.08,2,7693727,34113,7659614,0,0.00,80.27,70155.08,1,10.30,9.30,0.22
875,0,7664822,5208,47.70,70202.78,2,7696331,31509,7664822,5208,47.70,80.23,70202.78,1,7.55,9.30,0.22
876,0,7669822,5000,45.80,70248.58,2,7698831,29009,7669822,5000,45.80,80.19,70248.58,0,7.60,9.30,0.11
877,0,7674718,4896,44.84,70293.42,2,7701279,26561,7674718,4896,44.84,80.15,70293.42,0,8.84,9.30,0.23
878,0,7679744,5026,46.03,70339.45,2,7703792,24048,7679744,5026,46.03,80.11,70339.45,0,8.99,9.30,0.34
879,0,7684708,4964,45.47,70384.91,2,7706274,21566,7684708,4964,45.47,80.07,70384.91,1,9.04,9.30,0.46
880,0,7689998,5290,48.45,70433.37,2,7708919,18921,7689998,5290,48.45,80.04,70433.37,0,6.94,9.30,0.18
881,0,7695434,5436,49.79,70483.16,2,7711637,16203,7695434,5436,49.79,80.00,70483.16,1,6.99,9.30,0.29
882,0,7701336,5902,54.06,70537.22,2,7714588,13252,7701336,5902,54.06,79.97,70537.22,0,5.79,9.30,0.17
883,0,7712816,11480,105.15,70642.36,2,7720328,7512,7712816,11480,105.15,80.00,70642.36,1,6.99,9.30,0.29
884,0,7740664,27848,255.06,70897.42,2,7740664,0,7740664,27848,255.06,80.20,70897.42,0,6.41,9.30,0.12
885,0,7775743,35079,321.29,71218.72,2,7775743,0,7775743,35079,321.29,80.47,71218.72,1,7.15,9.30,0.23
886,0,7810281,34538,316.34,71535.05,2,7810281,0,7810281,34538,316.34,80.74,71535.05,0,6.94,9.30,0.13
887,0,7844945,34664,317.49,71852.54,2,7844945,0,7844945,34664,317.49,81.01,71852.54,1,8.32,9.30,0.24
888,0,7844945,0,0.00,71852.54,2,7855897,10952,7844945,0,0.00,80.92,71852.54,1,10.31,9.31,0.12
889,0,7844945,0,0.00,71852.54,2,7861825,16880,7844945,0,0.00,80.82,71852.54,0,10.17,9.17,0.05
890,0,7844945,0,0.00,71852.54,2,7866364,21419,7844945,0,0.00,80.73,71852.54,1,10.23,9.23,0.17
891,0,7853373,8428,77.19,71929.73,2,7870578,17205,7853373,8428,77.19,80.73,71929.73,0,9.07,9.23,0.06
892,0,7853373,0,0.00,71929.73,2,7874230,20857,7853373,0,0.00,80.64,71929.73,1,9.28,8.28,0.17
893,0,7860187,6814,62.41,71992.15,2,7877637,17450,7860187,6814,62.41,80.62,71992.15,0,8.23,8.28,0.07
894,0,7860187,0,0.00,71992.15,2,7880865,20678,7860187,0,0.00,80.53,71992.15,1,8.51,8.00,0.18
895,0,7865959,5772,52.87,72045.02,2,7883751,17792,7865959,5772,52.87,80.50,72045.02,0,7.38,8.00,0.06
896,0,7872779,6820,62.46,72107.48,2,7887161,14382,7872779,6820,62.46,80.48,72107.48,1,7.58,8.00,0.18
897,0,7885211,12432,113.87,72221.34,2,7893377,8166,7885211,12432,113.87,80.51,72221.34,0,7.15,8.00,0.18
898,0,7910806,25595,234.43,72455.77,2,7910806,0,7910806,25595,234.43,80.69,72455.77,0,7.27,8.00,0.11
899,0,7945615,34809,318.82,72774.59,2,7945615,0,7945615,34809,318.82,80.95,72774.59,1,7.80,8.00,0.22
900,0,7978566,32951,301.80,73076.39,2,7978566,0,7978566,32951,301.80,81.20,73076.39,0,10.16,11.16,0.13
901,0,7978566,0,0.00,73076.39,2,7989254,10688,7978566,0,0.00,81.11,73076.39,1,11.26,10.26,0.24
902,0,8000381,21815,199.81,73276.20,2,8000381,0,8000381,21815,199.81,81.24,73276.20,0,9.77,10.26,0.08
903,0,8000381,0,0.00,73276.20,2,8011046,10665,8000381,0,0.00,81.15,73276.20,1,10.36,9.36,0.19
904,0,8000381,0,0.00,73276.20,2,8016815,16434,8000381,0,0.00,81.06,73276.20,1,9.63,8.63,0.04
905,0,8000381,0,0.00,73276.20,2,8020878,20497,8000381,0,0.00,80.97,73276.20,0,9.51,8.51,0.02
906,0,8000381,0,0.00,73276.20,2,8024373,23992,8000381,0,0.00,80.88,73276.20,0,10.10,9.10,0.13
907,0,8000381,0,0.00,73276.20,2,8027729,27348,8000381,0,0.00,80.79,73276.20,1,10.44,9.44,0.24
908,0,8006783,6402,58.64,73334.83,2,8030930,24147,8006783,6402,58.64,80.77,73334.83,1,9.28,9.44,0.10
909,0,8012805,6022,55.16,73389.98,2,8033941,21136,8012805,6022,55.16,80.74,73389.98,0,8.69,9.44,0.07
910,0,8018771,5966,54.64,73444.63,2,8036924,18153,8018771,5966,54.64,80.71,73444.63,1,8.74,9.44,0.18
911,0,8025189,6418,58.78,73503.41,2,8040133,14944,8025189,6418,58.78,80.68,73503.41,0,7.77,9.44,0.07
912,0,8032213,7024,64.33,73567.75,2,8043645,11432,8032213,7024,64.33,80.67,73567.75,1,8.11,9.44,0.18
913,0,8049017,16804,153.91,73721.66,2,8052047,3030,8049017,16804,153.91,80.75,73721.66,1,6.85,9.44,0.05
914,0,8080513,31496,288.47,74010.13,2,8080513,0,8080513,31496,288.47,80.97,74010.13,0,7.10,9.44,0.05
915,0,8113437,32924,301.55,74311.69,2,8113437,0,8113437,32924,301.55,81.21,74311.69,1,7.38,9.44,0.11
916,0,8131242,17805,163.08,74474.77,2,8136875,5633,8131242,17805,163.08,81.30,74474.77,0,13.66,12.66,0.11
917,0,8131242,0,0.00,74474.77,2,8144644,13402,8131242,0,0.00,81.22,74474.77,0,13.82,12.82,0.11
918,0,8131242,0,0.00,74474.77,2,8149322,18080,8131242,0,0.00,81.13,74474.77,1,13.86,12.86,0.22
919,0,8139602,8360,76.57,74551.34,2,8153502,13900,8139602,8360,76.57,81.12,74551.34,0,12.61,12.86,0.11
920,0,8150754,11152,102.14,74653.48,2,8159078,8324,8150754,11152,102.14,81.15,74653.48,1,12.80,12.86,0.21
921,0,8173765,23011,210.76,74864.23,2,8173765,0,8173765,23011,210.76,81.29,74864.23,0,11.84,12.86,0.10
922,0,8205520,31755,290.85,75155.08,2,8205520,0,8205520,31755,290.85,81.51,75155.08,1,12.79,12.86,0.21
923,0,8205520,0,0.00,75155.08,2,8215754,10234,8205520,0,0.00,81.42,75155.08,0,13.12,12.12,0.06
924,0,8205520,0,0.00,75155.08,2,8221343,15823,8205520,0,0.00,81.34,75155.08,1,13.55,12.55,0.17
925,0,8215148,9628,88.18,75243.27,2,8226157,11009,8215148,9628,88.18,81.34,75243.27,0,11.84,12.55,0.17
926,0,8232662,17514,160.41,75403.68,2,8234914,2252,8232662,17514,160.41,81.43,75403.68,1,11.93,12.55,0.11
927,0,8248034,15372,140.79,75544.47,2,8254586,6552,8248034,15372,140.79,81.49,75544.47,0,15.44,14.44,0.11
928,0,8248034,0,0.00,75544.47,2,8261463,13429,8248034,0,0.00,81.41,75544.47,1,15.58,14.58,0.11
929,0,8261274,13240,121.27,75665.73,2,8268083,6809,8261274,13240,121.27,81.45,75665.73,0,14.19,14.58,0.11
930,0,8288247,26973,247.05,75912.78,2,8288247,0,8288247,26973,247.05,81.63,75912.78,1,14.30,14.58,0.11
931,0,8288247,0,0.00,75912.78,2,8298425,10178,8288247,0,0.00,81.54,75912.78,0,14.65,13.65,0.11
932,0,8288247,0,0.00,75912.78,2,8304401,16154,8288247,0,0.00,81.45,75912.78,1,14.65,13.65,0.11
933,0,8298597,10350,94.80,76007.58,2,8309576,10979,8298597,10350,94.80,81.47,76007.58,0,12.81,13.65,0.11
934,0,8316789,18192,166.62,76174.20,2,8318672,1883,8316789,18192,166.62,81.56,76174.20,1,12.90,13.65,0.11
935,0,8347136,30347,277.95,76452.16,2,8347136,0,8347136,30347,277.95,81.77,76452.16,0,13.01,13.65,0.11
936,0,8377680,30544,279.76,76731.91,2,8377680,0,8377680,30544,279.76,81.98,76731.91,1,13.28,13.65,0.11
937,0,8392940,15260,139.77,76871.68,2,8398887,5947,8392940,15260,139.77,82.04,76871.68,0,16.41,15.41,0.11
938,0,8392940,0,0.00,76871.68,2,8406803,13863,8392940,0,0.00,81.95,76871.68,0,16.54,15.54,0.11
939,0,8392940,0,0.00,76871.68,2,8411647,18707,8392940,0,0.00,81.87,76871.68,1,16.54,15.54,0.21
940,0,8392940,0,0.00,76871.68,2,8415637,22697,8392940,0,0.00,81.78,76871.68,0,16.62,15.62,0.04
941,0,8392940,0,0.00,76871.68,2,8418892,25952,8392940,0,0.00,81.69,76871.68,1,16.90,15.90,0.14
942,0,8399352,6412,58.73,76930.41,2,8422098,22746,8399352,6412,58.73,81.67,76930.41,0,15.42,15.90,0.14
943,0,8405988,6636,60.78,76991.19,2,8425416,19428,8405988,6636,60.78,81.64,76991.19,1,15.48,15.90,0.11
944,0,8412746,6758,61.90,77053.09,2,8428795,16049,8412746,6758,61.90,81.62,77053.09,1,12.92,15.90,0.11
945,0,8419686,6940,63.56,77116.65,2,8432265,12579,8419686,6940,63.56,81.60,77116.65,0,12.98,15.90,0.11
946,0,8432742,13056,119.58,77236.23,2,8438793,6051,8432742,13056,119.58,81.65,77236.23,1,13.08,15.90,0.21
947,0,8459487,26745,244.96,77481.19,2,8459487,0,8459487,26745,244.96,81.82,77481.19,0,12.18,15.90,0.07
948,0,8489962,30475,279.12,77760.31,2,8489962,0,8489962,30475,279.12,82.03,77760.31,1,13.75,15.90,0.18
949,0,8520578,30616,280.41,78040.73,2,8520578,0,8520578,30616,280.41,82.23,78040.73,0,14.74,15.90,0.06
950,0,8551332,30754,281.68,78322.41,2,8551332,0,8551332,30754,281.68,82.44,78322.41,1,15.73,15.90,0.17
951,0,8582136,30804,282.14,78604.54,2,8582136,0,8582136,30804,282.14,82.65,78604.54,1,14.48,15.90,0.17
952,0,8612299,30163,276.27,78880.80,2,8612299,0,8612299,30163,276.27,82.86,78880.80,0,14.76,15.90,0.11
953,0,8612299,0,0.00,78880.80,2,8622495,10196,8612299,0,0.00,82.77,78880.80,0,17.03,16.03,0.21
954,0,8612299,0,0.00,78880.80,2,8627937,15638,8612299,0,0.00,82.68,78880.80,1,18.75,17.75,0.31
955,0,8622615,10316,94.49,78975.29,2,8633095,10480,8622615,10316,94.49,82.70,78975.29,0,17.05,17.75,0.09
956,0,8641227,18612,170.47,79145.76,2,8642401,1174,8641227,18612,170.47,82.79,79145.76,1,17.14,17.75,0.19
957,0,8671934,30707,281.25,79427.01,2,8671934,0,8671934,30707,281.25,83.00,79427.01,0,16.12,17.75,0.10
958,0,8671934,0,0.00,79427.01,2,8682038,10104,8671934,0,0.00,82.91,79427.01,0,18.27,17.27,0.20
959,0,8671934,0,0.00,79427.01,2,8687597,15663,8671934,0,0.00,82.82,79427.01,1,18.56,17.56,0.30
960,0,8671934,0,0.00,79427.01,2,8691880,19946,8671934,0,0.00,82.74,79427.01,0,18.23,17.23,0.05
961,0,8671934,0,0.00,79427.01,2,8695648,23714,8671934,0,0.00,82.65,79427.01,1,18.23,17.23,0.15
962,0,8678996,7062,64.68,79491.69,2,8699179,20183,8678996,7062,64.68,82.63,79491.69,0,17.09,17.23,0.06
963,0,8678996,0,0.00,79491.69,2,8702523,23527,8678996,0,0.00,82.55,79491.69,1,18.30,17.30,0.17
964,0,8678996,0,0.00,79491.69,2,8705358,26362,8678996,0,0.00,82.46,79491.69,0,17.73,16.73,0.03
965,0,8678996,0,0.00,79491.69,2,8707902,28906,8678996,0,0.00,82.37,79491.69,1,17.73,16.73,0.14
966,0,8684106,5110,46.80,79538.49,2,8710457,26351,8684106,5110,46.80,82.34,79538.49,1,16.59,16.73,0.03
967,0,8689294,5188,47.52,79586.01,2,8713051,23757,8689294,5188,47.52,82.30,79586.01,0,15.78,16.73,0.03
968,0,8694504,5210,47.72,79633.73,2,8715656,21152,8694504,5210,47.72,82.27,79633.73,1,15.83,16.73,0.10
969,0,8699806,5302,48.56,79682.29,2,8718307,18501,8699806,5302,48.56,82.23,79682.29,0,14.51,16.73,0.10
970,0,8705428,5622,51.49,79733.78,2,8721118,15690,8705428,5622,51.49,82.20,79733.78,1,14.56,16.73,0.10
971,0,8712108,6680,61.18,79794.97,2,8724458,12350,8712108,6680,61.18,82.18,79794.97,0,13.45,16.73,0.01
972,0,8726722,14614,133.85,79928.81,2,8731765,5043,8726722,14614,133.85,82.23,79928.81,1,13.51,16.73,0.12
973,0,8754325,27603,252.82,80181.63,2,8754325,0,8754325,27603,252.82,82.41,80181.63,0,13.84,16.73,0.12
974,0,8784733,30408,278.51,80460.14,2,8784733,0,8784733,30408,278.51,82.61,80460.14,1,14.08,16.73,0.10
975,0,8815650,30917,283.17,80743.31,2,8815650,0,8815650,30917,283.17,82.81,80743.31,0,13.94,16.73,0.03
976,0,8847104,31454,288.09,81031.41,2,8847104,0,8847104,31454,288.09,83.02,81031.41,1,15.08,16.73,0.13
977,0,8878073,30969,283.65,81315.05,2,8878073,0,8878073,30969,283.65,83.23,81315.05,0,15.10,16.73,0.13
978,0,8909024,30951,283.48,81598.54,2,8909024,0,8909024,30951,283.48,83.43,81598.54,0,15.38,16.73,0.10
979,0,8909024,0,0.00,81598.54,2,8919585,10561,8909024,0,0.00,83.35,81598.54,1,21.48,19.00,0.20
980,0,8909024,0,0.00,81598.54,2,8925560,16536,8909024,0,0.00,83.26,81598.54,0,21.56,19.00,0.15
981,0,8909024,0,0.00,81598.54,2,8929770,20746,8909024,0,0.00,83.18,81598.54,1,23.16,19.00,0.25
982,0,8909024,0,0.00,81598.54,2,8933396,24372,8909024,0,0.00,83.09,81598.54,0,21.87,19.00,0.11
983,0,8909024,0,0.00,81598.54,2,8936786,27762,8909024,0,0.00,83.01,81598.54,1,21.87,19.00,0.21
984,0,8909024,0,0.00,81598.54,2,8939908,30884,8909024,0,0.00,82.93,81598.54,1,20.35,19.35,0.06
985,0,8909024,0,0.00,81598.54,2,8942788,33764,8909024,0,0.00,82.84,81598.54,0,19.53,18.53,0.01
986,0,8909024,0,0.00,81598.54,2,8945497,36473,8909024,0,0.00,82.76,81598.54,1,19.60,18.60,0.11
987,0,8914112,5088,46.60,81645.14,2,8948041,33929,8914112,5088,46.60,82.72,81645.14,0,18.15,18.60,0.11
988,0,8919282,5170,47.35,81692.49,2,8950626,31344,8919282,5170,47.35,82.68,81692.49,1,18.20,18.60,0.10
989,0,8924422,5140,47.08,81739.57,2,8953196,28774,8924422,5140,47.08,82.65,81739.57,0,17.71,18.60,0.10
990,0,8929548,5126,46.95,81786.52,2,8955759,26211,8929548,5126,46.95,82.61,81786.52,1,17.75,18.60,0.10
991,0,8934494,4946,45.30,81831.82,2,8958232,23738,8934494,4946,45.30,82.57,81831.82,0,17.29,18.60,0.10
992,0,8939398,4904,44.92,81876.73,2,8960684,21286,8939398,4904,44.92,82.54,81876.73,1,17.33,18.60,0.10
993,0,8944198,4800,43.96,81920.70,2,8963084,18886,8944198,4800,43.96,82.50,81920.70,0,16.11,18.60,0.10
994,0,8949202,5004,45.83,81966.53,2,8965586,16384,8949202,5004,45.83,82.46,81966.53,1,16.16,18.60,0.10
995,0,8954798,5596,51.25,82017.78,2,8968384,13586,8954798,5596,51.25,82.43,82017.78,0,14.89,18.60,0.10
996,0,8965274,10476,95.95,82113.73,2,8973622,8348,8965274,10476,95.95,82.44,82113.73,1,14.94,18.60,0.10
997,0,8990072,24798,227.13,82340.86,2,8990072,0,8990072,24798,227.13,82.59,82340.86,0,14.01,18.60,0.10
998,0,9021065,30993,283.87,82624.73,2,9021065,0,9021065,30993,283.87,82.79,82624.73,0,14.23,18.60,0.10
999,0,9051842,30777,281.89,82906.62,2,9051842,0,9051842,30777,281.89,82.99,82906.62,1,16.11,18.60,0.20
1000,0,9082897,31055,284.44,83191.05,2,9082897,0,9082897,31055,284.44,83.19,83191.05,0,15.71,18.60,0.08
1001,0,9114017,31120,285.03,83476.09,2,9114017,0,9114017,31120,285.03,83.39,83476.09,1,16.53,18.60,0.18
1002,0,9145162,31145,285.26,83761.34,2,9145162,0,9145162,31145,285.26,83.59,83761.34,0,18.10,18.60,0.04
1003,0,9145162,0,0.00,83761.34,2,9155364,10202,9145162,0,0.00,83.51,83761.34,1,20.38,19.38,0.14
1004,0,9145162,0,0.00,83761.34,2,9161412,16250,9145162,0,0.00,83.43,83761.34,1,21.01,19.00,0.03
1005,0,9145162,0,0.00,83761.34,2,9165912,20750,9145162,0,0.00,83.34,83761.34,0,21.74,19.00,0.03
1006,0,9145162,0,0.00,83761.34,2,9169793,24631,9145162,0,0.00,83.26,83761.34,1,21.74,19.00,0.10
1007,0,9145162,0,0.00,83761.34,2,9173199,28037,9145162,0,0.00,83.18,83761.34,0,20.97,19.97,0.10
1008,0,9145162,0,0.00,83761.34,2,9176328,31166,9145162,0,0.00,83.10,83761.34,1,20.97,19.97,0.10
1009,0,9151080,5918,54.20,83815.55,2,9179287,28207,9151080,5918,54.20,83.07,83815.55,0,19.74,19.97,0.00
1010,0,9151080,0,0.00,83815.55,2,9182091,31011,9151080,0,0.00,82.99,83815.55,1,20.74,19.74,0.10
1011,0,9151080,0,0.00,83815.55,2,9184556,33476,9151080,0,0.00,82.90,83815.55,0,20.33,19.33,0.10
1012,0,9151080,0,0.00,83815.55,2,9186838,35758,9151080,0,0.00,82.82,83815.55,1,20.33,19.33,0.10
1013,0,9155698,4618,42.30,83857.84,2,9189147,33449,9155698,4618,42.30,82.78,83857.84,0,19.23,19.33,0.10
1014,0,9160448,4750,43.51,83901.35,2,9191522,31074,9160448,4750,43.51,82.74,83901.35,1,19.27,19.33,0.10
1015,0,9165148,4700,43.05,83944.40,2,9193872,28724,9165148,4700,43.05,82.70,83944.40,0,17.99,19.33,0.10
1016,0,9169880,4732,43.34,83987.74,2,9196238,26358,9169880,4732,43.34,82.67,83987.74,1,18.03,19.33,0.10
1017,0,9174602,4722,43.25,84030.99,2,9198599,23997,9174602,4722,43.25,82.63,84030.99,0,17.66,19.33,0.01
1018,0,9179314,4712,43.16,84074.15,2,9200955,21641,9179314,4712,43.16,82.59,84074.15,1,18.17,19.33,0.11
1019,0,9184152,4838,44.31,84118.46,2,9203374,19222,9184152,4838,44.31,82.55,84118.46,0,16.67,19.33,0.11
1020,0,9189164,5012,45.91,84164.36,2,9205880,16716,9189164,5012,45.91,82.51,84164.36,1,16.72,19.33,0.10
1021,0,9194776,5612,51.40,84215.77,2,9208686,13910,9194776,5612,51.40,82.48,84215.77,0,15.42,19.33,0.10
1022,0,9204882,10106,92.56,84308.33,2,9213739,8857,9204882,10106,92.56,82.49,84308.33,1,15.47,19.33,0.10
1023,0,9225313,20431,187.13,84495.45,2,9225313,0,9225313,20431,187.13,82.60,84495.45,0,14.32,19.33,0.00
1024,0,9256771,31458,288.13,84783.58,2,9256771,0,9256771,31458,288.13,82.80,84783.58,1,15.28,19.33,0.10
1025,0,9287742,30971,283.67,85067.25,2,9287742,0,9287742,30971,283.67,82.99,85067.25,0,15.38,19.33,0.10
1026,0,9320676,32934,301.65,85368.89,2,9320676,0,9320676,32934,301.65,83.21,85368.89,1,15.66,19.33,0.10
1027,0,9352116,31440,287.96,85656.85,2,9352116,0,9352116,31440,287.96,83.40,85656.85,1,16.93,19.33,0.10
1028,0,9384306,32190,294.83,85951.69,2,9384306,0,9384306,32190,294.83,83.61,85951.69,0,17.21,19.33,0.10
1029,0,9384306,0,0.00,85951.69,2,9395212,10906,9384306,0,0.00,83.53,85951.69,0,19.50,18.50,0.19
1030,0,9384306,0,0.00,85951.69,2,9401402,17096,9384306,0,0.00,83.45,85951.69,1,21.22,19.00,0.29
1031,0,9384306,0,0.00,85951.69,2,9406018,21712,9384306,0,0.00,83.37,85951.69,0,19.34,18.34,0.05
1032,0,9384306,0,0.00,85951.69,2,9409654,25348,9384306,0,0.00,83.29,85951.69,1,19.34,18.34,0.15
1033,0,9384306,0,0.00,85951.69,2,9412861,28555,9384306,0,0.00,83.21,85951.69,0,18.95,17.95,0.06
1034,0,9384306,0,0.00,85951.69,2,9416036,31730,9384306,0,0.00,83.13,85951.69,1,20.09,19.09,0.15
1035,0,9390306,6000,54.95,86006.64,2,9419036,28730,9390306,6000,54.95,83.10,86006.64,0,18.35,19.09,0.15
1036,0,9396142,5836,53.45,86060.09,2,9421954,25812,9396142,5836,53.45,83.07,86060.09,1,18.41,19.09,0.10
1037,0,9401968,5826,53.36,86113.45,2,9424867,22899,9401968,5826,53.36,83.04,86113.45,0,17.74,19.09,0.10
1038,0,9407708,5740,52.57,86166.02,2,9427737,20029,9407708,5740,52.57,83.01,86166.02,1,17.79,19.09,0.10
1039,0,9413448,5740,52.57,86218.60,2,9430607,17159,9413448,5740,52.57,82.98,86218.60,0,17.41,19.09,0.10
1040,0,9419370,5922,54.24,86272.84,2,9433568,14198,9419370,5922,54.24,82.95,86272.84,1,17.46,19.09,0.10
1041,0,9427490,8120,74.37,86347.21,2,9437628,10138,9427490,8120,74.37,82.95,86347.21,0,15.86,19.09,0.10
1042,0,9447046,19556,179.12,86526.33,2,9447406,360,9447046,19556,179.12,83.04,86526.33,1,15.94,19.09,0.10
1043,0,9479582,32536,298.00,86824.33,2,9479582,0,9479582,32536,298.00,83.24,86824.33,1,13.33,19.09,0.10
1044,0,9512197,32615,298.72,87123.05,2,9512197,0,9512197,32615,298.72,83.45,87123.05,0,13.62,19.09,0.10
1045,0,9544266,32069,293.72,87416.77,2,9544266,0,9544266,32069,293.72,83.65,87416.77,1,14.75,19.09,0.19
1046,0,9576732,32466,297.36,87714.13,2,9576732,0,9576732,32466,297.36,83.86,87714.13,0,15.57,19.09,0.11
1047,0,9609363,32631,298.87,88013.00,2,9609363,0,9609363,32631,298.87,84.06,88013.00,0,17.86,19.09,0.20
1048,0,9609363,0,0.00,88013.00,2,9620352,10989,9609363,0,0.00,83.98,88013.00,1,20.73,19.73,0.30
1049,0,9609363,0,0.00,88013.00,2,9626076,16713,9609363,0,0.00,83.90,88013.00,0,20.24,19.24,0.14
1050,0,9609363,0,0.00,88013.00,2,9630509,21146,9609363,0,0.00,83.82,88013.00,1,20.24,19.24,0.24
1051,0,9617033,7670,70.25,88083.25,2,9634344,17311,9617033,7670,70.25,83.81,88083.25,0,19.19,19.24,0.07
1052,0,9617033,0,0.00,88083.25,2,9638030,20997,9617033,0,0.00,83.73,88083.25,1,20.04,19.04,0.16
1053,0,9617033,0,0.00,88083.25,2,9641362,24329,9617033,0,0.00,83.65,88083.25,0,19.30,18.30,0.03
1054,0,9617033,0,0.00,88083.25,2,9644439,27406,9617033,0,0.00,83.57,88083.25,1,20.12,19.12,0.12
1055,0,9622859,5826,53.36,88136.62,2,9647352,24493,9622859,5826,53.36,83.54,88136.62,0,18.79,19.12,0.12
1056,0,9628579,5720,52.39,88189.00,2,9650212,21633,9628579,5720,52.39,83.51,88189.00,1,18.85,19.12,0.09
1057,0,9634267,5688,52.10,88241.10,2,9653056,18789,9634267,5688,52.10,83.48,88241.10,0,17.44,19.12,0.09
1058,0,9640315,6048,55.39,88296.49,2,9656080,15765,9640315,6048,55.39,83.46,88296.49,0,17.49,19.12,0.09
1059,0,9646915,6600,60.45,88356.95,2,9659380,12465,9646915,6600,60.45,83.43,88356.95,1,17.76,19.12,0.19
1060,0,9659901,12986,118.94,88475.88,2,9665873,5972,9659901,12986,118.94,83.47,88475.88,1,17.65,19.12,0.05
1061,0,9687647,27746,254.13,88730.02,2,9687647,0,9687647,27746,254.13,83.63,88730.02,0,18.25,19.12,0.05
1062,0,9720086,32439,297.11,89027.12,2,9720086,0,9720086,32439,297.11,83.83,89027.12,1,18.49,19.12,0.09
1063,0,9752985,32899,301.32,89328.45,2,9752985,0,9752985,32899,301.32,84.03,89328.45,0,17.97,19.12,0.09
1064,0,9785389,32404,296.79,89625.24,2,9785389,0,9785389,32404,296.79,84.23,89625.24,1,18.27,19.12,0.09
1065,0,9786611,1222,11.19,89636.43,2,9796845,10234,9786611,1222,11.19,84.17,89636.43,0,19.58,18.58,0.09
1066,0,9786611,0,0.00,89636.43,2,9802756,16145,9786611,0,0.00,84.09,89636.43,0,19.59,18.59,0.09
1067,0,9786611,0,0.00,89636.43,2,9807190,20579,9786611,0,0.00,84.01,89636.43,1,19.59,18.59,0.19
1068,0,9794763,8152,74.66,89711.09,2,9811266,16503,9794763,8152,74.66,84.00,89711.09,0,17.87,18.59,0.03
1069,0,9802715,7952,72.83,89783.93,2,9815242,12527,9802715,7952,72.83,83.99,89783.93,1,17.94,18.59,0.12
1070,0,9814105,11390,104.32,89888.25,2,9820937,6832,9814105,11390,104.32,84.01,89888.25,1,15.07,18.59,0.12
1071,0,9840544,26439,242.16,90130.41,2,9840544,0,9840544,26439,242.16,84.16,90130.41,0,15.18,18.59,0.09
1072,0,9873042,32498,297.65,90428.06,2,9873042,0,9873042,32498,297.65,84.35,90428.06,1,15.41,18.59,0.19
1073,0,9905775,32733,299.80,90727.87,2,9905775,0,9905775,32733,299.80,84.56,90727.87,0,16.40,18.59,0.08
1074,0,9905775,0,0.00,90727.87,2,9916795,11020,9905775,0,0.00,84.48,90727.87,1,21.64,19.00,0.17
1075,0,9905775,0,0.00,90727.87,2,9922538,16763,9905775,0,0.00,84.40,90727.87,0,24.01,19.00,0.04
1076,0,9905775,0,0.00,90727.87,2,9927105,21330,9905775,0,0.00,84.32,90727.87,1,24.37,19.00,0.13
1077,0,9905775,0,0.00,90727.87,2,9931222,25447,9905775,0,0.00,84.24,90727.87,0,22.59,19.00,0.13
1078,0,9905775,0,0.00,90727.87,2,9934900,29125,9905775,0,0.00,84.16,90727.87,1,22.59,19.00,0.09
1079,0,9905775,0,0.00,90727.87,2,9938241,32466,9905775,0,0.00,84.09,90727.87,0,21.25,19.00,0.09
1080,0,9905775,0,0.00,90727.87,2,9941325,35550,9905775,0,0.00,84.01,90727.87,1,21.25,19.00,0.09
1081,0,9905775,0,0.00,90727.87,2,9944196,38421,9905775,0,0.00,83.93,90727.87,0,19.57,18.57,0.09
1082,0,9905775,0,0.00,90727.87,2,9946879,41104,9905775,0,0.00,83.85,90727.87,1,19.57,18.57,0.09
1083,0,9910955,5180,47.44,90775.31,2,9949469,38514,9910955,5180,47.44,83.82,90775.31,0,18.19,18.57,0.09
1084,0,9915795,4840,44.33,90819.64,2,9951889,36094,9915795,4840,44.33,83.78,90819.64,1,18.23,18.57,0.09
1085,0,9920449,4654,42.63,90862.27,2,9954216,33767,9920449,4654,42.63,83.74,90862.27,0,16.73,18.57,0.09
1086,0,9925079,4630,42.41,90904.67,2,9956531,31452,9925079,4630,42.41,83.71,90904.67,1,16.77,18.57,0.09
1087,0,9929823,4744,43.45,90948.12,2,9958903,29080,9929823,4744,43.45,83.67,90948.12,0,15.58,18.57,0.09
1088,0,9934625,4802,43.98,90992.11,2,9961304,26679,9934625,4802,43.98,83.63,90992.11,1,15.62,18.57,0.09
1089,0,9939457,4832,44.26,91036.36,2,9963720,24263,9939457,4832,44.26,83.60,91036.36,0,14.97,18.57,0.09
1090,0,9944189,4732,43.34,91079.70,2,9966086,21897,9944189,4732,43.34,83.56,91079.70,1,15.01,18.57,0.09
1091,0,9949013,4824,44.18,91123.89,2,9968498,19485,9949013,4824,44.18,83.52,91123.89,0,14.10,18.57,0.09
1092,0,9954133,5120,46.89,91170.78,2,9971058,16925,9954133,5120,46.89,83.49,91170.78,1,14.14,18.57,0.09
1093,0,9959933,5800,53.12,91223.91,2,9973958,14025,9959933,5800,53.12,83.46,91223.91,0,13.23,18.57,0.09
1094,0,9969591,9658,88.46,91312.36,2,9978787,9196,9969591,9658,88.46,83.47,91312.36,1,13.28,18.57,0.09
1095,0,9991679,22088,202.31,91514.67,2,9991679,0,9991679,22088,202.31,83.58,91514.67,0,12.26,18.57,0.02
1096,0,10023880,32201,294.93,91809.60,2,10023880,0,10023880,32201,294.93,83.77,91809.60,1,12.45,18.57,0.11
1097,0,10056579,32699,299.49,92109.09,2,10056579,0,10056579,32699,299.49,83.96,92109.09,0,10.90,18.57,0.11
1098,0,10088590,32011,293.19,92402.28,2,10088590,0,10088590,32011,293.19,84.16,92402.28,1,11.19,18.57,0.09
1099,0,10120724,32134,294.32,92696.60,2,10120724,0,10120724,32134,294.32,84.35,92696.60,0,17.35,18.57,0.03
1100,0,10152658,31934,292.49,92989.09,2,10152658,0,10152658,31934,292.49,84.54,92989.09,1,17.64,18.57,0.13
1101,0,10165751,13093,119.92,93109.01,2,10172981,7230,10165751,13093,119.92,84.57,93109.01,0,19.80,18.80,0.13
1102,0,10165751,0,0.00,93109.01,2,10179968,14217,10165751,0,0.00,84.49,93109.01,0,19.92,18.92,0.09
1103,0,10165751,0,0.00,93109.01,2,10184913,19162,10165751,0,0.00,84.41,93109.01,1,19.92,18.92,0.18
1104,0,10165751,0,0.00,93109.01,2,10189218,23467,10165751,0,0.00,84.34,93109.01,0,19.86,18.86,0.02
1105,0,10165751,0,0.00,93109.01,2,10193061,27310,10165751,0,0.00,84.26,93109.01,1,20.15,19.15,0.11
1106,0,10172895,7144,65.43,93174.45,2,10196633,23738,10172895,7144,65.43,84.24,93174.45,0,19.05,19.15,0.11
1107,0,10179739,6844,62.68,93237.12,2,10200055,20316,10179739,6844,62.68,84.23,93237.12,1,19.12,19.15,0.09
1108,0,10186549,6810,62.37,93299.50,2,10203460,16911,10186549,6810,62.37,84.21,93299.50,1,17.35,19.15,0.09
1109,0,10193229,6680,61.18,93360.68,2,10206800,13571,10193229,6680,61.18,84.18,93360.68,0,17.41,19.15,0.09
1110,0,10201209,7980,73.09,93433.77,2,10210790,9581,10201209,7980,73.09,84.17,93433.77,0,17.47,19.15,0.18
1111,0,10222284,21075,193.03,93626.80,2,10222284,0,10222284,21075,193.03,84.27,93626.80,1,17.55,19.15,0.27
1112,0,10255461,33177,303.87,93930.67,2,10255461,0,10255461,33177,303.87,84.47,93930.67,1,17.14,19.15,0.12
1113,0,10288420,32959,301.87,94232.55,2,10288420,0,10288420,32959,301.87,84.67,94232.55,0,15.85,19.15,0.12
1114,0,10320999,32579,298.39,94530.94,2,10320999,0,10320999,32579,298.39,84.86,94530.94,1,16.15,19.15,0.09
1115,0,10353428,32429,297.02,94827.96,2,10353428,0,10353428,32429,297.02,85.05,94827.96,0,18.84,19.15,0.09
1116,0,10385758,32330,296.11,95124.07,2,10385758,0,10385758,32330,296.11,85.24,95124.07,1,19.13,19.15,0.09
1117,0,10399710,13952,127.79,95251.86,2,10406695,6985,10399710,13952,127.79,85.27,95251.86,0,21.62,19.00,0.09
1118,0,10399710,0,0.00,95251.86,2,10413892,14182,10399710,0,0.00,85.20,95251.86,0,21.74,19.00,0.09
1119,0,10399710,0,0.00,95251.86,2,10418902,19192,10399710,0,0.00,85.12,95251.86,1,22.56,19.00,0.18
1120,0,10399710,0,0.00,95251.86,2,10423227,23517,10399710,0,0.00,85.05,95251.86,0,21.66,19.00,0.03
1121,0,10399710,0,0.00,95251.86,2,10427080,27370,10399710,0,0.00,84.97,95251.86,0,21.85,19.00,0.12
1122,0,10399710,0,0.00,95251.86,2,10430595,30885,10399710,0,0.00,84.89,95251.86,1,21.85,19.00,0.21
1123,0,10399710,0,0.00,95251.86,2,10433569,33859,10399710,0,0.00,84.82,95251.86,0,20.83,19.83,0.07
1124,0,10399710,0,0.00,95251.86,2,10436336,36626,10399710,0,0.00,84.74,95251.86,1,21.49,19.00,0.15
1125,0,10399710,0,0.00,95251.86,2,10439036,39326,10399710,0,0.00,84.67,95251.86,0,20.56,19.56,0.02
1126,0,10399710,0,0.00,95251.86,2,10441641,41931,10399710,0,0.00,84.59,95251.86,1,20.56,19.56,0.11
1127,0,10399710,0,0.00,95251.86,2,10444118,44408,10399710,0,0.00,84.52,95251.86,1,20.22,19.22,0.02
1128,0,10399710,0,0.00,95251.86,2,10446478,46768,10399710,0,0.00,84.44,95251.86,0,19.63,18.63,0.02
1129,0,10399710,0,0.00,95251.86,2,10448742,49032,10399710,0,0.00,84.37,95251.86,1,19.63,18.63,0.09
1130,0,10404142,4432,40.59,95292.45,2,10450958,46816,10404142,4432,40.59,84.33,95292.45,1,17.25,18.63,0.09
1131,0,10408552,4410,40.39,95332.84,2,10453163,44611,10408552,4410,40.39,84.29,95332.84,0,17.29,18.63,0.09
1132,0,10412922,4370,40.03,95372.87,2,10455348,42426,10412922,4370,40.03,84.25,95372.87,1,17.33,18.63,0.18
1133,0,10417266,4344,39.79,95412.66,2,10457520,40254,10417266,4344,39.79,84.21,95412.66,0,16.16,18.63,0.10
1134,0,10421566,4300,39.38,95452.04,2,10459670,38104,10421566,4300,39.38,84.17,95452.04,1,17.34,18.63,0.19
1135,0,10425824,4258,39.00,95491.04,2,10461799,35975,10425824,4258,39.00,84.13,95491.04,0,16.36,18.63,0.06
1136,0,10429934,4110,37.64,95528.69,2,10463854,33920,10429934,4110,37.64,84.09,95528.69,1,16.69,18.63,0.14
1137,0,10433786,3852,35.28,95563.97,2,10465780,31994,10433786,3852,35.28,84.05,95563.97,0,15.51,18.63,0.07
1138,0,10437722,3936,36.05,95600.02,2,10467748,30026,10437722,3936,36.05,84.01,95600.02,1,15.55,18.63,0.15
1139,0,10441714,3992,36.56,95636.58,2,10469744,28030,10441714,3992,36.56,83.97,95636.58,0,14.10,18.63,0.04
1140,0,10445696,3982,36.47,95673.05,2,10471735,26039,10445696,3982,36.47,83.92,95673.05,1,14.13,18.63,0.13
1141,0,10449628,3932,36.01,95709.06,2,10473701,24073,10449628,3932,36.01,83.88,95709.06,1,13.54,18.63,0.07
1142,0,10453866,4238,38.82,95747.88,2,10475820,21954,10453866,4238,38.82,83.84,95747.88,0,12.90,18.63,0.07
1143,0,10458262,4396,40.26,95788.14,2,10478018,19756,10458262,4396,40.26,83.80,95788.14,1,12.94,18.63,0.09
1144,0,10463018,4756,43.56,95831.70,2,10480396,17378,10463018,4756,43.56,83.77,95831.70,0,11.82,18.63,0.02
1145,0,10468278,5260,48.18,95879.88,2,10483026,14748,10468278,5260,48.18,83.74,95879.88,1,12.06,18.63,0.10
1146,0,10476938,8660,79.32,95959.20,2,10487356,10418,10476938,8660,79.32,83.73,95959.20,0,10.83,18.63,0.02
1147,0,10494382,17444,159.77,96118.97,2,10496078,1696,10494382,17444,159.77,83.80,96118.97,0,10.91,18.63,0.11
1148,0,10526509,32127,294.25,96413.23,2,10526509,0,10526509,32127,294.25,83.98,96413.23,1,11.07,18.63,0.19
1149,0,10558296,31787,291.14,96704.37,2,10558296,0,10558296,31787,291.14,84.16,96704.37,0,10.24,18.63,0.05
1150,0,10590798,32502,297.69,97002.05,2,10590798,0,10590798,32502,297.69,84.35,97002.05,1,12.89,18.63,0.13
1151,0,10622261,31463,288.17,97290.23,2,10622261,0,10622261,31463,288.17,84.53,97290.23,0,13.32,18.63,0.06
1152,0,10653990,31729,290.61,97580.84,2,10653990,0,10653990,31729,290.61,84.71,97580.84,1,15.93,18.63,0.15
1153,0,10686282,32292,295.77,97876.60,2,10686282,0,10686282,32292,295.77,84.89,97876.60,0,18.10,18.63,0.15
1154,0,10717524,31242,286.15,98162.75,2,10717524,0,10717524,31242,286.15,85.06,98162.75,1,18.39,18.63,0.09
1155,0,10717524,0,0.00,98162.75,2,10728053,10529,10717524,0,0.00,84.99,98162.75,0,20.03,19.03,0.02
1156,0,10717524,0,0.00,98162.75,2,10734200,16676,10717524,0,0.00,84.92,98162.75,1,21.53,19.00,0.11
1157,0,10717524,0,0.00,98162.75,2,10738759,21235,10717524,0,0.00,84.84,98162.75,0,19.38,18.38,0.11
1158,0,10717524,0,0.00,98162.75,2,10742688,25164,10717524,0,0.00,84.77,98162.75,1,19.38,18.38,0.09
1159,0,10724800,7276,66.64,98229.39,2,10746326,21526,10724800,7276,66.64,84.75,98229.39,0,18.29,18.38,0.03
1160,0,10731984,7184,65.80,98295.19,2,10749918,17934,10731984,7184,65.80,84.74,98295.19,1,18.35,18.38,0.11
1161,0,10738862,6878,63.00,98358.18,2,10753357,14495,10738862,6878,63.00,84.72,98358.18,0,16.75,18.38,0.11
1162,0,10746020,7158,65.56,98423.74,2,10756936,10916,10746020,7158,65.56,84.70,98423.74,1,16.81,18.38,0.09
1163,0,10765212,19192,175.78,98599.52,2,10766532,1320,10765212,19192,175.78,84.78,98599.52,0,15.38,18.38,0.09
1164,0,10798097,32885,301.20,98900.72,2,10798097,0,10798097,32885,301.20,84.97,98900.72,1,15.55,18.38,0.09
1165,0,10829299,31202,285.78,99186.51,2,10829299,0,10829299,31202,285.78,85.14,99186.51,0,16.54,18.38,0.09
1166,0,10860677,31378,287.39,99473.90,2,10860677,0,10860677,31378,287.39,85.31,99473.90,1,16.82,18.38,0.09
1167,0,10869630,8953,82.00,99555.90,2,10877993,8363,10869630,8953,82.00,85.31,99555.90,0,19.60,18.60,0.09
1168,0,10869630,0,0.00,99555.90,2,10884553,14923,10869630,0,0.00,85.24,99555.90,1,19.68,18.68,0.09
1169,0,10871281,1651,15.12,99571.02,2,10889537,18256,10871281,1651,15.12,85.18,99571.02,0,20.25,19.25,0.09
1170,0,10871281,0,0.00,99571.02,2,10893701,22420,10871281,0,0.00,85.10,99571.02,1,20.26,19.26,0.09
1171,0,10878765,7484,68.55,99639.57,2,10897443,18678,10878765,7484,68.55,85.09,99639.57,0,18.80,19.26,0.09
1172,0,10886269,7504,68.73,99708.30,2,10901195,14926,10886269,7504,68.73,85.08,99708.30,1,18.87,19.26,0.09
1173,0,10894108,7839,71.80,99780.09,2,10905227,11119,10894108,7839,71.80,85.06,99780.09,0,19.48,18.48,0.09
1174,0,10894108,0,0.00,99780.09,2,10909007,14899,10894108,0,0.00,84.99,99780.09,1,19.55,18.55,0.09
1175,0,10901898,7790,71.35,99851.45,2,10912902,11004,10901898,7790,71.35,84.98,99851.45,0,18.09,18.55,0.09
1176,0,10918816,16918,154.95,100006.40,2,10921361,2545,10918816,16918,154.95,85.04,100006.40,1,18.16,18.55,0.09
1177,0,10918816,0,0.00,100006.40,2,10930374,11558,10918816,0,0.00,84.97,100006.40,0,18.95,17.95,0.09
1178,0,10918816,0,0.00,100006.40,2,10935752,16936,10918816,0,0.00,84.90,100006.40,0,18.95,17.95,0.08
1179,0,10918816,0,0.00,100006.40,2,10939021,20205,10918816,0,0.00,84.82,100006.40,0,20.67,19.67,0.17
1180,0,10918816,0,0.00,100006.40,2,10941424,22608,10918816,0,0.00,84.75,100006.40,1,20.95,19.95,0.25
1181,0,10923432,4616,42.28,100048.68,2,10943732,20300,10923432,4616,42.28,84.72,100048.68,0,19.94,19.95,0.21
1182,0,10923432,0,0.00,100048.68,2,10945926,22494,10923432,0,0.00,84.64,100048.68,1,19.98,18.98,0.29
1183,0,10927784,4352,39.86,100088.54,2,10948102,20318,10927784,4352,39.86,84.61,100088.54,0,18.68,18.98,0.20
1184,0,10933256,5472,50.12,100138.66,2,10950838,17582,10933256,5472,50.12,84.58,100138.66,1,18.72,18.98,0.29
1185,0,10933256,0,0.00,100138.66,2,10953655,20399,10933256,0,0.00,84.51,100138.66,1,19.13,18.13,0.23
1186,0,10933256,0,0.00,100138.66,2,10955980,22724,10933256,0,0.00,84.43,100138.66,0,19.04,18.04,0.23
1187,0,10933256,0,0.00,100138.66,2,10958027,24771,10933256,0,0.00,84.36,100138.66,1,19.04,18.04,0.31
1188,0,10937358,4102,37.57,100176.23,2,10960078,22720,10937358,4102,37.57,84.32,100176.23,1,17.95,18.04,0.26
1189,0,10941986,4628,42.39,100218.62,2,10962392,20406,10941986,4628,42.39,84.29,100218.62,0,17.34,18.04,0.26
1190,0,10947588,5602,51.31,100269.92,2,10965193,17605,10947588,5602,51.31,84.26,100269.92,1,17.38,18.04,0.34
1191,0,10955144,7556,69.21,100339.13,2,10968971,13827,10955144,7556,69.21,84.25,100339.13,0,17.06,18.04,0.34
1192,0,10955144,0,0.00,100339.13,2,10972773,17629,10955144,0,0.00,84.18,100339.13,1,18.67,17.67,0.42
1193,0,10955144,0,0.00,100339.13,2,10975582,20438,10955144,0,0.00,84.11,100339.13,0,18.15,17.15,0.40
1194,0,10955144,0,0.00,100339.13,2,10977860,22716,10955144,0,0.00,84.04,100339.13,1,18.23,17.23,0.48
1195,0,10955144,0,0.00,100339.13,2,10979834,24690,10955144,0,0.00,83.97,100339.13,0,17.48,16.48,0.47
1196,0,10955144,0,0.00,100339.13,2,10981632,26488,10955144,0,0.00,83.90,100339.13,1,17.48,16.48,0.55
1197,0,10955144,0,0.00,100339.13,2,10983347,28203,10955144,0,0.00,83.83,100339.13,0,16.62,15.62,0.52
1198,0,10955144,0,0.00,100339.13,2,10985007,29863,10955144,0,0.00,83.76,100339.13,1,16.62,15.62,0.60
1199,0,10955144,0,0.00,100339.13,2,10986596,31452,10955144,0,0.00,83.69,100339.13,1,15.88,14.88,0.59
1200,0,10955144,0,0.00,100339.13,2,10988138,32994,10955144,0,0.00,83.62,100339.13,0,15.16,14.16,0.58
1201,0,10955144,0,0.00,100339.13,2,10989642,34498,10955144,0,0.00,83.55,100339.13,1,15.16,14.16,0.66
1202,0,10955144,0,0.00,100339.13,2,10991113,35969,10955144,0,0.00,83.48,100339.13,0,14.77,13.77,0.70
1203,0,10955144,0,0.00,100339.13,2,10992555,37411,10955144,0,0.00,83.41,100339.13,1,14.77,13.77,0.78
1204,0,10955144,0,0.00,100339.13,2,10993972,38828,10955144,0,0.00,83.34,100339.13,0,14.13,13.13,0.78
1205,0,10955144,0,0.00,100339.13,2,10995364,40220,10955144,0,0.00,83.27,100339.13,1,14.13,13.13,0.86
1206,0,10955144,0,0.00,100339.13,2,10996731,41587,10955144,0,0.00,83.20,100339.13,0,13.34,12.34,0.84
1207,0,10955144,0,0.00,100339.13,2,10998077,42933,10955144,0,0.00,83.13,100339.13,1,13.34,12.34,0.92
1208,0,10957820,2676,24.51,100363.64,2,10999415,41595,10957820,2676,24.51,83.08,100363.64,0,12.33,12.34,0.88
1209,0,10957820,0,0.00,100363.64,2,11000768,42948,10957820,0,0.00,83.01,100363.64,1,12.35,11.35,0.96
1210,0,10960608,2788,25.54,100389.17,2,11002162,41554,10960608,2788,25.54,82.97,100389.17,0,11.35,11.35,0.91
1211,0,10960608,0,0.00,100389.17,2,11003553,42945,10960608,0,0.00,82.90,100389.17,0,11.37,10.37,0.99
1212,0,10960608,0,0.00,100389.17,2,11004904,44296,10960608,0,0.00,82.83,100389.17,1,11.37,10.37,1.08
1213,0,10963324,2716,24.88,100414.05,2,11006262,42938,10963324,2716,24.88,82.78,100414.05,0,9.85,10.37,0.96
1214,0,10966096,2772,25.39,100439.44,2,11007648,41552,10966096,2772,25.39,82.73,100439.44,1,10.10,10.37,1.04
1215,0,10968898,2802,25.66,100465.10,2,11009049,40151,10968898,2802,25.66,82.69,100465.10,0,10.00,10.37,1.00
1216,0,10968898,0,0.00,100465.10,2,11010452,41554,10968898,0,0.00,82.62,100465.10,1,10.56,9.56,1.08
1217,0,10971676,2778,25.44,100490.55,2,11011841,40165,10971676,2778,25.44,82.57,100490.55,0,9.39,9.56,0.99
1218,0,10974646,2970,27.20,100517.75,2,11013326,38680,10974646,2970,27.20,82.53,100517.75,1,9.41,9.56,1.07
1219,0,10977764,3118,28.56,100546.30,2,11014885,37121,10977764,3118,28.56,82.48,100546.30,0,8.27,9.56,1.00
1220,0,10981004,3240,29.68,100575.98,2,11016505,35501,10981004,3240,29.68,82.44,100575.98,1,8.30,9.56,1.08
1221,0,10984258,3254,29.80,100605.79,2,11018132,33874,10984258,3254,29.80,82.40,100605.79,0,6.88,9.56,0.98
1222,0,10987628,3370,30.87,100636.66,2,11019817,32189,10987628,3370,30.87,82.35,100636.66,1,6.91,9.56,1.06
1223,0,10991008,3380,30.96,100667.61,2,11021507,30499,10991008,3380,30.96,82.31,100667.61,0,5.95,9.56,0.96
1224,0,10994382,3374,30.90,100698.52,2,11023194,28812,10994382,3374,30.90,82.27,100698.52,1,5.98,9.56,1.04
1225,0,10997656,3274,29.99,100728.50,2,11024831,27175,10997656,3274,29.99,82.23,100728.50,0,4.95,9.56,0.92
1226,0,11000902,3246,29.73,100758.23,2,11026454,25552,11000902,3246,29.73,82.18,100758.23,1,5.54,9.56,1.00
1227,0,11004316,3414,31.27,100789.50,2,11028161,23845,11004316,3414,31.27,82.14,100789.50,0,4.80,9.56,0.94
1228,0,11007974,3658,33.50,100823.01,2,11029990,22016,11007974,3658,33.50,82.10,100823.01,1,4.83,9.56,1.03
1229,0,11011880,3906,35.78,100858.78,2,11031943,20063,11011880,3906,35.78,82.07,100858.78,0,3.02,9.56,0.87
1230,0,11016146,4266,39.07,100897.85,2,11034076,17930,11016146,4266,39.07,82.03,100897.85,1,3.05,9.56,0.95
1231,0,11021098,4952,45.36,100943.21,2,11036552,15454,11021098,4952,45.36,82.00,100943.21,1,2.11,9.56,0.91
1232,0,11028982,7884,72.21,101015.42,2,11040494,11512,11028982,7884,72.21,81.99,101015.42,0,1.61,9.56,0.92
1233,0,11044266,15284,139.99,101155.41,2,11048136,3870,11044266,15284,139.99,82.04,101155.41,1,3.53,9.56,1.00
1234,0,11076871,32605,298.63,101454.04,2,11076871,0,11076871,32605,298.63,82.22,101454.04,0,3.71,9.56,1.02
1235,0,11111122,34251,313.71,101767.74,2,11111122,0,11111122,34251,313.71,82.40,101767.74,1,5.73,9.56,1.10
1236,0,11145994,34872,319.40,102087.14,2,11145994,0,11145994,34872,319.40,82.59,102087.14,0,6.79,9.56,1.01
1237,0,11181754,35760,327.53,102414.67,2,11181754,0,11181754,35760,327.53,82.79,102414.67,0,7.10,9.56,1.09
1238,0,11215926,34172,312.98,102727.66,2,11215926,0,11215926,34172,312.98,82.98,102727.66,0,9.35,9.56,1.17
1239,0,11215926,0,0.00,102727.66,2,11226801,10875,11215926,0,0.00,82.91,102727.66,1,11.66,10.66,1.25
1240,0,11236138,20212,185.12,102912.78,2,11236907,769,11236138,20212,185.12,82.99,102912.78,0,10.63,10.66,1.14
1241,0,11236138,0,0.00,102912.78,2,11247338,11200,11236138,0,0.00,82.93,102912.78,1,10.81,9.81,1.22
1242,0,11257244,21106,193.31,103106.09,2,11257891,647,11257244,21106,193.31,83.02,103106.09,0,9.22,9.81,1.07
1243,0,11257244,0,0.00,103106.09,2,11267978,10734,11257244,0,0.00,82.95,103106.09,1,10.30,9.30,1.15
1244,0,11277072,19828,181.61,103287.70,2,11277892,820,11277072,19828,181.61,83.03,103287.70,1,9.10,9.30,1.03
1245,0,11312054,34982,320.40,103608.10,2,11312054,0,11312054,34982,320.40,83.22,103608.10,0,8.90,9.30,0.99
1246,0,11312054,0,0.00,103608.10,2,11322797,10743,11312054,0,0.00,83.15,103608.10,1,9.32,8.32,1.07
1247,0,11333232,21178,193.97,103802.07,2,11333386,154,11333232,21178,193.97,83.24,103802.07,0,7.95,8.32,0.97
1248,0,11333232,0,0.00,103802.07,2,11344460,11228,11333232,0,0.00,83.17,103802.07,1,9.39,8.39,1.05
1249,0,11333232,0,0.00,103802.07,2,11350062,16830,11333232,0,0.00,83.11,103802.07,0,10.18,9.18,0.98
1250,0,11333232,0,0.00,103802.07,2,11354393,21161,11333232,0,0.00,83.04,103802.07,1,10.21,9.21,1.06
1251,0,11341530,8298,76.00,103878.07,2,11358542,17012,11341530,8298,76.00,83.04,103878.07,1,8.33,9.21,0.90
1252,0,11349344,7814,71.57,103949.64,2,11362449,13105,11349344,7814,71.57,83.03,103949.64,0,9.05,9.21,0.85
1253,0,11349344,0,0.00,103949.64,2,11366097,16753,11349344,0,0.00,82.96,103949.64,1,9.37,8.37,0.93
1254,0,11356478,7134,65.34,104014.98,2,11369664,13186,11356478,7134,65.34,82.95,104014.98,0,8.16,8.37,0.86
1255,0,11370412,13934,127.62,104142.61,2,11376631,6219,11370412,13934,127.62,82.98,104142.61,1,8.23,8.37,0.93
1256,0,11401481,31069,284.56,104427.17,2,11401481,0,11401481,31069,284.56,83.14,104427.17,0,6.86,8.37,0.83
1257,0,11401481,0,0.00,104427.17,2,11412162,10681,11401481,0,0.00,83.08,104427.17,0,11.10,10.10,0.91
1258,0,11401481,0,0.00,104427.17,2,11417837,16356,11401481,0,0.00,83.01,104427.17,1,11.69,10.69,0.99
1259,0,11411533,10052,92.07,104519.23,2,11422863,11330,11411533,10052,92.07,83.02,104519.23,0,10.19,10.69,0.88
1260,0,11428053,16520,151.31,104670.55,2,11431123,3070,11428053,16520,151.31,83.07,104670.55,1,10.28,10.69,0.96
1261,0,11428053,0,0.00,104670.55,2,11440213,12160,11428053,0,0.00,83.01,104670.55,0,11.86,10.86,0.90
1262,0,11428053,0,0.00,104670.55,2,11445656,17603,11428053,0,0.00,82.94,104670.55,1,12.74,11.74,0.98
1263,0,11437267,9214,84.39,104754.94,2,11450263,12996,11437267,9214,84.39,82.94,104754.94,0,11.65,11.74,0.89
1264,0,11437267,0,0.00,104754.94,2,11454973,17706,11437267,0,0.00,82.88,104754.94,1,13.45,12.45,0.97
1265,0,11445667,8400,76.94,104831.88,2,11459173,13506,11445667,8400,76.94,82.87,104831.88,0,12.05,12.45,0.87
1266,0,11458275,12608,115.48,104947.35,2,11465477,7202,11458275,12608,115.48,82.90,104947.35,1,12.13,12.45,0.95
1267,0,11483943,25668,235.10,105182.45,2,11483943,0,11483943,25668,235.10,83.02,105182.45,0,11.59,12.45,0.82
1268,0,11483943,0,0.00,105182.45,2,11494440,10497,11483943,0,0.00,82.95,105182.45,1,12.77,11.77,0.90
1269,0,11504147,20204,185.05,105367.50,2,11504542,395,11504147,20204,185.05,83.03,105367.50,0,11.51,11.77,0.77
1270,0,11535713,31566,289.12,105656.61,2,11535713,0,11535713,31566,289.12,83.19,105656.61,1,11.76,11.77,0.85
1271,0,11535713,0,0.00,105656.61,2,11546680,10967,11535713,0,0.00,83.13,105656.61,0,12.14,11.14,0.75
1272,0,11535713,0,0.00,105656.61,2,11552747,17034,11535713,0,0.00,83.06,105656.61,1,13.00,12.00,0.83
1273,0,11535713,0,0.00,105656.61,2,11557154,21441,11535713,0,0.00,83.00,105656.61,0,12.16,11.16,0.67
1274,0,11535713,0,0.00,105656.61,2,11561277,25564,11535713,0,0.00,82.93,105656.61,1,12.16,11.16,0.75
1275,0,11535713,0,0.00,105656.61,2,11564988,29275,11535713,0,0.00,82.87,105656.61,0,11.16,10.16,0.66
1276,0,11535713,0,0.00,105656.61,2,11568368,32655,11535713,0,0.00,82.80,105656.61,1,11.88,10.88,0.74
1277,0,11542125,6412,58.73,105715.34,2,11571574,29449,11542125,6412,58.73,82.78,105715.34,0,10.33,10.88,0.61
1278,0,11548201,6076,55.65,105770.99,2,11574612,26411,11548201,6076,55.65,82.76,105770.99,0,10.39,10.88,0.69
1279,0,11548201,0,0.00,105770.99,2,11577371,29170,11548201,0,0.00,82.70,105770.99,1,11.10,10.10,0.76
1280,0,11553561,5360,49.09,105820.09,2,11580051,26490,11553561,5360,49.09,82.67,105820.09,1,9.25,10.10,0.59
1281,0,11558921,5360,49.09,105869.18,2,11582731,23810,11558921,5360,49.09,82.65,105869.18,0,7.95,10.10,0.50
1282,0,11563863,4942,45.26,105914.44,2,11585202,21339,11563863,4942,45.26,82.62,105914.44,1,8.24,10.10,0.57
1283,0,11568623,4760,43.60,105958.04,2,11587582,18959,11568623,4760,43.60,82.59,105958.04,0,7.04,10.10,0.50
1284,0,11573969,5346,48.96,106007.00,2,11590255,16286,11573969,5346,48.96,82.56,106007.00,1,7.17,10.10,0.58
1285,0,11580203,6234,57.10,106064.10,2,11593372,13169,11580203,6234,57.10,82.54,106064.10,0,6.40,10.10,0.56
1286,0,11594219,14016,128.37,106192.48,2,11600380,6161,11594219,14016,128.37,82.58,106192.48,1,6.45,10.10,0.64
1287,0,11624527,30308,277.59,106470.07,2,11624527,0,11624527,30308,277.59,82.73,106470.07,0,5.01,10.10,0.51
1288,0,11659101,34574,316.67,106786.73,2,11659101,0,11659101,34574,316.67,82.91,106786.73,1,6.51,10.10,0.59
1289,0,11692854,33753,309.15,107095.88,2,11692854,0,11692854,33753,309.15,83.08,107095.88,0,7.78,10.10,0.55
1290,0,11727556,34702,317.84,107413.72,2,11727556,0,11727556,34702,317.84,83.27,107413.72,1,9.08,10.10,0.63
1291,0,11761016,33460,306.46,107720.18,2,11761016,0,11761016,33460,306.46,83.44,107720.18,0,8.96,10.10,0.50
1292,0,11794877,33861,310.14,108030.32,2,11794877,0,11794877,33861,310.14,83.61,108030.32,0,9.76,10.10,0.58
1293,0,11794877,0,0.00,108030.32,2,11805993,11116,11794877,0,0.00,83.55,108030.32,1,10.64,9.64,0.65
1294,0,11814841,19964,182.85,108213.17,2,11815975,1134,11814841,19964,182.85,83.63,108213.17,0,9.43,9.64,0.59
1295,0,11814841,0,0.00,108213.17,2,11825761,10920,11814841,0,0.00,83.56,108213.17,1,10.86,9.86,0.66
1296,0,11814841,0,0.00,108213.17,2,11831201,16360,11814841,0,0.00,83.50,108213.17,0,11.16,10.16,0.57
1297,0,11814841,0,0.00,108213.17,2,11834607,19766,11814841,0,0.00,83.43,108213.17,1,11.16,10.16,0.65
1298,0,11814841,0,0.00,108213.17,2,11837578,22737,11814841,0,0.00,83.37,108213.17,0,10.75,9.75,0.54
1299,0,11814841,0,0.00,108213.17,2,11840210,25369,11814841,0,0.00,83.30,108213.17,0,11.61,10.61,0.62
1300,0,11814841,0,0.00,108213.17,2,11842622,27781,11814841,0,0.00,83.24,108213.17,1,11.61,10.61,0.69
1301,0,11814841,0,0.00,108213.17,2,11844998,30157,11814841,0,0.00,83.18,108213.17,0,10.74,9.74,0.66
1302,0,11814841,0,0.00,108213.17,2,11847374,32533,11814841,0,0.00,83.11,108213.17,1,10.74,9.74,0.74
1303,0,11819629,4788,43.85,108257.02,2,11849768,30139,11819629,4788,43.85,83.08,108257.02,1,9.50,9.74,0.67
1304,0,11825095,5466,50.06,108307.09,2,11852501,27406,11825095,5466,50.06,83.06,108307.09,0,8.36,9.74,0.60
1305,0,11830775,5680,52.02,108359.11,2,11855341,24566,11830775,5680,52.02,83.03,108359.11,1,8.40,9.74,0.68
1306,0,11836347,5572,51.03,108410.15,2,11858127,21780,11836347,5572,51.03,83.01,108410.15,1,7.54,9.74,0.65
1307,0,11841639,5292,48.47,108458.62,2,11860773,19134,11841639,5292,48.47,82.98,108458.62,0,6.62,9.74,0.61
1308,0,11847127,5488,50.27,108508.88,2,11863517,16390,11847127,5488,50.27,82.96,108508.88,1,6.66,9.74,0.68
1309,0,11853299,6172,56.53,108565.41,2,11866603,13304,11853299,6172,56.53,82.94,108565.41,1,5.52,9.74,0.62
1310,0,11864725,11426,104.65,108670.06,2,11872316,7591,11864725,11426,104.65,82.95,108670.06,0,4.36,9.74,0.55
1311,0,11891835,27110,248.30,108918.37,2,11891835,0,11891835,27110,248.30,83.08,108918.37,0,4.46,9.74,0.63
1312,0,11926873,35038,320.92,109239.28,2,11926873,0,11926873,35038,320.92,83.26,109239.28,1,6.12,9.74,0.70
1313,0,11961727,34854,319.23,109558.52,2,11961727,0,11961727,34854,319.23,83.44,109558.52,0,6.93,9.74,0.58
1314,0,11996397,34670,317.55,109876.05,2,11996397,0,11996397,34670,317.55,83.62,109876.05,1,8.00,9.74,0.66
1315,0,11996397,0,0.00,109876.05,2,12006961,10564,11996397,0,0.00,83.56,109876.05,0,10.48,9.48,0.56
1316,0,11996397,0,0.00,109876.05,2,12012861,16464,11996397,0,0.00,83.49,109876.05,1,11.54,10.54,0.63
1317,0,12006603,10206,93.48,109969.53,2,12017964,11361,12006603,10206,93.48,83.50,109969.53,0,10.38,10.54,0.54
1318,0,12024139,17536,160.61,110130.15,2,12026732,2593,12024139,17536,160.61,83.56,110130.15,0,10.47,10.54,0.61
1319,0,12024139,0,0.00,110130.15,2,12035500,11361,12024139,0,0.00,83.50,110130.15,0,12.99,11.99,0.69
1320,0,12024139,0,0.00,110130.15,2,12040675,16536,12024139,0,0.00,83.43,110130.15,1,13.30,12.30,0.77
1321,0,12024139,0,0.00,110130.15,2,12044029,19890,12024139,0,0.00,83.37,110130.15,1,12.63,11.63,0.59
1322,0,12024139,0,0.00,110130.15,2,12046712,22573,12024139,0,0.00,83.31,110130.15,0,11.97,10.97,0.52
1323,0,12024139,0,0.00,110130.15,2,12049084,24945,12024139,0,0.00,83.24,110130.15,0,11.97,10.97,0.60
1324,0,12024139,0,0.00,110130.15,2,12051293,27154,12024139,0,0.00,83.18,110130.15,1,11.97,10.97,0.67
1325,0,12028463,4324,39.60,110169.75,2,12053455,24992,12028463,4324,39.60,83.15,110169.75,1,10.14,10.97,0.54
1326,0,12033233,4770,43.69,110213.45,2,12055840,22607,12033233,4770,43.69,83.12,110213.45,0,8.99,10.97,0.47
1327,0,12038779,5546,50.80,110264.23,2,12058613,19834,12038779,5546,50.80,83.09,110264.23,1,9.89,10.97,0.55
1328,0,12045221,6442,59.00,110323.24,2,12061834,16613,12045221,6442,59.00,83.07,110323.24,0,9.73,10.97,0.49
1329,0,12052233,7012,64.22,110387.46,2,12065340,13107,12052233,7012,64.22,83.06,110387.46,1,10.08,10.97,0.57
1330,0,12063773,11540,105.70,110493.16,2,12071110,7337,12063773,11540,105.70,83.08,110493.16,0,8.75,10.97,0.48
1331,0,12091165,27392,250.89,110744.05,2,12091165,0,12091165,27392,250.89,83.20,110744.05,1,8.85,10.97,0.56
1332,0,12125009,33844,309.98,111054.02,2,12125009,0,12125009,33844,309.98,83.37,111054.02,1,9.92,10.97,0.53
1333,0,12158105,33096,303.13,111357.16,2,12158105,0,12158105,33096,303.13,83.54,111357.16,0,9.53,10.97,0.48
1334,0,12190217,32112,294.12,111651.27,2,12190217,0,12190217,32112,294.12,83.70,111651.27,1,10.46,10.97,0.56
1335,0,12190217,0,0.00,111651.27,2,12200797,10580,12190217,0,0.00,83.63,111651.27,0,11.22,10.22,0.52
1336,0,12190217,0,0.00,111651.27,2,12206877,16660,12190217,0,0.00,83.57,111651.27,1,12.03,11.03,0.59
1337,0,12190217,0,0.00,111651.27,2,12211591,21374,12190217,0,0.00,83.51,111651.27,0,11.09,10.09,0.54
1338,0,12190217,0,0.00,111651.27,2,12215663,25446,12190217,0,0.00,83.45,111651.27,1,11.61,10.61,0.61
1339,0,12197723,7506,68.75,111720.02,2,12219416,21693,12197723,7506,68.75,83.44,111720.02,0,10.23,10.61,0.53
1340,0,12197723,0,0.00,111720.02,2,12222972,25249,12197723,0,0.00,83.37,111720.02,1,10.69,9.69,0.60
1341,0,12197723,0,0.00,111720.02,2,12225902,28179,12197723,0,0.00,83.31,111720.02,0,9.70,8.70,0.56
1342,0,12197723,0,0.00,111720.02,2,12228627,30904,12197723,0,0.00,83.25,111720.02,1,9.70,8.70,0.64
1343,0,12203125,5402,49.48,111769.50,2,12231328,28203,12203125,5402,49.48,83.22,111769.50,1,8.57,8.70,0.58
1344,0,12208455,5330,48.82,111818.31,2,12233993,25538,12208455,5330,48.82,83.20,111818.31,0,8.27,8.70,0.54
1345,0,12213753,5298,48.52,111866.84,2,12236642,22889,12213753,5298,48.52,83.17,111866.84,1,8.32,8.70,0.61
1346,0,12218887,5134,47.02,111913.86,2,12239209,20322,12218887,5134,47.02,83.15,111913.86,0,7.15,8.70,0.55
1347,0,12224251,5364,49.13,111962.99,2,12241891,17640,12224251,5364,49.13,83.12,111962.99,0,7.20,8.70,0.62
1348,0,12229997,5746,52.63,112015.62,2,12244764,14767,12229997,5746,52.63,83.10,112015.62,1,8.08,8.70,0.69
1349,0,12238407,8410,77.03,112092.65,2,12248969,10562,12238407,8410,77.03,83.09,112092.65,0,6.31,8.70,0.56
1350,0,12258099,19692,180.36,112273.01,2,12258815,716,12258099,19692,180.36,83.17,112273.01,1,6.39,8.70,0.63
1351,0,12292352,34253,313.73,112586.73,2,12292352,0,12292352,34253,313.73,83.34,112586.73,0,6.55,8.70,0.58
1352,0,12292352,0,0.00,112586.73,2,12302905,10553,12292352,0,0.00,83.27,112586.73,1,11.85,10.85,0.65
1353,0,12292352,0,0.00,112586.73,2,12308588,16236,12292352,0,0.00,83.21,112586.73,0,10.86,9.86,0.55
1354,0,12292352,0,0.00,112586.73,2,12312956,20604,12292352,0,0.00,83.15,112586.73,1,10.96,9.96,0.62
1355,0,12292352,0,0.00,112586.73,2,12316721,24369,12292352,0,0.00,83.09,112586.73,0,10.05,9.05,0.57
1356,0,12292352,0,0.00,112586.73,2,12320074,27722,12292352,0,0.00,83.03,112586.73,1,10.05,9.05,0.64
1357,0,12298728,6376,58.40,112645.13,2,12323262,24534,12298728,6376,58.40,83.01,112645.13,0,8.49,9.05,0.51
1358,0,12305150,6422,58.82,112703.95,2,12326473,21323,12305150,6422,58.82,82.99,112703.95,0,8.55,9.05,0.58
1359,0,12311490,6340,58.07,112762.02,2,12329643,18153,12311490,6340,58.07,82.97,112762.02,1,8.61,9.05,0.66
1360,0,12317652,6162,56.44,112818.46,2,12332724,15072,12317652,6162,56.44,82.95,112818.46,0,7.97,9.05,0.65
1361,0,12324290,6638,60.80,112879.26,2,12336043,11753,12324290,6638,60.80,82.94,112879.26,1,8.03,9.05,0.72
1362,0,12338068,13778,126.19,113005.45,2,12342932,4864,12338068,13778,126.19,82.97,113005.45,0,6.77,9.05,0.65
1363,0,12369428,31360,287.23,113292.68,2,12369428,0,12369428,31360,287.23,83.12,113292.68,1,8.11,9.05,0.72
1364,0,12403738,34310,314.25,113606.93,2,12403738,0,12403738,34310,314.25,83.29,113606.93,1,8.87,9.05,0.64
1365,0,12403738,0,0.00,113606.93,2,12414490,10752,12403738,0,0.00,83.23,113606.93,0,10.77,9.77,0.63
1366,0,12403738,0,0.00,113606.93,2,12420152,16414,12403738,0,0.00,83.17,113606.93,1,10.77,9.77,0.70
1367,0,12403738,0,0.00,113606.93,2,12424427,20689,12403738,0,0.00,83.11,113606.93,0,11.60,10.60,0.64
1368,0,12403738,0,0.00,113606.93,2,12428353,24615,12403738,0,0.00,83.05,113606.93,1,11.60,10.60,0.71
1369,0,12411136,7398,67.76,113674.69,2,12432052,20916,12411136,7398,67.76,83.03,113674.69,0,10.54,10.60,0.67
1370,0,12411136,0,0.00,113674.69,2,12435411,24275,12411136,0,0.00,82.97,113674.69,1,11.74,10.74,0.74
1371,0,12411136,0,0.00,113674.69,2,12438560,27424,12411136,0,0.00,82.91,113674.69,0,11.51,10.51,0.69
1372,0,12411136,0,0.00,113674.69,2,12441416,30280,12411136,0,0.00,82.85,113674.69,1,11.51,10.51,0.76
1373,0,12411136,0,0.00,113674.69,2,12444075,32939,12411136,0,0.00,82.79,113674.69,0,10.62,9.62,0.70
1374,0,12411136,0,0.00,113674.69,2,12446608,35472,12411136,0,0.00,82.73,113674.69,1,11.01,10.01,0.77
1375,0,12411136,0,0.00,113674.69,2,12448855,37719,12411136,0,0.00,82.67,113674.69,0,10.33,9.33,0.71
1376,0,12411136,0,0.00,113674.69,2,12450919,39783,12411136,0,0.00,82.61,113674.69,1,10.84,9.84,0.78
1377,0,12411136,0,0.00,113674.69,2,12452954,41818,12411136,0,0.00,82.55,113674.69,0,10.14,9.14,0.74
1378,0,12411136,0,0.00,113674.69,2,12454957,43821,12411136,0,0.00,82.49,113674.69,1,10.14,9.14,0.81
1379,0,12415236,4100,37.55,113712.24,2,12457007,41771,12415236,4100,37.55,82.46,113712.24,0,9.09,9.14,0.76
1380,0,12415236,0,0.00,113712.24,2,12459024,43788,12415236,0,0.00,82.40,113712.24,1,9.14,8.14,0.83
1381,0,12419174,3938,36.07,113748.31,2,12460993,41819,12419174,3938,36.07,82.37,113748.31,1,8.02,8.14,0.78
1382,0,12423072,3898,35.70,113784.01,2,12462942,39870,12423072,3898,35.70,82.33,113784.01,0,7.16,8.14,0.75
1383,0,12426944,3872,35.46,113819.48,2,12464878,37934,12426944,3872,35.46,82.30,113819.48,0,7.19,8.14,0.82
1384,0,12430826,3882,35.56,113855.03,2,12466819,35993,12430826,3882,35.56,82.27,113855.03,1,7.25,8.14,0.89
1385,0,12434738,3912,35.83,113890.86,2,12468775,34037,12434738,3912,35.83,82.23,113890.86,1,6.09,8.14,0.83
1386,0,12438826,4088,37.44,113928.30,2,12470819,31993,12438826,4088,37.44,82.20,113928.30,0,5.23,8.14,0.80
1387,0,12442964,4138,37.90,113966.20,2,12472888,29924,12442964,4138,37.90,82.17,113966.20,1,5.27,8.14,0.87
1388,0,12447090,4126,37.79,114003.99,2,12474951,27861,12447090,4126,37.79,82.14,114003.99,0,4.52,8.14,0.85
1389,0,12451220,4130,37.83,114041.82,2,12477016,25796,12451220,4130,37.83,82.10,114041.82,1,4.56,8.14,0.92
1390,0,12455310,4090,37.46,114079.28,2,12479061,23751,12455310,4090,37.46,82.07,114079.28,0,3.89,8.14,0.91
1391,0,12459228,3918,35.89,114115.16,2,12481020,21792,12459228,3918,35.89,82.04,114115.16,1,4.25,8.14,0.98
1392,0,12463426,4198,38.45,114153.62,2,12483119,19693,12463426,4198,38.45,82.01,114153.62,0,3.49,8.14,0.97
1393,0,12468136,4710,43.14,114196.76,2,12485474,17338,12468136,4710,43.14,81.98,114196.76,1,3.62,8.14,1.04
1394,0,12473822,5686,52.08,114248.84,2,12488317,14495,12473822,5686,52.08,81.96,114248.84,0,2.95,8.14,1.03
1395,0,12484644,10822,99.12,114347.95,2,12493728,9084,12484644,10822,99.12,81.97,114347.95,0,3.02,8.14,1.10
1396,0,12509552,24908,228.13,114576.09,2,12509552,0,12509552,24908,228.13,82.07,114576.09,1,3.61,8.14,1.17
1397,0,12544326,34774,318.50,114894.59,2,12544326,0,12544326,34774,318.50,82.24,114894.59,0,3.79,8.14,1.08
1398,0,12579089,34763,318.40,115212.98,2,12579089,0,12579089,34763,318.40,82.41,115212.98,1,5.09,8.14,1.15
1399,0,12614102,35013,320.69,115533.67,2,12614102,0,12614102,35013,320.69,82.58,115533.67,0,7.08,8.14,1.11
1400,0,12649321,35219,322.57,115856.24,2,12649321,0,12649321,35219,322.57,82.75,115856.24,1,7.76,8.14,1.18
1401,0,12683976,34655,317.41,116173.66,2,12683976,0,12683976,34655,317.41,82.92,116173.66,0,8.11,8.14,1.10
1402,0,12683976,0,0.00,116173.66,2,12695252,11276,12683976,0,0.00,82.86,116173.66,1,9.24,8.24,1.17
1403,0,12683976,0,0.00,116173.66,2,12701346,17370,12683976,0,0.00,82.80,116173.66,0,8.37,8.00,1.11
1404,0,12693686,9710,88.93,116262.59,2,12706201,12515,12693686,9710,88.93,82.81,116262.59,1,11.33,12.33,1.18
1405,0,12708224,14538,133.15,116395.74,2,12713470,5246,12708224,14538,133.15,82.84,116395.74,0,9.52,12.33,1.04
1406,0,12739878,31654,289.92,116685.66,2,12739878,0,12739878,31654,289.92,82.99,116685.66,1,9.65,12.33,1.11
1407,0,12773243,33365,305.59,116991.26,2,12773243,0,12773243,33365,305.59,83.15,116991.26,0,8.94,12.33,1.07
1408,0,12806931,33688,308.55,117299.81,2,12806931,0,12806931,33688,308.55,83.31,117299.81,1,9.23,12.33,1.14
1409,0,12840082,33151,303.63,117603.45,2,12840082,0,12840082,33151,303.63,83.47,117603.45,0,9.97,12.33,1.04
1410,0,12871927,31845,291.67,117895.12,2,12871927,0,12871927,31845,291.67,83.61,117895.12,1,11.96,12.33,1.11
1411,0,12871927,0,0.00,117895.12,2,12882605,10678,12871927,0,0.00,83.55,117895.12,0,12.63,11.63,1.03
1412,0,12871927,0,0.00,117895.12,2,12888749,16822,12871927,0,0.00,83.50,117895.12,1,13.21,12.21,1.10
1413,0,12871927,0,0.00,117895.12,2,12893393,21466,12871927,0,0.00,83.44,117895.12,0,13.50,12.50,1.01
1414,0,12871927,0,0.00,117895.12,2,12897191,25264,12871927,0,0.00,83.38,117895.12,1,13.81,12.81,1.09
1415,0,12878877,6950,63.66,117958.77,2,12900666,21789,12878877,6950,63.66,83.36,117958.77,0,12.13,12.81,0.97
1416,0,12886143,7266,66.55,118025.32,2,12904299,18156,12886143,7266,66.55,83.35,118025.32,1,12.19,12.81,1.04
1417,0,12893293,7150,65.49,118090.80,2,12907874,14581,12893293,7150,65.49,83.34,118090.80,0,12.77,12.81,0.98
1418,0,12893293,0,0.00,118090.80,2,12911203,17910,12893293,0,0.00,83.28,118090.80,1,13.10,12.10,1.05
1419,0,12899553,6260,57.34,118148.14,2,12914333,14780,12899553,6260,57.34,83.26,118148.14,0,11.48,12.10,0.94
1420,0,12908515,8962,82.08,118230.23,2,12918814,10299,12908515,8962,82.08,83.26,118230.23,1,11.54,12.10,1.01
1421,0,12928459,19944,182.67,118412.90,2,12928786,327,12928459,19944,182.67,83.33,118412.90,1,10.20,12.10,0.93
1422,0,12961158,32699,299.49,118712.39,2,12961158,0,12961158,32699,299.49,83.48,118712.39,0,10.22,12.10,0.89
1423,0,12961158,0,0.00,118712.39,2,12971949,10791,12961158,0,0.00,83.42,118712.39,0,14.01,13.01,0.96
1424,0,12961158,0,0.00,118712.39,2,12977539,16381,12961158,0,0.00,83.37,118712.39,1,15.68,14.68,1.03
1425,0,12961158,0,0.00,118712.39,2,12981912,20754,12961158,0,0.00,83.31,118712.39,1,14.84,13.84,0.97
1426,0,12961158,0,0.00,118712.39,2,12985644,24486,12961158,0,0.00,83.25,118712.39,0,14.66,13.66,0.92
1427,0,12961158,0,0.00,118712.39,2,12988956,27798,12961158,0,0.00,83.19,118712.39,0,15.12,14.12,0.99
1428,0,12961158,0,0.00,118712.39,2,12991914,30756,12961158,0,0.00,83.13,118712.39,1,15.41,14.41,1.06
1429,0,12966810,5652,51.77,118764.16,2,12994740,27930,12966810,5652,51.77,83.11,118764.16,1,14.03,14.41,0.98
1430,0,12972850,6040,55.32,118819.48,2,12997760,24910,12972850,6040,55.32,83.09,118819.48,0,13.08,14.41,0.94
1431,0,12978952,6102,55.89,118875.37,2,13000811,21859,12978952,6102,55.89,83.07,118875.37,0,13.14,14.41,1.01
1432,0,12984926,5974,54.72,118930.08,2,13003798,18872,12984926,5974,54.72,83.05,118930.08,1,13.19,14.41,1.07
1433,0,12990810,5884,53.89,118983.98,2,13006740,15930,12990810,5884,53.89,83.03,118983.98,0,11.52,14.41,0.96
1434,0,12997066,6256,57.30,119041.27,2,13009868,12802,12997066,6256,57.30,83.01,119041.27,1,12.31,14.41,1.03
1435,0,13008208,11142,102.05,119143.32,2,13015439,7231,13008208,11142,102.05,83.03,119143.32,0,11.20,14.41,0.94
1436,0,13034742,26534,243.03,119386.35,2,13034742,0,13034742,26534,243.03,83.14,119386.35,1,11.84,14.41,1.01
1437,0,13067282,32540,298.04,119684.39,2,13067282,0,13067282,32540,298.04,83.29,119684.39,0,10.47,14.41,0.89
1438,0,13100749,33467,306.53,119990.91,2,13100749,0,13100749,33467,306.53,83.44,119990.91,0,10.76,14.41,0.96
1439,0,13100749,0,0.00,119990.91,2,13111315,10566,13100749,0,0.00,83.38,119990.91,1,15.78,14.78,1.03
1440,0,13100749,0,0.00,119990.91,2,13117060,16311,13100749,0,0.00,83.33,119990.91,0,16.49,15.49,0.97
1441,0,13100749,0,0.00,119990.91,2,13121439,20690,13100749,0,0.00,83.27,119990.91,1,16.80,15.80,1.04
1442,0,13100749,0,0.00,119990.91,2,13125127,24378,13100749,0,0.00,83.21,119990.91,0,16.46,15.46,0.93
1443,0,13100749,0,0.00,119990.91,2,13128739,27990,13100749,0,0.00,83.15,119990.91,1,16.61,15.61,1.00
1444,0,13107271,6522,59.74,120050.65,2,13132000,24729,13107271,6522,59.74,83.14,120050.65,1,15.21,15.61,0.92
1445,0,13113637,6366,58.31,120108.96,2,13135183,21546,13113637,6366,58.31,83.12,120108.96,0,14.20,15.61,0.87
1446,0,13119987,6350,58.16,120167.12,2,13138358,18371,13119987,6350,58.16,83.10,120167.12,1,15.10,15.61,0.94
1447,0,13126415,6428,58.87,120225.99,2,13141572,15157,13126415,6428,58.87,83.09,120225.99,0,14.72,15.61,0.84
1448,0,13133281,6866,62.89,120288.88,2,13145005,11724,13133281,6866,62.89,83.07,120288.88,1,14.81,15.61,0.91
1449,0,13148317,15036,137.72,120426.59,2,13152523,4206,13148317,15036,137.72,83.11,120426.59,0,13.51,15.61,0.83
1450,0,13178813,30496,279.32,120705.91,2,13178813,0,13178813,30496,279.32,83.25,120705.91,1,13.64,15.61,0.90
1451,0,13211179,32366,296.44,121002.35,2,13211179,0,13211179,32366,296.44,83.39,121002.35,0,13.16,15.61,0.81
1452,0,13244154,32975,302.02,121304.38,2,13244154,0,13244154,32975,302.02,83.54,121304.38,1,14.78,15.61,0.87
1453,0,13277117,32963,301.91,121606.28,2,13277117,0,13277117,32963,301.91,83.69,121606.28,0,15.16,15.61,0.75
1454,0,13277117,0,0.00,121606.28,2,13287574,10457,13277117,0,0.00,83.64,121606.28,1,17.55,16.55,0.82
1455,0,13299133,22016,201.65,121807.93,2,13299133,0,13299133,22016,201.65,83.72,121807.93,0,16.43,16.55,0.75
1456,0,13299133,0,0.00,121807.93,2,13309991,10858,13299133,0,0.00,83.66,121807.93,1,16.73,15.73,0.82
1457,0,13318917,19784,181.20,121989.13,2,13319883,966,13318917,19784,181.20,83.73,121989.13,0,15.26,15.73,0.71
1458,0,13318917,0,0.00,121989.13,2,13329661,10744,13318917,0,0.00,83.67,121989.13,0,16.75,15.75,0.78
1459,0,13318917,0,0.00,121989.13,2,13335111,16194,13318917,0,0.00,83.61,121989.13,1,17.51,16.51,0.85
1460,0,13328499,9582,87.76,122076.90,2,13339902,11403,13328499,9582,87.76,83.61,122076.90,0,16.37,16.51,0.76
1461,0,13345677,17178,157.33,122234.23,2,13348491,2814,13345677,17178,157.33,83.66,122234.23,1,16.46,16.51,0.83
1462,0,13377142,31465,288.19,122522.42,2,13377142,0,13377142,31465,288.19,83.80,122522.42,0,15.19,16.51,0.75
1463,0,13409352,32210,295.01,122817.44,2,13409352,0,13409352,32210,295.01,83.95,122817.44,1,15.93,16.51,0.82
1464,0,13409352,0,0.00,122817.44,2,13419700,10348,13409352,0,0.00,83.89,122817.44,1,19.23,18.23,0.70
1465,0,13409352,0,0.00,122817.44,2,13425663,16311,13409352,0,0.00,83.83,122817.44,0,18.44,17.44,0.68
1466,0,13409352,0,0.00,122817.44,2,13430343,20991,13409352,0,0.00,83.78,122817.44,1,18.44,17.44,0.75
1467,0,13417798,8446,77.36,122894.80,2,13434566,16768,13417798,8446,77.36,83.77,122894.80,0,17.27,17.44,0.66
1468,0,13426358,8560,78.40,122973.20,2,13438846,12488,13426358,8560,78.40,83.77,122973.20,1,17.34,17.44,0.73
1469,0,13437354,10996,100.71,123073.91,2,13444344,6990,13437354,10996,100.71,83.78,123073.91,0,16.74,17.44,0.66
1470,0,13464526,27172,248.87,123322.78,2,13464526,0,13464526,27172,248.87,83.89,123322.78,1,17.34,17.44,0.72
1471,0,13464526,0,0.00,123322.78,2,13475229,10703,13464526,0,0.00,83.84,123322.78,0,17.96,16.96,0.60
1472,0,13464526,0,0.00,123322.78,2,13480838,16312,13464526,0,0.00,83.78,123322.78,1,18.24,17.24,0.67
1473,0,13464526,0,0.00,123322.78,2,13485188,20662,13464526,0,0.00,83.72,123322.78,0,18.32,17.32,0.57
1474,0,13464526,0,0.00,123322.78,2,13488975,24449,13464526,0,0.00,83.67,123322.78,1,18.61,17.61,0.63
1475,0,13471836,7310,66.95,123389.73,2,13492630,20794,13471836,7310,66.95,83.65,123389.73,0,16.97,17.61,0.53
1476,0,13479344,7508,68.77,123458.50,2,13496384,17040,13479344,7508,68.77,83.64,123458.50,1,17.03,17.61,0.60
1477,0,13486640,7296,66.82,123525.33,2,13500032,13392,13486640,7296,66.82,83.63,123525.33,0,16.50,17.61,0.42
1478,0,13495194,8554,78.35,123603.67,2,13504309,9115,13495194,8554,78.35,83.63,123603.67,1,16.86,17.61,0.49
1479,0,13517640,22446,205.58,123809.26,2,13517640,0,13517640,22446,205.58,83.71,123809.26,0,15.80,17.61,0.44
1480,0,13517640,0,0.00,123809.26,2,13528589,10949,13517640,0,0.00,83.65,123809.26,1,18.01,17.01,0.50
1481,0,13537738,20098,184.08,123993.34,2,13538638,900,13537738,20098,184.08,83.72,123993.34,0,16.82,17.01,0.39
1482,0,13537738,0,0.00,123993.34,2,13548396,10658,13537738,0,0.00,83.67,123993.34,1,18.47,17.47,0.45
1483,0,13558520,20782,190.34,124183.68,2,13558787,267,13558520,20782,190.34,83.74,124183.68,0,16.99,17.47,0.36
1484,0,13590267,31747,290.77,124474.45,2,13590267,0,13590267,31747,290.77,83.88,124474.45,1,17.17,17.47,0.42
1485,0,13590267,0,0.00,124474.45,2,13600886,10619,13590267,0,0.00,83.82,124474.45,0,18.03,17.03,0.35
1486,0,13590267,0,0.00,124474.45,2,13606519,16252,13590267,0,0.00,83.76,124474.45,1,18.03,17.03,0.42
1487,0,13600953,10686,97.87,124572.33,2,13611862,10909,13600953,10686,97.87,83.77,124572.33,0,16.98,17.03,0.31
1488,0,13600953,0,0.00,124572.33,2,13616795,15842,13600953,0,0.00,83.72,124572.33,1,17.16,16.16,0.38
1489,0,13610649,9696,88.81,124661.13,2,13621643,10994,13610649,9696,88.81,83.72,124661.13,0,15.65,16.16,0.28
1490,0,13630493,19844,181.75,124842.88,2,13631565,1072,13630493,19844,181.75,83.79,124842.88,1,15.74,16.16,0.35
1491,0,13630493,0,0.00,124842.88,2,13641065,10572,13630493,0,0.00,83.73,124842.88,0,17.11,16.11,0.25
1492,0,13630493,0,0.00,124842.88,2,13646611,16118,13630493,0,0.00,83.67,124842.88,1,17.57,16.57,0.32
1493,0,13630493,0,0.00,124842.88,2,13649946,19453,13630493,0,0.00,83.62,124842.88,0,17.66,16.66,0.22
1494,0,13630493,0,0.00,124842.88,2,13652745,22252,13630493,0,0.00,83.56,124842.88,1,17.95,16.95,0.28
1495,0,13636259,5766,52.81,124895.70,2,13655628,19369,13636259,5766,52.81,83.54,124895.70,0,16.59,16.95,0.21
1496,0,13643033,6774,62.04,124957.74,2,13659015,15982,13643033,6774,62.04,83.53,124957.74,1,16.75,16.95,0.28
1497,0,13652089,9056,82.94,125040.69,2,13663543,11454,13652089,9056,82.94,83.53,125040.69,0,15.27,16.95,0.16
1498,0,13667475,15386,140.92,125181.61,2,13671236,3761,13667475,15386,140.92,83.57,125181.61,0,15.41,16.95,0.23
1499,0,13698727,31252,286.24,125467.85,2,13698727,0,13698727,31252,286.24,83.70,125467.85,1,15.55,16.95,0.29
1500,0,13730958,32231,295.21,125763.05,2,13730958,0,13730958,32231,295.21,83.84,125763.05,1,16.53,16.95,0.26
1501,0,13762528,31570,289.15,126052.20,2,13762528,0,13762528,31570,289.15,83.98,126052.20,0,15.70,16.95,0.21
1502,0,13795146,32618,298.75,126350.96,2,13795146,0,13795146,32618,298.75,84.12,126350.96,1,15.98,16.95,0.28
1503,0,13795146,0,0.00,126350.96,2,13805622,10476,13795146,0,0.00,84.07,126350.96,1,17.50,16.50,0.20
1504,0,13795146,0,0.00,126350.96,2,13811188,16042,13795146,0,0.00,84.01,126350.96,0,18.08,17.08,0.19
1505,0,13795146,0,0.00,126350.96,2,13815577,20431,13795146,0,0.00,83.95,126350.96,1,18.08,17.08,0.26
1506,0,13803204,8058,73.80,126424.77,2,13819606,16402,13803204,8058,73.80,83.95,126424.77,0,16.58,17.08,0.17
1507,0,13803204,0,0.00,126424.77,2,13823380,20176,13803204,0,0.00,83.89,126424.77,0,17.16,16.16,0.23
1508,0,13803204,0,0.00,126424.77,2,13826396,23192,13803204,0,0.00,83.84,126424.77,1,17.67,16.67,0.30
1509,0,13809000,5796,53.09,126477.85,2,13829294,20294,13809000,5796,53.09,83.82,126477.85,0,15.93,16.67,0.13
1510,0,13815064,6064,55.54,126533.39,2,13832326,17262,13815064,6064,55.54,83.80,126533.39,1,16.37,16.67,0.20
1511,0,13821616,6552,60.01,126593.40,2,13835602,13986,13821616,6552,60.01,83.78,126593.40,0,15.14,16.67,0.11
1512,0,13832202,10586,96.96,126690.36,2,13840895,8693,13832202,10586,96.96,83.79,126690.36,1,15.20,16.67,0.18
1513,0,13855572,23370,214.05,126904.41,2,13855572,0,13855572,23370,214.05,83.88,126904.41,1,13.25,16.67,0.04
1514,0,13888175,32603,298.61,127203.02,2,13888175,0,13888175,32603,298.61,84.02,127203.02,0,14.02,16.67,0.04
1515,0,13920870,32695,299.46,127502.48,2,13920870,0,13920870,32695,299.46,84.16,127502.48,1,14.31,16.67,0.07
1516,0,13952500,31630,289.70,127792.18,2,13952500,0,13952500,31630,289.70,84.30,127792.18,0,15.19,16.67,0.07
1517,0,13984674,32174,294.68,128086.86,2,13984674,0,13984674,32174,294.68,84.43,128086.86,0,15.47,16.67,0.07
1518,0,13984674,0,0.00,128086.86,2,13995200,10526,13984674,0,0.00,84.38,128086.86,1,17.86,16.86,0.13
1519,0,14005024,20350,186.39,128273.25,2,14005375,351,14005024,20350,186.39,84.45,128273.25,0,16.65,16.86,0.06
1520,0,14005024,0,0.00,128273.25,2,14015373,10349,14005024,0,0.00,84.39,128273.25,1,17.73,16.73,0.13
1521,0,14023668,18644,170.76,128444.01,2,14024695,1027,14023668,18644,170.76,84.45,128444.01,0,16.31,16.73,0.13
1522,0,14056210,32542,298.06,128742.06,2,14056210,0,14056210,32542,298.06,84.59,128742.06,1,16.47,16.73,0.07
1523,0,14070575,14365,131.57,128873.63,2,14077224,6649,14070575,14365,131.57,84.62,128873.63,0,17.44,16.44,0.07
1524,0,14070575,0,0.00,128873.63,2,14084328,13753,14070575,0,0.00,84.56,128873.63,1,17.57,16.57,0.07
1525,0,14070575,0,0.00,128873.63,2,14089110,18535,14070575,0,0.00,84.51,128873.63,0,19.87,18.87,0.07
1526,0,14070575,0,0.00,128873.63,2,14093137,22562,14070575,0,0.00,84.45,128873.63,1,19.87,18.87,0.07
1527,0,14077159,6584,60.30,128933.94,2,14096917,19758,14077159,6584,60.30,84.44,128933.94,0,19.07,18.07,0.07
1528,0,14077159,0,0.00,128933.94,2,14100502,23343,14077159,0,0.00,84.38,128933.94,1,19.13,18.13,0.07
1529,0,14077159,0,0.00,128933.94,2,14103661,26502,14077159,0,0.00,84.33,128933.94,0,18.17,17.17,0.07
1530,0,14077159,0,0.00,128933.94,2,14106546,29387,14077159,0,0.00,84.27,128933.94,1,18.17,17.17,0.07
1531,0,14082723,5564,50.96,128984.90,2,14109328,26605,14082723,5564,50.96,84.25,128984.90,0,15.94,17.17,0.07
1532,0,14088105,5382,49.29,129034.20,2,14112019,23914,14088105,5382,49.29,84.23,129034.20,1,15.99,17.17,0.07
1533,0,14093177,5072,46.45,129080.65,2,14114555,21378,14093177,5072,46.45,84.20,129080.65,0,14.62,17.17,0.07
1534,0,14098481,5304,48.58,129129.23,2,14117207,18726,14098481,5304,48.58,84.18,129129.23,1,14.66,17.17,0.07
1535,0,14104347,5866,53.73,129182.96,2,14120140,15793,14104347,5866,53.73,84.16,129182.96,0,13.06,17.17,0.07
1536,0,14110937,6590,60.36,129243.31,2,14123435,12498,14110937,6590,60.36,84.14,129243.31,1,13.11,17.17,0.07
1537,0,14125079,14142,129.53,129372.84,2,14130506,5427,14125079,14142,129.53,84.17,129372.84,0,11.93,17.17,0.07
1538,0,14153042,27963,256.12,129628.96,2,14153042,0,14153042,27963,256.12,84.28,129628.96,0,12.05,17.17,0.07
1539,0,14183397,30355,278.02,129906.98,2,14183397,0,14183397,30355,278.02,84.41,129906.98,1,13.60,17.17,0.13
1540,0,14213851,30454,278.93,130185.91,2,14213851,0,14213851,30454,278.93,84.54,130185.91,0,12.81,17.17,0.03
1541,0,14244657,30806,282.15,130468.07,2,14244657,0,14244657,30806,282.15,84.66,130468.07,1,13.08,17.17,0.10
1542,0,14275444,30787,281.98,130750.05,2,14275444,0,14275444,30787,281.98,84.79,130750.05,0,14.86,17.17,0.10
1543,0,14306511,31067,284.55,131034.59,2,14306511,0,14306511,31067,284.55,84.92,131034.59,1,15.14,17.17,0.06
1544,0,14320306,13795,126.35,131160.94,2,14320306,0,14320306,13795,126.35,84.95,131160.94,1,18.66,18.84,0.06
1545,0,14351123,30817,282.26,131443.20,2,14351123,0,14351123,30817,282.26,85.08,131443.20,0,18.78,18.84,0.06
1546,0,14351123,0,0.00,131443.20,2,14361885,10762,14351123,0,0.00,85.02,131443.20,1,19.46,18.46,0.13
1547,0,14351123,0,0.00,131443.20,2,14367634,16511,14351123,0,0.00,84.97,131443.20,0,18.83,17.83,0.02
1548,0,14351123,0,0.00,131443.20,2,14371561,20438,14351123,0,0.00,84.91,131443.20,1,18.83,17.83,0.09
1549,0,14355472,4349,39.83,131483.03,2,14375431,19959,14355472,4349,39.83,84.88,131483.03,0,18.76,17.76,0.09
1550,0,14355472,0,0.00,131483.03,2,14378890,23418,14355472,0,0.00,84.83,131483.03,1,18.80,17.80,0.06
1551,0,14361954,6482,59.37,131542.41,2,14382131,20177,14361954,6482,59.37,84.81,131542.41,0,16.98,17.80,0.06
1552,0,14368600,6646,60.87,131603.28,2,14385454,16854,14368600,6646,60.87,84.80,131603.28,1,17.04,17.80,0.06
1553,0,14375608,7008,64.19,131667.45,2,14388958,13350,14375608,7008,64.19,84.78,131667.45,0,15.17,17.80,0.06
1554,0,14387082,11474,105.09,131772.55,2,14394695,7613,14387082,11474,105.09,84.80,131772.55,0,15.23,17.80,0.06
1555,0,14411702,24620,225.50,131998.05,2,14411702,0,14411702,24620,225.50,84.89,131998.05,0,15.33,17.80,0.13
1556,0,14442177,30475,279.12,132277.17,2,14442177,0,14442177,30475,279.12,85.01,132277.17,1,16.04,17.80,0.19
1557,0,14472709,30532,279.65,132556.81,2,14472709,0,14472709,30532,279.65,85.14,132556.81,1,13.75,17.80,0.19
1558,0,14503697,30988,283.82,132840.64,2,14503697,0,14503697,30988,283.82,85.26,132840.64,0,14.03,17.80,0.06
1559,0,14534260,30563,279.93,133120.56,2,14534260,0,14534260,30563,279.93,85.39,133120.56,0,16.39,17.80,0.13
1560,0,14534260,0,0.00,133120.56,2,14544388,10128,14534260,0,0.00,85.33,133120.56,0,19.22,18.22,0.19
1561,0,14534260,0,0.00,133120.56,2,14550145,15885,14534260,0,0.00,85.28,133120.56,1,20.64,19.64,0.26
1562,0,14544932,10672,97.75,133218.31,2,14555481,10549,14544932,10672,97.75,85.29,133218.31,0,18.40,19.64,0.05
1563,0,14544932,0,0.00,133218.31,2,14560533,15601,14544932,0,0.00,85.23,133218.31,1,19.80,18.80,0.12
1564,0,14554816,9884,90.53,133308.84,2,14565475,10659,14554816,9884,90.53,85.24,133308.84,1,18.59,18.80,0.05
1565,0,14567995,13179,120.71,133429.55,2,14574428,6433,14567995,13179,120.71,85.26,133429.55,0,19.14,18.14,0.05
1566,0,14567995,0,0.00,133429.55,2,14581838,13843,14567995,0,0.00,85.20,133429.55,1,19.26,18.26,0.06
1567,0,14573661,5666,51.90,133481.45,2,14587388,13727,14573661,5666,51.90,85.18,133481.45,1,18.71,18.76,0.06
1568,0,14573661,0,0.00,133481.45,2,14591714,18053,14573661,0,0.00,85.13,133481.45,0,18.76,17.76,0.06
1569,0,14573661,0,0.00,133481.45,2,14594441,20780,14573661,0,0.00,85.07,133481.45,1,18.76,17.76,0.13
1570,0,14578979,5318,48.71,133530.16,2,14597100,18121,14578979,5318,48.71,85.05,133530.16,1,17.22,17.76,0.04
1571,0,14585939,6960,63.75,133593.91,2,14600580,14641,14585939,6960,63.75,85.04,133593.91,0,16.41,17.76,0.02
1572,0,14597359,11420,104.60,133698.50,2,14606290,8931,14597359,11420,104.60,85.05,133698.50,1,17.62,17.76,0.08
1573,0,14597359,0,0.00,133698.50,2,14612494,15135,14597359,0,0.00,85.00,133698.50,0,17.80,16.80,0.07
1574,0,14597359,0,0.00,133698.50,2,14616313,18954,14597359,0,0.00,84.94,133698.50,1,17.80,16.80,0.13
1575,0,14604731,7372,67.52,133766.02,2,14619999,15268,14604731,7372,67.52,84.93,133766.02,0,16.20,16.80,0.04
1576,0,14615765,11034,101.06,133867.08,2,14625516,9751,14615765,11034,101.06,84.94,133867.08,1,16.27,16.80,0.11
1577,0,14615765,0,0.00,133867.08,2,14630715,14950,14615765,0,0.00,84.89,133867.08,0,17.29,16.29,0.07
1578,0,14615765,0,0.00,133867.08,2,14634767,19002,14615765,0,0.00,84.83,133867.08,0,17.29,16.29,0.13
1579,0,14615765,0,0.00,133867.08,2,14637708,21943,14615765,0,0.00,84.78,133867.08,1,17.29,16.29,0.19
1580,0,14615765,0,0.00,133867.08,2,14640013,24248,14615765,0,0.00,84.73,133867.08,0,16.55,15.55,0.17
1581,0,14615765,0,0.00,133867.08,2,14642043,26278,14615765,0,0.00,84.67,133867.08,1,17.27,16.27,0.23
1582,0,14619811,4046,37.06,133904.14,2,14644066,24255,14619811,4046,37.06,84.64,133904.14,1,15.97,16.27,0.15
1583,0,14624257,4446,40.72,133944.86,2,14646289,22032,14624257,4446,40.72,84.61,133944.86,0,14.86,16.27,0.08
1584,0,14629413,5156,47.22,133992.08,2,14648867,19454,14629413,5156,47.22,84.59,133992.08,1,14.90,16.27,0.15
1585,0,14635727,6314,57.83,134049.91,2,14652024,16297,14635727,6314,57.83,84.57,134049.91,1,14.09,16.27,0.13
1586,0,14644579,8852,81.08,134130.98,2,14656450,11871,14644579,8852,81.08,84.57,134130.98,0,13.01,16.27,0.08
1587,0,14658143,13564,124.23,134255.22,2,14663232,5089,14658143,13564,124.23,84.60,134255.22,0,13.09,16.27,0.14
1588,0,14686280,28137,257.71,134512.94,2,14686280,0,14686280,28137,257.71,84.71,134512.94,1,13.21,16.27,0.21
1589,0,14717348,31068,284.55,134797.48,2,14717348,0,14717348,31068,284.55,84.83,134797.48,0,13.00,16.27,0.14
1590,0,14747834,30486,279.22,135076.72,2,14747834,0,14747834,30486,279.22,84.95,135076.72,1,15.45,16.27,0.20
1591,0,14778231,30397,278.41,135355.12,2,14778231,0,14778231,30397,278.41,85.08,135355.12,0,15.90,16.27,0.10
1592,0,14778231,0,0.00,135355.12,2,14788318,10087,14778231,0,0.00,85.02,135355.12,1,18.05,17.05,0.17
1593,0,14778231,0,0.00,135355.12,2,14794204,15973,14778231,0,0.00,84.97,135355.12,0,18.53,17.53,0.08
1594,0,14778231,0,0.00,135355.12,2,14798621,20390,14778231,0,0.00,84.92,135355.12,1,18.53,17.53,0.14
1595,0,14778932,701,6.42,135361.55,2,14802339,23407,14778932,701,6.42,84.87,135361.55,0,18.29,17.29,0.14
1596,0,14778932,0,0.00,135361.55,2,14805745,26813,14778932,0,0.00,84.81,135361.55,1,18.30,17.30,0.06
1597,0,14785190,6258,57.32,135418.86,2,14808874,23684,14785190,6258,57.32,84.80,135418.86,0,16.89,17.30,0.06
1598,0,14791468,6278,57.50,135476.36,2,14812013,20545,14791468,6278,57.50,84.78,135476.36,0,16.95,17.30,0.06
1599,0,14797608,6140,56.24,135532.59,2,14815083,17475,14797608,6140,56.24,84.76,135532.59,1,17.20,17.30,0.13
1600,0,14803682,6074,55.63,135588.23,2,14818120,14438,14803682,6074,55.63,84.74,135588.23,0,15.79,17.30,0.01
1601,0,14810846,7164,65.62,135653.84,2,14821702,10856,14810846,7164,65.62,84.73,135653.84,1,15.94,17.30,0.07
1602,0,14827986,17140,156.99,135810.83,2,14830272,2286,14827986,17140,156.99,84.78,135810.83,0,14.75,17.30,0.07
1603,0,14858133,30147,276.12,136086.95,2,14858133,0,14858133,30147,276.12,84.90,136086.95,1,14.91,17.30,0.06
1604,0,14888566,30433,278.74,136365.69,2,14888566,0,14888566,30433,278.74,85.02,136365.69,0,15.36,17.30,0.06
1605,0,14918954,30388,278.33,136644.02,2,14918954,0,14918954,30388,278.33,85.14,136644.02,1,15.63,17.30,0.06
1606,0,14949682,30728,281.44,136925.45,2,14949682,0,14949682,30728,281.44,85.26,136925.45,0,16.00,17.30,0.02
1607,0,14979953,30271,277.25,137202.70,2,14979953,0,14979953,30271,277.25,85.38,137202.70,1,16.28,17.30,0.08
1608,0,15010171,30218,276.77,137479.48,2,15010171,0,15010171,30218,276.77,85.50,137479.48,1,16.67,17.30,0.02
1609,0,15027474,17303,158.48,137637.95,2,15032790,5316,15027474,17303,158.48,85.54,137637.95,0,18.06,17.06,0.02
1610,0,15027474,0,0.00,137637.95,2,15040591,13117,15027474,0,0.00,85.49,137637.95,1,18.22,17.22,0.06
1611,0,15041516,14042,128.61,137766.58,2,15047612,6096,15041516,14042,128.61,85.52,137766.58,0,16.97,17.22,0.01
1612,0,15041516,0,0.00,137766.58,2,15055407,13891,15041516,0,0.00,85.46,137766.58,1,19.09,18.09,0.07
1613,0,15056146,14630,134.00,137900.56,2,15062722,6576,15056146,14630,134.00,85.49,137900.56,0,17.74,18.09,0.00
1614,0,15056146,0,0.00,137900.56,2,15070101,13955,15056146,0,0.00,85.44,137900.56,1,19.87,18.87,0.06
1615,0,15064043,7897,72.33,137972.89,2,15076128,12085,15064043,7897,72.33,85.43,137972.89,0,20.21,19.21,0.06
1616,0,15064043,0,0.00,137972.89,2,15081070,17027,15064043,0,0.00,85.38,137972.89,1,20.28,19.28,0.06
1617,0,15064043,0,0.00,137972.89,2,15084369,20326,15064043,0,0.00,85.33,137972.89,0,19.40,18.40,0.01
1618,0,15064043,0,0.00,137972.89,2,15086941,22898,15064043,0,0.00,85.27,137972.89,0,19.40,18.40,0.08
1619,0,15064043,0,0.00,137972.89,2,15089233,25190,15064043,0,0.00,85.22,137972.89,1,19.81,18.81,0.14
1620,0,15068679,4636,42.46,138015.36,2,15091551,22872,15068679,4636,42.46,85.19,138015.36,1,18.56,18.81,0.08
1621,0,15073811,5132,47.00,138062.36,2,15094117,20306,15073811,5132,47.00,85.17,138062.36,0,17.89,18.81,0.03
1622,0,15079915,6104,55.91,138118.27,2,15097169,17254,15079915,6104,55.91,85.15,138118.27,1,18.21,18.81,0.09
1623,0,15087051,7136,65.36,138183.62,2,15100737,13686,15087051,7136,65.36,85.14,138183.62,0,17.21,18.81,0.02
1624,0,15097929,10878,99.63,138283.27,2,15106176,8247,15097929,10878,99.63,85.15,138283.27,1,17.27,18.81,0.08
1625,0,15118862,20933,191.73,138474.98,2,15118862,0,15118862,20933,191.73,85.22,138474.98,0,16.62,18.81,0.05
1626,0,15149436,30574,280.03,138755.02,2,15149436,0,15149436,30574,280.03,85.34,138755.02,1,16.81,18.81,0.11
1627,0,15180352,30916,283.16,139038.19,2,15180352,0,15180352,30916,283.16,85.46,139038.19,0,16.84,18.81,0.03
1628,0,15210431,30079,275.50,139313.67,2,15210431,0,15210431,30079,275.50,85.57,139313.67,1,18.42,18.81,0.09
1629,0,15210431,0,0.00,139313.67,2,15221018,10587,15210431,0,0.00,85.52,139313.67,0,19.83,18.83,0.01
1630,0,15210431,0,0.00,139313.67,2,15226936,16505,15210431,0,0.00,85.47,139313.67,1,20.96,19.96,0.07
1631,0,15216316,5885,53.90,139367.58,2,15231714,15398,15216316,5885,53.90,85.45,139367.58,0,20.01,19.01,0.07
1632,0,15216316,0,0.00,139367.58,2,15235415,19099,15216316,0,0.00,85.40,139367.58,1,20.07,19.07,0.06
1633,0,15217552,1236,11.32,139378.91,2,15238900,21348,15217552,1236,11.32,85.35,139378.91,0,19.49,18.49,0.06
1634,0,15217552,0,0.00,139378.91,2,15242000,24448,15217552,0,0.00,85.30,139378.91,1,19.50,18.50,0.06
1635,0,15223354,5802,53.14,139432.05,2,15244901,21547,15223354,5802,53.14,85.28,139432.05,0,17.30,18.50,0.06
1636,0,15229300,5946,54.46,139486.50,2,15247874,18574,15229300,5946,54.46,85.26,139486.50,1,17.35,18.50,0.06
1637,0,15235682,6382,58.45,139544.95,2,15251065,15383,15235682,6382,58.45,85.24,139544.95,0,17.46,18.50,0.01
1638,0,15243670,7988,73.16,139618.11,2,15255059,11389,15243670,7988,73.16,85.24,139618.11,0,17.73,18.50,0.07
1639,0,15261888,18218,166.86,139784.98,2,15264168,2280,15261888,18218,166.86,85.29,139784.98,1,18.01,18.50,0.13
1640,0,15291811,29923,274.07,140059.05,2,15291811,0,15291811,29923,274.07,85.40,140059.05,0,18.06,18.50,0.03
1641,0,15291811,0,0.00,140059.05,2,15301812,10001,15291811,0,0.00,85.35,140059.05,1,19.96,18.96,0.09
1642,0,15307629,15818,144.88,140203.92,2,15311535,3906,15307629,15818,144.88,85.39,140203.92,0,19.28,18.28,0.09
1643,0,15307629,0,0.00,140203.92,2,15319808,12179,15307629,0,0.00,85.33,140203.92,1,19.42,18.42,0.06
1644,0,15309001,1372,12.57,140216.48,2,15324681,15680,15309001,1372,12.57,85.29,140216.48,1,18.22,18.63,0.06
1645,0,15319475,10474,95.93,140312.42,2,15329918,10443,15319475,10474,95.93,85.30,140312.42,0,18.23,18.63,0.06
1646,0,15319475,0,0.00,140312.42,2,15335310,15835,15319475,0,0.00,85.24,140312.42,1,18.66,17.66,0.12
1647,0,15330993,11518,105.49,140417.92,2,15341069,10076,15330993,11518,105.49,85.26,140417.92,0,17.17,17.66,0.04
1648,0,15351191,20198,185.00,140602.91,2,15351191,0,15351191,20198,185.00,85.32,140602.91,1,17.27,17.66,0.10
1649,0,15381923,30732,281.48,140884.39,2,15381923,0,15381923,30732,281.48,85.44,140884.39,0,16.05,17.66,0.03
1650,0,15412207,30284,277.37,141161.77,2,15412207,0,15412207,30284,277.37,85.55,141161.77,1,17.24,17.66,0.09
1651,0,15442429,30222,276.81,141438.56,2,15442429,0,15442429,30222,276.81,85.67,141438.56,0,17.36,17.66,0.02
1652,0,15442429,0,0.00,141438.56,2,15452702,10273,15442429,0,0.00,85.62,141438.56,1,19.06,18.06,0.08
1653,0,15442429,0,0.00,141438.56,2,15458142,15713,15442429,0,0.00,85.56,141438.56,0,19.59,18.59,0.08
1654,0,15442429,0,0.00,141438.56,2,15462375,19946,15442429,0,0.00,85.51,141438.56,1,19.59,18.59,0.06
1655,0,15442429,0,0.00,141438.56,2,15466168,23739,15442429,0,0.00,85.46,141438.56,0,19.85,18.85,0.06
1656,0,15442429,0,0.00,141438.56,2,15469633,27204,15442429,0,0.00,85.41,141438.56,1,19.85,18.85,0.06
1657,0,15448993,6564,60.12,141498.69,2,15472915,23922,15448993,6564,60.12,85.39,141498.69,0,18.02,18.85,0.06
1658,0,15455239,6246,57.21,141555.89,2,15476038,20799,15455239,6246,57.21,85.38,141555.89,0,18.08,18.85,0.06
1659,0,15455239,0,0.00,141555.89,2,15478857,23618,15455239,0,0.00,85.33,141555.89,1,19.28,18.28,0.12
1660,0,15455239,0,0.00,141555.89,2,15481490,26251,15455239,0,0.00,85.27,141555.89,0,18.61,17.61,0.04
1661,0,15455239,0,0.00,141555.89,2,15483956,28717,15455239,0,0.00,85.22,141555.89,1,18.61,17.61,0.10
1662,0,15459991,4752,43.52,141599.42,2,15486332,26341,15459991,4752,43.52,85.20,141599.42,0,16.88,17.61,0.00
1663,0,15464571,4580,41.95,141641.38,2,15488622,24051,15464571,4580,41.95,85.17,141641.38,1,16.93,17.61,0.06
1664,0,15469085,4514,41.34,141682.72,2,15490879,21794,15469085,4514,41.34,85.15,141682.72,1,14.32,17.61,0.06
1665,0,15473977,4892,44.81,141727.52,2,15493325,19348,15473977,4892,44.81,85.12,141727.52,0,14.36,17.61,0.06
1666,0,15479235,5258,48.16,141775.67,2,15495954,16719,15479235,5258,48.16,85.10,141775.67,1,14.40,17.61,0.12
1667,0,15485457,6222,56.99,141832.67,2,15499065,13608,15485457,6222,56.99,85.08,141832.67,0,13.03,17.61,0.05
1668,0,15498175,12718,116.49,141949.16,2,15505424,7249,15498175,12718,116.49,85.10,141949.16,1,13.89,17.61,0.11
1669,0,15523616,25441,233.02,142182.17,2,15523616,0,15523616,25441,233.02,85.19,142182.17,0,12.57,17.61,0.03
1670,0,15554753,31137,285.19,142467.36,2,15554753,0,15554753,31137,285.19,85.31,142467.36,1,13.16,17.61,0.09
1671,0,15586124,31371,287.33,142754.69,2,15586124,0,15586124,31371,287.33,85.43,142754.69,0,15.28,17.61,0.09
1672,0,15617122,30998,283.91,143038.59,2,15617122,0,15617122,30998,283.91,85.55,143038.59,1,15.56,17.61,0.06
1673,0,15648060,30938,283.36,143321.95,2,15648060,0,15648060,30938,283.36,85.67,143321.95,0,16.07,17.61,0.02
1674,0,15678679,30619,280.44,143602.41,2,15678679,0,15678679,30619,280.44,85.78,143602.41,1,16.76,17.61,0.08
1675,0,15709350,30671,280.92,143883.33,2,15709350,0,15709350,30671,280.92,85.90,143883.33,0,16.76,17.61,0.08
1676,0,15740275,30925,283.24,144166.56,2,15740275,0,15740275,30925,283.24,86.02,144166.56,1,17.03,17.61,0.06
1677,0,15770959,30684,281.04,144447.61,2,15770959,0,15770959,30684,281.04,86.13,144447.61,0,16.76,17.61,0.02
1678,0,15770959,0,0.00,144447.61,2,15781106,10147,15770959,0,0.00,86.08,144447.61,0,19.83,18.83,0.08
1679,0,15770959,0,0.00,144447.61,2,15787071,16112,15770959,0,0.00,86.03,144447.61,1,22.20,19.00,0.14
1680,0,15770959,0,0.00,144447.61,2,15791511,20552,15770959,0,0.00,85.98,144447.61,0,20.62,19.62,0.06
1681,0,15770959,0,0.00,144447.61,2,15795342,24383,15770959,0,0.00,85.93,144447.61,1,20.62,19.62,0.12
1682,0,15777871,6912,63.31,144510.91,2,15798798,20927,15777871,6912,63.31,85.92,144510.91,0,19.21,19.62,0.05
1683,0,15784773,6902,63.22,144574.12,2,15802249,17476,15784773,6902,63.22,85.90,144574.12,1,19.27,19.62,0.11
1684,0,15791951,7178,65.74,144639.88,2,15805838,13887,15791951,7178,65.74,85.89,144639.88,1,18.10,19.62,0.06
1685,0,15800037,8086,74.06,144713.94,2,15809881,9844,15800037,8086,74.06,85.88,144713.94,0,17.14,19.62,0.02
1686,0,15818771,18734,171.59,144885.52,2,15819248,477,15818771,18734,171.59,85.93,144885.52,1,17.62,19.62,0.08
1687,0,15850113,31342,287.06,145172.58,2,15850113,0,15850113,31342,287.06,86.05,145172.58,0,17.75,19.62,0.02
1688,0,15880668,30555,279.86,145452.44,2,15880668,0,15880668,30555,279.86,86.17,145452.44,1,18.49,19.62,0.08
1689,0,15911475,30807,282.16,145734.61,2,15911475,0,15911475,30807,282.16,86.28,145734.61,0,19.39,19.62,0.03
1690,0,15911475,0,0.00,145734.61,2,15921810,10335,15911475,0,0.00,86.23,145734.61,1,21.56,19.00,0.09
1691,0,15911475,0,0.00,145734.61,2,15927578,16103,15911475,0,0.00,86.18,145734.61,0,22.22,19.00,0.03
1692,0,15911475,0,0.00,145734.61,2,15931953,20478,15911475,0,0.00,86.13,145734.61,1,22.40,19.00,0.09
1693,0,15911475,0,0.00,145734.61,2,15935679,24204,15911475,0,0.00,86.08,145734.61,0,20.82,19.82,0.01
1694,0,15911475,0,0.00,145734.61,2,15938759,27284,15911475,0,0.00,86.03,145734.61,1,21.39,19.00,0.07
1695,0,15911475,0,0.00,145734.61,2,15941665,30190,15911475,0,0.00,85.98,145734.61,0,21.40,19.00,0.02
1696,0,15911475,0,0.00,145734.61,2,15944466,32991,15911475,0,0.00,85.93,145734.61,1,21.72,19.00,0.08
1697,0,15911475,0,0.00,145734.61,2,15947164,35689,15911475,0,0.00,85.88,145734.61,0,19.80,18.80,0.08
1698,0,15911475,0,0.00,145734.61,2,15949702,38227,15911475,0,0.00,85.83,145734.61,1,19.80,18.80,0.06
1699,0,15916283,4808,44.04,145778.64,2,15952106,35823,15916283,4808,44.04,85.80,145778.64,0,18.76,18.80,0.02
1700,0,15916283,0,0.00,145778.64,2,15954453,38170,15916283,0,0.00,85.75,145778.64,1,19.92,18.92,0.08
1701,0,15916283,0,0.00,145778.64,2,15956643,40360,15916283,0,0.00,85.70,145778.64,0,18.93,17.93,0.00
1702,0,15916283,0,0.00,145778.64,2,15958716,42433,15916283,0,0.00,85.65,145778.64,1,19.17,18.17,0.06
1703,0,15920303,4020,36.82,145815.45,2,15960726,40423,15920303,4020,36.82,85.62,145815.45,0,17.76,18.17,0.06
1704,0,15924397,4094,37.50,145852.95,2,15962773,38376,15924397,4094,37.50,85.59,145852.95,1,17.80,18.17,0.06
1705,0,15928627,4230,38.74,145891.70,2,15964888,36261,15928627,4230,38.74,85.57,145891.70,0,16.55,18.17,0.00
1706,0,15932805,4178,38.27,145929.97,2,15966977,34172,15932805,4178,38.27,85.54,145929.97,1,16.58,18.17,0.06
1707,0,15936603,3798,34.79,145964.75,2,15968876,32273,15936603,3798,34.79,85.51,145964.75,0,16.86,18.17,0.06
1708,0,15940397,3794,34.75,145999.50,2,15970773,30376,15940397,3794,34.75,85.48,145999.50,1,16.90,18.17,0.06
1709,0,15944195,3798,34.79,146034.28,2,15972672,28477,15944195,3798,34.79,85.45,146034.28,0,15.81,18.17,0.06
1710,0,15948031,3836,35.13,146069.42,2,15974590,26559,15948031,3836,35.13,85.42,146069.42,1,15.84,18.17,0.06
1711,0,15952097,4066,37.24,146106.66,2,15976623,24526,15952097,4066,37.24,85.39,146106.66,0,13.99,18.17,0.06
1712,0,15956467,4370,40.03,146146.69,2,15978808,22341,15956467,4370,40.03,85.37,146146.69,1,14.03,18.17,0.06
1713,0,15961033,4566,41.82,146188.52,2,15981091,20058,15961033,4566,41.82,85.34,146188.52,0,12.87,18.17,0.01
1714,0,15965775,4742,43.43,146231.94,2,15983462,17687,15965775,4742,43.43,85.32,146231.94,1,12.91,18.17,0.07
1715,0,15971077,5302,48.56,146280.50,2,15986113,15036,15971077,5302,48.56,85.29,146280.50,0,12.50,18.17,0.07
1716,0,15979917,8840,80.97,146361.47,2,15990533,10616,15979917,8840,80.97,85.29,146361.47,1,12.55,18.17,0.06
1717,0,15998253,18336,167.94,146529.41,2,15999701,1448,15998253,18336,167.94,85.34,146529.41,0,11.77,18.17,0.02
1718,0,16028496,30243,277.00,146806.41,2,16028496,0,16028496,30243,277.00,85.45,146806.41,0,12.80,18.17,0.07
1719,0,16059269,30773,281.85,147088.27,2,16059269,0,16059269,30773,281.85,85.57,147088.27,1,14.50,18.17,0.13
1720,0,16089848,30579,280.08,147368.33,2,16089848,0,16089848,30579,280.08,85.68,147368.33,0,15.56,18.17,0.04
1721,0,16120348,30500,279.35,147647.69,2,16120348,0,16120348,30500,279.35,85.79,147647.69,1,16.05,18.17,0.10
1722,0,16151283,30935,283.34,147931.03,2,16151283,0,16151283,30935,283.34,85.91,147931.03,0,15.81,18.17,0.02
1723,0,16181868,30585,280.13,148211.16,2,16181868,0,16181868,30585,280.13,86.02,148211.16,1,17.36,18.17,0.08
1724,0,16181868,0,0.00,148211.16,2,16192143,10275,16181868,0,0.00,85.97,148211.16,1,18.83,17.83,0.02
1725,0,16181868,0,0.00,148211.16,2,16197686,15818,16181868,0,0.00,85.92,148211.16,0,20.02,19.02,0.02
1726,0,16181868,0,0.00,148211.16,2,16202071,20203,16181868,0,0.00,85.87,148211.16,1,20.02,19.02,0.06
1727,0,16189928,8060,73.82,148284.98,2,16206101,16173,16189928,8060,73.82,85.86,148284.98,0,18.66,19.02,0.06
1728,0,16198280,8352,76.50,148361.47,2,16210277,11997,16198280,8352,76.50,85.86,148361.47,1,18.73,19.02,0.06
1729,0,16212628,14348,131.41,148492.89,2,16217451,4823,16212628,14348,131.41,85.88,148492.89,0,18.43,19.02,0.01
1730,0,16212628,0,0.00,148492.89,2,16225399,12771,16212628,0,0.00,85.83,148492.89,1,19.71,18.71,0.06
1731,0,16226570,13942,127.70,148620.58,2,16232370,5800,16226570,13942,127.70,85.86,148620.58,0,18.48,18.71,0.01
1732,0,16226570,0,0.00,148620.58,2,16239749,13179,16226570,0,0.00,85.81,148620.58,1,19.24,18.24,0.07
1733,0,16241016,14446,132.31,148752.89,2,16246972,5956,16241016,14446,132.31,85.84,148752.89,0,17.97,18.24,0.01
1734,0,16267073,26057,238.66,148991.56,2,16267073,0,16267073,26057,238.66,85.92,148991.56,1,18.10,18.24,0.07
1735,0,16296911,29838,273.29,149264.84,2,16296911,0,16296911,29838,273.29,86.03,149264.84,0,17.05,18.24,0.01
1736,0,16296911,0,0.00,149264.84,2,16307214,10303,16296911,0,0.00,85.98,149264.84,1,18.58,17.58,0.07
1737,0,16300098,3187,29.19,149294.03,2,16314333,14235,16300098,3187,29.19,85.95,149294.03,0,18.86,17.86,0.07
1738,0,16300098,0,0.00,149294.03,2,16318717,18619,16300098,0,0.00,85.90,149294.03,1,18.89,17.89,0.06
1739,0,16307382,7284,66.71,149360.75,2,16322359,14977,16307382,7284,66.71,85.89,149360.75,0,17.72,17.89,0.01
1740,0,16317748,10366,94.94,149455.69,2,16327542,9794,16317748,10366,94.94,85.89,149455.69,1,17.78,17.89,0.07
1741,0,16317748,0,0.00,149455.69,2,16333093,15345,16317748,0,0.00,85.84,149455.69,0,18.29,17.29,0.07
1742,0,16317748,0,0.00,149455.69,2,16336533,18785,16317748,0,0.00,85.80,149455.69,1,18.29,17.29,0.06
1743,0,16324942,7194,65.89,149521.58,2,16340130,15188,16324942,7194,65.89,85.78,149521.58,0,17.26,17.29,0.06
1744,0,16324942,0,0.00,149521.58,2,16344072,19130,16324942,0,0.00,85.73,149521.58,1,17.32,16.32,0.06
1745,0,16324942,0,0.00,149521.58,2,16346846,21904,16324942,0,0.00,85.69,149521.58,0,17.57,16.57,0.06
1746,0,16324942,0,0.00,149521.58,2,16349211,24269,16324942,0,0.00,85.64,149521.58,1,17.57,16.57,0.06
1747,0,16329626,4684,42.90,149564.48,2,16351553,21927,16329626,4684,42.90,85.61,149564.48,0,15.85,16.57,0.06
1748,0,16334622,4996,45.76,149610.25,2,16354051,19429,16334622,4996,45.76,85.59,149610.25,1,15.89,16.57,0.06
1749,0,16340594,5972,54.70,149664.94,2,16357037,16443,16340594,5972,54.70,85.57,149664.94,0,14.65,16.57,0.00
1750,0,16349874,9280,85.00,149749.94,2,16361677,11803,16349874,9280,85.00,85.57,149749.94,1,15.56,16.57,0.06
1751,0,16366586,16712,153.07,149903.00,2,16370033,3447,16366586,16712,153.07,85.61,149903.00,0,15.00,16.57,0.06
1752,0,16396623,30037,275.11,150178.11,2,16396623,0,16396623,30037,275.11,85.72,150178.11,1,15.15,16.57,0.06
1753,0,16404135,7512,68.80,150246.92,2,16412392,8257,16404135,7512,68.80,85.71,150246.92,0,17.94,16.94,0.06
1754,0,16404135,0,0.00,150246.92,2,16418641,14506,16404135,0,0.00,85.66,150246.92,1,18.00,17.00,0.06
1755,0,16408329,4194,38.41,150285.33,2,16423813,15484,16408329,4194,38.41,85.63,150285.33,0,18.02,17.02,0.06
1756,0,16408329,0,0.00,150285.33,2,16427991,19662,16408329,0,0.00,85.58,150285.33,1,18.06,17.06,0.06
1757,0,16415791,7462,68.35,150353.67,2,16431722,15931,16415791,7462,68.35,85.57,150353.67,0,16.93,17.06,0.00
1758,0,16415791,0,0.00,150353.67,2,16435240,19449,16415791,0,0.00,85.53,150353.67,0,17.13,16.13,0.06
1759,0,16415791,0,0.00,150353.67,2,16438288,22497,16415791,0,0.00,85.48,150353.67,0,17.13,16.13,0.11
1760,0,16415791,0,0.00,150353.67,2,16441085,25294,16415791,0,0.00,85.43,150353.67,1,17.13,16.13,0.17
1761,0,16421251,5460,50.01,150403.69,2,16443815,22564,16421251,5460,50.01,85.41,150403.69,1,15.31,16.13,0.07
1762,0,16427003,5752,52.68,150456.38,2,16446691,19688,16427003,5752,52.68,85.39,150456.38,0,13.81,16.13,0.07
1763,0,16432769,5766,52.81,150509.17,2,16449574,16805,16432769,5766,52.81,85.37,150509.17,1,13.86,16.13,0.06
1764,0,16439465,6696,61.33,150570.52,2,16452922,13457,16439465,6696,61.33,85.36,150570.52,0,12.71,16.13,0.01
1765,0,16452509,13044,119.47,150689.98,2,16459444,6935,16452509,13044,119.47,85.38,150689.98,1,12.77,16.13,0.07
1766,0,16479591,27082,248.05,150938.03,2,16479591,0,16479591,27082,248.05,85.47,150938.03,1,13.49,16.13,0.05
1767,0,16510590,30999,283.92,151221.95,2,16510590,0,16510590,30999,283.92,85.58,151221.95,0,14.11,16.13,0.03
1768,0,16541624,31034,284.24,151506.19,2,16541624,0,16541624,31034,284.24,85.69,151506.19,1,14.38,16.13,0.09
1769,0,16572485,30861,282.66,151788.84,2,16572485,0,16572485,30861,282.66,85.80,151788.84,0,15.63,16.13,0.05
1770,0,16572485,0,0.00,151788.84,2,16582581,10096,16572485,0,0.00,85.76,151788.84,1,17.58,16.58,0.11
1771,0,16572485,0,0.00,151788.84,2,16588260,15775,16572485,0,0.00,85.71,151788.84,0,17.76,16.76,0.08
1772,0,16572485,0,0.00,151788.84,2,16592709,20224,16572485,0,0.00,85.66,151788.84,1,18.50,17.50,0.13
1773,0,16580665,8180,74.92,151863.77,2,16596799,16134,16580665,8180,74.92,85.65,151863.77,0,17.25,17.50,0.07
1774,0,16589155,8490,77.76,151941.53,2,16601044,11889,16589155,8490,77.76,85.65,151941.53,1,17.32,17.50,0.13
1775,0,16603569,14414,132.02,152073.55,2,16608251,4682,16603569,14414,132.02,85.68,152073.55,0,16.45,17.50,0.10
1776,0,16631710,28141,257.75,152331.30,2,16631710,0,16631710,28141,257.75,85.77,152331.30,1,16.92,17.50,0.16
1777,0,16662017,30307,277.58,152608.88,2,16662017,0,16662017,30307,277.58,85.88,152608.88,0,16.39,17.50,0.07
1778,0,16692400,30383,278.28,152887.16,2,16692400,0,16692400,30383,278.28,85.99,152887.16,0,17.27,17.50,0.13
1779,0,16692400,0,0.00,152887.16,2,16702647,10247,16692400,0,0.00,85.94,152887.16,1,17.54,16.54,0.18
1780,0,16692400,0,0.00,152887.16,2,16708056,15656,16692400,0,0.00,85.89,152887.16,0,19.87,18.87,0.16
1781,0,16692400,0,0.00,152887.16,2,16712242,19842,16692400,0,0.00,85.84,152887.16,1,20.22,19.22,0.22
1782,0,16700564,8164,74.77,152961.94,2,16716324,15760,16700564,8164,74.77,85.84,152961.94,0,18.83,19.22,0.14
1783,0,16709104,8540,78.22,153040.16,2,16720594,11490,16709104,8540,78.22,85.83,153040.16,1,18.91,19.22,0.20
1784,0,16724980,15876,145.41,153185.56,2,16728532,3552,16724980,15876,145.41,85.87,153185.56,1,17.42,19.22,0.12
1785,0,16754354,29374,269.04,153454.61,2,16754354,0,16754354,29374,269.04,85.97,153454.61,0,16.75,19.22,0.11
1786,0,16784913,30559,279.88,153734.48,2,16784913,0,16784913,30559,279.89,86.08,153734.48,1,18.50,19.22,0.16
1787,0,16815156,30243,277.01,154011.50,2,16815156,0,16815156,30243,277.00,86.18,154011.50,0,17.28,19.22,0.09
1788,0,16815156,0,0.00,154011.50,2,16825972,10816,16815156,0,0.00,86.14,154011.50,1,19.56,18.56,0.15
1789,0,16815156,0,0.00,154011.50,2,16831723,16567,16815156,0,0.00,86.09,154011.50,0,20.34,19.34,0.10
1790,0,16815156,0,0.00,154011.50,2,16835640,20484,16815156,0,0.00,86.04,154011.50,1,20.34,19.34,0.16
1791,0,16815156,0,0.00,154011.50,2,16839245,24089,16815156,0,0.00,85.99,154011.50,0,19.95,18.95,0.11
1792,0,16815156,0,0.00,154011.50,2,16842686,27530,16815156,0,0.00,85.94,154011.50,1,21.09,19.00,0.16
1793,0,16815156,0,0.00,154011.50,2,16845819,30663,16815156,0,0.00,85.90,154011.50,0,19.44,18.44,0.08
1794,0,16815156,0,0.00,154011.50,2,16848685,33529,16815156,0,0.00,85.85,154011.50,1,19.44,18.44,0.13
1795,0,16820596,5440,49.83,154061.33,2,16851405,30809,16820596,5440,49.83,85.83,154061.33,0,18.29,18.44,0.09
1796,0,16820596,0,0.00,154061.33,2,16854031,33435,16820596,0,0.00,85.78,154061.33,1,18.92,17.92,0.15
1797,0,16820596,0,0.00,154061.33,2,16856456,35860,16820596,0,0.00,85.73,154061.33,0,18.08,17.08,0.03
1798,0,16820596,0,0.00,154061.33,2,16858770,38174,16820596,0,0.00,85.68,154061.33,0,18.39,17.39,0.09
1799,0,16820596,0,0.00,154061.33,2,16861004,40408,16820596,0,0.00,85.64,154061.33,1,18.39,17.39,0.14
1800,0,16824962,4366,39.99,154101.31,2,16863187,38225,16824962,4366,39.99,85.61,154101.31,0,17.31,17.39,0.11
1801,0,16829026,4064,37.22,154138.53,2,16865219,36193,16829026,4064,37.22,85.58,154138.53,1,17.35,17.39,0.17
1802,0,16833068,4042,37.02,154175.55,2,16867240,34172,16833068,4042,37.02,85.56,154175.55,1,15.87,17.39,0.09
1803,0,16837230,4162,38.12,154213.67,2,16869321,32091,16837230,4162,38.12,85.53,154213.67,0,15.44,17.39,0.06
1804,0,16841582,4352,39.86,154253.53,2,16871497,29915,16841582,4352,39.86,85.51,154253.53,1,16.61,17.39,0.12
1805,0,16845966,4384,40.15,154293.69,2,16873689,27723,16845966,4384,40.15,85.48,154293.69,0,16.40,17.39,0.13
1806,0,16850350,4384,40.15,154333.84,2,16875881,25531,16850350,4384,40.15,85.46,154333.84,1,16.44,17.39,0.19
1807,0,16854780,4430,40.57,154374.42,2,16878096,23316,16854780,4430,40.57,85.43,154374.42,1,14.75,17.39,0.10
1808,0,16859372,4592,42.06,154416.47,2,16880392,21020,16859372,4592,42.06,85.41,154416.47,0,14.09,17.39,0.09
1809,0,16863896,4524,41.44,154457.91,2,16882654,18758,16863896,4524,41.44,85.38,154457.91,1,14.16,17.39,0.15
1810,0,16868706,4810,44.06,154501.97,2,16885059,16353,16868706,4810,44.06,85.36,154501.97,0,13.05,17.39,0.10
1811,0,16874688,5982,54.79,154556.75,2,16888050,13362,16874688,5982,54.79,85.34,154556.75,1,13.11,17.39,0.16
1812,0,16887682,12994,119.01,154675.77,2,16894547,6865,16887682,12994,119.01,85.36,154675.77,0,12.05,17.39,0.12
1813,0,16912794,25112,230.00,154905.77,2,16912794,0,16912794,25112,230.00,85.44,154905.77,0,12.40,17.39,0.17
1814,0,16942909,30115,275.82,155181.59,2,16942909,0,16942909,30115,275.83,85.55,155181.59,1,13.22,17.39,0.23
1815,0,16973382,30473,279.11,155460.70,2,16973382,0,16973382,30473,279.10,85.65,155460.70,0,13.52,17.39,0.15
1816,0,17004199,30817,282.26,155742.97,2,17004199,0,17004199,30817,282.26,85.76,155742.97,1,17.12,17.39,0.20
1817,0,17035018,30819,282.26,156025.23,2,17035018,0,17035018,30819,282.27,85.87,156025.23,0,15.19,17.39,0.07
1818,0,17065657,30639,280.62,156305.84,2,17065657,0,17065657,30639,280.63,85.98,156305.84,0,15.92,17.39,0.12
1819,0,17065657,0,0.00,156305.84,2,17076328,10671,17065657,0,0.00,85.93,156305.84,1,17.62,16.62,0.18
1820,0,17065657,0,0.00,156305.84,2,17082409,16752,17065657,0,0.00,85.88,156305.84,0,17.98,16.98,0.08
1821,0,17065657,0,0.00,156305.84,2,17086910,21253,17065657,0,0.00,85.84,156305.84,1,17.98,16.98,0.14
1822,0,17065657,0,0.00,156305.84,2,17090373,24716,17065657,0,0.00,85.79,156305.84,0,17.29,16.29,0.01
1823,0,17065657,0,0.00,156305.84,2,17093552,27895,17065657,0,0.00,85.74,156305.84,0,17.87,16.87,0.07
1824,0,17065657,0,0.00,156305.84,2,17096613,30956,17065657,0,0.00,85.69,156305.84,1,17.87,16.87,0.12
1825,0,17071445,5788,53.01,156358.86,2,17099507,28062,17071445,5788,53.01,85.68,156358.86,1,14.35,16.87,0.12
1826,0,17077227,5782,52.98,156411.84,2,17102398,25171,17077227,5782,52.96,85.66,156411.84,0,14.40,16.87,0.05
1827,0,17083061,5834,53.42,156465.25,2,17105315,22254,17083061,5834,53.43,85.64,156465.25,1,15.60,16.87,0.11
1828,0,17088979,5918,54.22,156519.47,2,17108274,19295,17088979,5918,54.20,85.62,156519.47,1,15.08,16.87,0.05
1829,0,17094919,5940,54.40,156573.88,2,17111244,16325,17094919,5940,54.40,85.61,156573.88,0,13.48,16.87,0.05
1830,0,17101171,6252,57.26,156631.14,2,17114370,13199,17101171,6252,57.26,85.59,156631.14,1,13.54,16.87,0.05
1831,0,17112205,11034,101.04,156732.19,2,17119887,7682,17112205,11034,101.06,85.60,156732.19,0,12.20,16.87,0.05
1832,0,17135708,23503,215.28,156947.45,2,17135708,0,17135708,23503,215.27,85.67,156947.45,1,12.30,16.87,0.05
1833,0,17166073,30365,278.11,157225.56,2,17166073,0,17166073,30365,278.12,85.77,157225.56,0,11.19,16.87,0.05
1834,0,17197355,31282,286.53,157512.09,2,17197355,0,17197355,31282,286.51,85.88,157512.09,1,11.46,16.87,0.05
1835,0,17228243,30888,282.91,157795.00,2,17228243,0,17228243,30888,282.91,85.99,157795.00,1,11.16,16.87,0.05
1836,0,17259230,30987,283.80,158078.81,2,17259230,0,17259230,30987,283.81,86.10,158078.81,0,11.43,16.87,0.05
1837,0,17290192,30962,283.58,158362.39,2,17290192,0,17290192,30962,283.58,86.21,158362.39,0,13.42,16.87,0.11
1838,0,17321124,30932,283.31,158645.70,2,17321124,0,17321124,30932,283.31,86.31,158645.70,0,15.42,16.87,0.16
1839,0,17321124,0,0.00,158645.70,2,17331292,10168,17321124,0,0.00,86.27,158645.70,1,17.41,16.41,0.22
1840,0,17342158,21034,192.65,158838.36,2,17342158,0,17342158,21034,192.65,86.33,158838.36,0,16.26,16.41,0.06
1841,0,17342158,0,0.00,158838.36,2,17352084,9926,17342158,0,0.00,86.28,158838.36,1,18.45,17.45,0.11
1842,0,17362984,20826,190.75,159029.09,2,17362984,0,17362984,20826,190.75,86.34,159029.09,0,16.90,17.45,0.04
1843,0,17362984,0,0.00,159029.09,2,17373711,10727,17362984,0,0.00,86.29,159029.09,1,19.09,18.09,0.10
1844,0,17362984,0,0.00,159029.09,2,17378987,16003,17362984,0,0.00,86.24,159029.09,0,19.18,18.18,0.10
1845,0,17362984,0,0.00,159029.09,2,17383008,20024,17362984,0,0.00,86.19,159029.09,1,19.18,18.18,0.05
1846,0,17370914,7930,72.63,159101.73,2,17386973,16059,17370914,7930,72.63,86.19,159101.73,1,16.18,18.18,0.05
1847,0,17379030,8116,74.34,159176.06,2,17391031,12001,17379030,8116,74.34,86.18,159176.06,0,16.25,18.18,0.05
1848,0,17393490,14460,132.44,159308.52,2,17398261,4771,17393490,14460,132.44,86.21,159308.52,1,16.45,18.18,0.11
1849,0,17422273,28783,263.62,159572.12,2,17422273,0,17422273,28783,263.63,86.30,159572.12,1,15.77,18.18,0.03
1850,0,17452713,30440,278.80,159850.92,2,17452713,0,17452713,30440,278.80,86.41,159850.92,0,14.82,18.18,0.03
1851,0,17483391,30678,281.00,160131.92,2,17483391,0,17483391,30678,280.98,86.51,160131.92,0,15.09,18.18,0.05
1852,0,17483391,0,0.00,160131.92,2,17493534,10143,17483391,0,0.00,86.46,160131.92,1,18.38,17.38,0.11
1853,0,17483391,0,0.00,160131.92,2,17499019,15628,17483391,0,0.00,86.42,160131.92,0,18.70,17.70,0.02
1854,0,17483391,0,0.00,160131.92,2,17503089,19698,17483391,0,0.00,86.37,160131.92,1,18.70,17.70,0.07
1855,0,17488164,4773,43.71,160175.64,2,17506714,18550,17488164,4773,43.72,86.35,160175.64,0,18.37,17.37,0.07
1856,0,17488164,0,0.00,160175.64,2,17510120,21956,17488164,0,0.00,86.30,160175.64,1,18.42,17.42,0.05
1857,0,17494710,6546,59.96,160235.59,2,17513393,18683,17494710,6546,59.96,86.29,160235.59,0,17.17,17.42,0.05
1858,0,17501414,6704,61.40,160297.00,2,17516745,15331,17501414,6704,61.40,86.27,160297.00,1,17.23,17.42,0.05
1859,0,17508974,7560,69.24,160366.23,2,17520525,11551,17508974,7560,69.24,86.26,160366.23,0,16.10,17.42,0.05
1860,0,17524782,15808,144.79,160511.02,2,17528429,3647,17524782,15808,144.79,86.30,160511.02,1,16.17,17.42,0.05
1861,0,17545976,21194,194.12,160705.14,2,17548793,2817,17545976,21194,194.12,86.35,160705.14,1,16.75,17.18,0.05
1862,0,17575008,29032,265.91,160971.05,2,17575008,0,17575008,29032,265.91,86.45,160971.05,0,16.94,17.18,0.05
1863,0,17575008,0,0.00,160971.05,2,17585290,10282,17575008,0,0.00,86.40,160971.05,0,19.23,18.23,0.11
1864,0,17575008,0,0.00,160971.05,2,17591260,16252,17575008,0,0.00,86.36,160971.05,1,19.23,18.23,0.16
1865,0,17575008,0,0.00,160971.05,2,17595748,20740,17575008,0,0.00,86.31,160971.05,0,19.18,18.18,0.05
1866,0,17575008,0,0.00,160971.05,2,17599543,24535,17575008,0,0.00,86.27,160971.05,1,19.18,18.18,0.10
1867,0,17581590,6582,60.29,161031.33,2,17602834,21244,17581590,6582,60.29,86.25,161031.33,0,17.37,18.18,0.01
1868,0,17588510,6920,63.38,161094.72,2,17606294,17784,17588510,6920,63.38,86.24,161094.72,1,17.67,18.18,0.06
1869,0,17595648,7138,65.38,161160.09,2,17609863,14215,17595648,7138,65.38,86.23,161160.09,1,14.96,18.18,0.06
1870,0,17603724,8076,73.97,161234.06,2,17613901,10177,17603724,8076,73.97,86.22,161234.06,0,15.02,18.18,0.05
1871,0,17623446,19722,180.64,161414.69,2,17623762,316,17623446,19722,180.64,86.27,161414.69,0,15.58,18.18,0.11
1872,0,17654062,30616,280.41,161695.11,2,17654062,0,17654062,30616,280.41,86.38,161695.11,0,16.45,18.18,0.16
1873,0,17684411,30349,277.98,161973.09,2,17684411,0,17684411,30349,277.97,86.48,161973.09,1,16.86,18.18,0.21
1874,0,17714774,30363,278.09,162251.17,2,17714774,0,17714774,30363,278.10,86.58,162251.17,0,15.83,18.18,0.06
1875,0,17745474,30700,281.18,162532.36,2,17745474,0,17745474,30700,281.18,86.68,162532.36,1,17.09,18.18,0.11
1876,0,17776004,30530,279.63,162811.98,2,17776004,0,17776004,30530,279.63,86.79,162811.98,0,16.55,18.18,0.07
1877,0,17776004,0,0.00,162811.98,2,17786275,10271,17776004,0,0.00,86.74,162811.98,1,20.05,19.05,0.13
1878,0,17776004,0,0.00,162811.98,2,17791830,15826,17776004,0,0.00,86.69,162811.98,0,20.44,19.44,0.08
1879,0,17776004,0,0.00,162811.98,2,17796043,20039,17776004,0,0.00,86.65,162811.98,1,20.72,19.72,0.13
1880,0,17784532,8528,78.11,162890.09,2,17800307,15775,17784532,8528,78.11,86.64,162890.09,0,19.68,19.72,0.10
1881,0,17784532,0,0.00,162890.09,2,17804310,19778,17784532,0,0.00,86.60,162890.09,1,20.04,19.04,0.15
1882,0,17784532,0,0.00,162890.09,2,17807637,23105,17784532,0,0.00,86.55,162890.09,0,19.38,18.38,0.10
1883,0,17784532,0,0.00,162890.09,2,17810581,26049,17784532,0,0.00,86.51,162890.09,1,19.53,18.53,0.16
1884,0,17790120,5588,51.18,162941.28,2,17813375,23255,17790120,5588,51.18,86.49,162941.28,1,18.20,18.53,0.11
1885,0,17795602,5482,50.21,162991.48,2,17816116,20514,17795602,5482,50.21,86.47,162991.48,0,17.36,18.53,0.09
1886,0,17801232,5630,51.57,163043.05,2,17818931,17699,17801232,5630,51.57,86.45,163043.05,1,17.41,18.53,0.14
1887,0,17807384,6152,56.35,163099.41,2,17822007,14623,17807384,6152,56.35,86.43,163099.41,0,16.08,18.53,0.08
1888,0,17815280,7896,72.32,163171.72,2,17825955,10675,17815280,7896,72.32,86.43,163171.72,1,16.13,18.53,0.14
1889,0,17832614,17334,158.76,163330.48,2,17834622,2008,17832614,17334,158.76,86.46,163330.48,1,14.68,18.53,0.07
1890,0,17863750,31136,285.18,163615.66,2,17863750,0,17863750,31136,285.18,86.57,163615.66,0,14.17,18.53,0.02
1891,0,17894521,30771,281.83,163897.48,2,17894521,0,17894521,30771,281.83,86.67,163897.48,0,16.89,18.53,0.08
1892,0,17894521,0,0.00,163897.48,2,17905000,10479,17894521,0,0.00,86.63,163897.48,1,19.16,18.16,0.13
1893,0,17915583,21062,192.93,164090.41,2,17915583,0,17915583,21062,192.91,86.68,164090.41,0,17.31,18.16,0.02
1894,0,17946518,30935,283.33,164373.73,2,17946518,0,17946518,30935,283.34,86.79,164373.73,1,18.03,18.16,0.07
1895,0,17946518,0,0.00,164373.73,2,17956821,10303,17946518,0,0.00,86.74,164373.73,0,18.24,17.24,0.03
1896,0,17946518,0,0.00,164373.73,2,17962600,16082,17946518,0,0.00,86.70,164373.73,1,18.72,17.72,0.08
1897,0,17956978,10460,95.80,164469.55,2,17967830,10852,17956978,10460,95.80,86.70,164469.55,0,17.21,17.72,0.08
1898,0,17976534,19556,179.12,164648.66,2,17977608,1074,17976534,19556,179.12,86.75,164648.66,1,17.31,17.72,0.05
1899,0,18007266,30732,281.48,164930.14,2,18007266,0,18007266,30732,281.48,86.85,164930.14,0,17.40,17.72,0.02
1900,0,18007266,0,0.00,164930.14,2,18017809,10543,18007266,0,0.00,86.81,164930.14,1,18.27,17.27,0.07
1901,0,18016208,8942,81.90,165012.03,2,18026561,10353,18016208,8942,81.90,86.80,165012.03,0,21.99,19.00,0.07
1902,0,18016208,0,0.00,165012.03,2,18032202,15994,18016208,0,0.00,86.76,165012.03,1,22.07,19.00,0.05
1903,0,18016208,0,0.00,165012.03,2,18035814,19606,18016208,0,0.00,86.71,165012.03,0,20.62,19.62,0.05
1904,0,18016208,0,0.00,165012.03,2,18038955,22747,18016208,0,0.00,86.67,165012.03,1,20.62,19.62,0.05
1905,0,18016720,512,4.69,165016.72,2,18041808,25088,18016720,512,4.69,86.62,165016.72,1,19.35,19.53,0.05
1906,0,18022260,5540,50.74,165067.47,2,18044578,22318,18022260,5540,50.74,86.60,165067.47,0,19.35,19.53,0.05
1907,0,18022260,0,0.00,165067.47,2,18047203,24943,18022260,0,0.00,86.56,165067.47,1,19.87,18.87,0.10
1908,0,18027140,4880,44.70,165112.17,2,18049643,22503,18027140,4880,44.70,86.54,165112.17,0,18.15,18.87,0.02
1909,0,18032298,5158,47.24,165159.41,2,18052222,19924,18032298,5158,47.24,86.52,165159.41,0,18.49,18.87,0.07
1910,0,18032298,0,0.00,165159.41,2,18054848,22550,18032298,0,0.00,86.47,165159.41,1,18.91,17.91,0.13
1911,0,18037314,5016,45.94,165205.34,2,18057356,20042,18037314,5016,45.94,86.45,165205.34,0,17.04,17.91,0.03
1912,0,18042496,5182,47.46,165252.81,2,18059947,17451,18042496,5182,47.46,86.43,165252.81,1,17.28,17.91,0.08
1913,0,18048552,6056,55.47,165308.28,2,18062975,14423,18048552,6056,55.47,86.41,165308.28,0,14.96,17.91,0.08
1914,0,18058744,10192,93.35,165401.62,2,18068071,9327,18058744,10192,93.35,86.42,165401.62,1,15.02,17.91,0.05
1915,0,18080112,21368,195.71,165597.34,2,18080112,0,18080112,21368,195.71,86.47,165597.34,0,13.75,17.91,0.05
1916,0,18110470,30358,278.05,165875.39,2,18110470,0,18110470,30358,278.05,86.57,165875.39,1,13.94,17.91,0.05
1917,0,18140476,30006,274.83,166150.22,2,18140476,0,18140476,30006,274.83,86.67,166150.22,0,15.16,17.91,0.05
1918,0,18170066,29590,271.02,166421.23,2,18170066,0,18170066,29590,271.02,86.77,166421.23,0,15.43,17.91,0.05
1919,0,18170066,0,0.00,166421.23,2,18180240,10174,18170066,0,0.00,86.72,166421.23,1,18.04,17.04,0.10
1920,0,18170066,0,0.00,166421.23,2,18185952,15886,18170066,0,0.00,86.68,166421.23,0,17.35,16.35,0.01
1921,0,18170066,0,0.00,166421.23,2,18190135,20069,18170066,0,0.00,86.63,166421.23,1,18.21,17.21,0.06
1922,0,18177820,7754,71.02,166492.25,2,18194012,16192,18177820,7754,71.02,86.62,166492.25,0,16.72,17.21,0.00
1923,0,18186044,8224,75.32,166567.58,2,18198124,12080,18186044,8224,75.32,86.62,166567.58,1,16.89,17.21,0.05
1924,0,18199034,12990,118.98,166686.56,2,18204619,5585,18199034,12990,118.98,86.64,166686.56,0,15.84,17.21,0.05
1925,0,18225652,26618,243.80,166930.36,2,18225652,0,18225652,26618,243.80,86.72,166930.36,1,15.95,17.21,0.05
1926,0,18255043,29391,269.20,167199.56,2,18255043,0,18255043,29391,269.19,86.81,167199.56,1,14.23,17.21,0.05
1927,0,18285130,30087,275.56,167475.12,2,18285130,0,18285130,30087,275.57,86.91,167475.12,0,14.49,17.21,0.05
1928,0,18285130,0,0.00,167475.12,2,18295756,10626,18285130,0,0.00,86.86,167475.12,1,17.42,16.42,0.10
1929,0,18285130,0,0.00,167475.12,2,18301816,16686,18285130,0,0.00,86.82,167475.12,0,17.22,16.22,0.03
1930,0,18285130,0,0.00,167475.12,2,18305949,20819,18285130,0,0.00,86.77,167475.12,1,17.67,16.67,0.08
1931,0,18292510,7380,67.59,167542.72,2,18309639,17129,18292510,7380,67.59,86.76,167542.72,0,16.21,16.67,0.01
1932,0,18300624,8114,74.32,167617.03,2,18313696,13072,18300624,8114,74.32,86.76,167617.03,1,16.28,16.67,0.06
1933,0,18311718,11094,101.61,167718.64,2,18319243,7525,18311718,11094,101.61,86.77,167718.64,0,15.73,16.67,0.06
1934,0,18337371,25653,234.97,167953.61,2,18337371,0,18337371,25653,234.96,86.84,167953.61,1,15.83,16.67,0.05
1935,0,18367543,30172,276.35,168229.95,2,18367543,0,18367543,30172,276.35,86.94,168229.95,0,15.31,16.67,0.05
1936,0,18397188,29645,271.51,168501.47,2,18397188,0,18397188,29645,271.52,87.04,168501.47,1,15.58,16.67,0.05
1937,0,18427389,30201,276.60,168778.08,2,18427389,0,18427389,30201,276.61,87.13,168778.08,0,15.69,16.67,0.05
1938,0,18457323,29934,274.19,169052.25,2,18457323,0,18457323,29934,274.17,87.23,169052.25,0,15.96,16.67,0.05
1939,0,18487591,30268,277.23,169329.48,2,18487591,0,18487591,30268,277.23,87.33,169329.48,1,16.23,16.67,0.10
1940,0,18487591,0,0.00,169329.48,2,18498006,10415,18487591,0,0.00,87.28,169329.48,1,18.10,17.10,0.02
1941,0,18487591,0,0.00,169329.48,2,18503679,16088,18487591,0,0.00,87.24,169329.48,0,18.89,17.89,0.02
1942,0,18487591,0,0.00,169329.48,2,18508147,20556,18487591,0,0.00,87.19,169329.48,1,18.89,17.89,0.05
1943,0,18495527,7936,72.69,169402.17,2,18512115,16588,18495527,7936,72.69,87.19,169402.17,0,17.35,17.89,0.05
1944,0,18503883,8356,76.53,169478.70,2,18516293,12410,18503883,8356,76.53,87.18,169478.70,1,17.42,17.89,0.05
1945,0,18517149,13266,121.49,169600.19,2,18522926,5777,18517149,13266,121.50,87.20,169600.19,0,16.86,17.89,0.05
1946,0,18543527,26378,241.62,169841.81,2,18543527,0,18543527,26378,241.60,87.28,169841.81,1,16.98,17.89,0.05
1947,0,18552299,8772,80.34,169922.16,2,18559428,7129,18552299,8772,80.34,87.27,169922.16,1,17.02,17.60,0.05
1948,0,18577601,25302,231.72,170153.88,2,18577601,0,18577601,25302,231.74,87.35,170153.88,0,17.10,17.60,0.05
1949,0,18577601,0,0.00,170153.88,2,18588307,10706,18577601,0,0.00,87.30,170153.88,0,19.33,18.33,0.10
1950,0,18577601,0,0.00,170153.88,2,18593860,16259,18577601,0,0.00,87.26,170153.88,1,20.87,19.87,0.15
1951,0,18587073,9472,86.75,170240.62,2,18598596,11523,18587073,9472,86.75,87.26,170240.62,0,19.13,19.87,0.04
1952,0,18604117,17044,156.11,170396.73,2,18607118,3001,18604117,17044,156.11,87.29,170396.73,1,19.22,19.87,0.09
1953,0,18633706,29589,271.02,170667.75,2,18633706,0,18633706,29589,271.01,87.39,170667.75,0,17.86,19.87,0.02
1954,0,18663455,29749,272.48,170940.23,2,18663455,0,18663455,29749,272.47,87.48,170940.23,0,19.13,19.87,0.07
1955,0,18693540,30085,275.54,171215.78,2,18693540,0,18693540,30085,275.55,87.58,171215.78,1,19.59,19.87,0.12
1956,0,18693540,0,0.00,171215.78,2,18703934,10394,18693540,0,0.00,87.53,171215.78,1,20.83,19.83,0.12
1957,0,18693540,0,0.00,171215.78,2,18709971,16431,18693540,0,0.00,87.49,171215.78,0,20.83,19.83,0.05
1958,0,18693540,0,0.00,171215.78,2,18714399,20859,18693540,0,0.00,87.44,171215.78,0,20.83,19.83,0.10
1959,0,18693540,0,0.00,171215.78,2,18718125,24585,18693540,0,0.00,87.40,171215.78,1,21.69,19.00,0.15
1960,0,18693540,0,0.00,171215.78,2,18721322,27782,18693540,0,0.00,87.35,171215.78,0,20.98,19.98,0.06
1961,0,18693540,0,0.00,171215.78,2,18724217,30677,18693540,0,0.00,87.31,171215.78,1,20.98,19.98,0.11
1962,0,18699476,5936,54.37,171270.16,2,18727185,27709,18699476,5936,54.37,87.29,171270.16,0,19.25,19.98,0.03
1963,0,18705270,5794,53.07,171323.22,2,18730082,24812,18705270,5794,53.07,87.28,171323.22,1,19.30,19.98,0.08
1964,0,18711036,5766,52.81,171376.03,2,18732965,21929,18711036,5766,52.81,87.26,171376.03,1,18.24,19.98,0.01
1965,0,18716966,5930,54.31,171430.34,2,18735930,18964,18716966,5930,54.31,87.24,171430.34,0,19.02,19.98,0.01
1966,0,18722808,5842,53.51,171483.84,2,18738851,16043,18722808,5842,53.51,87.22,171483.84,1,19.07,19.98,0.05
1967,0,18729040,6232,57.08,171540.92,2,18741967,12927,18729040,6232,57.08,87.21,171540.92,0,18.27,19.98,0.05
1968,0,18740134,11094,101.61,171642.53,2,18747514,7380,18740134,11094,101.61,87.22,171642.53,1,18.32,19.98,0.05
1969,0,18764350,24216,221.80,171864.33,2,18764350,0,18764350,24216,221.80,87.29,171864.33,0,18.17,19.98,0.05
1970,0,18794995,30645,280.69,172145.03,2,18794995,0,18794995,30645,280.68,87.38,172145.03,1,18.39,19.98,0.05
1971,0,18825627,30632,280.56,172425.59,2,18825627,0,18825627,30632,280.56,87.48,172425.59,0,17.39,19.98,0.01
1972,0,18856055,30428,278.69,172704.28,2,18856055,0,18856055,30428,278.69,87.58,172704.28,1,19.68,19.98,0.06
1973,0,18856055,0,0.00,172704.28,2,18866444,10389,18856055,0,0.00,87.53,172704.28,0,21.51,19.00,0.06
1974,0,18856055,0,0.00,172704.28,2,18872202,16147,18856055,0,0.00,87.49,172704.28,1,21.51,19.00,0.05
1975,0,18856055,0,0.00,172704.28,2,18876280,20225,18856055,0,0.00,87.45,172704.28,0,20.93,19.93,0.05
1976,0,18856055,0,0.00,172704.28,2,18879860,23805,18856055,0,0.00,87.40,172704.28,1,20.93,19.93,0.05
1977,0,18862549,6494,59.46,172763.73,2,18883107,20558,18862549,6494,59.48,87.39,172763.73,0,19.75,19.93,0.05
1978,0,18869183,6634,60.78,172824.52,2,18886424,17241,18869183,6634,60.76,87.37,172824.52,0,19.81,19.93,0.05
1979,0,18869183,0,0.00,172824.52,2,18889739,20556,18869183,0,0.00,87.33,172824.52,1,20.26,19.26,0.10
1980,0,18875333,6150,56.31,172880.83,2,18892814,17481,18875333,6150,56.33,87.31,172880.83,1,18.96,19.26,0.05
1981,0,18881735,6402,58.65,172939.48,2,18896015,14280,18881735,6402,58.64,87.30,172939.48,0,17.38,19.26,0.05
1982,0,18892909,11174,102.33,173041.81,2,18901602,8693,18892909,11174,102.34,87.31,173041.81,1,17.44,19.26,0.05
1983,0,18916589,23680,216.89,173258.70,2,18916589,0,18916589,23680,216.89,87.37,173258.70,0,15.99,19.26,0.05
1984,0,18947156,30567,279.98,173538.67,2,18947156,0,18947156,30567,279.97,87.47,173538.67,1,16.21,19.26,0.05
1985,0,18964202,17046,156.13,173694.80,2,18969683,5481,18964202,17046,156.13,87.50,173694.80,0,19.91,18.91,0.05
1986,0,18964202,0,0.00,173694.80,2,18977257,13055,18964202,0,0.00,87.46,173694.80,1,20.06,19.06,0.05
1987,0,18972069,7867,72.05,173766.84,2,18983833,11764,18972069,7867,72.05,87.45,173766.84,0,19.82,18.82,0.05
1988,0,18972069,0,0.00,173766.84,2,18988747,16678,18972069,0,0.00,87.41,173766.84,1,19.89,18.89,0.05
1989,0,18980106,8037,73.62,173840.47,2,18993164,13058,18980106,8037,73.61,87.40,173840.47,0,18.96,17.96,0.05
1990,0,18980106,0,0.00,173840.47,2,18997396,17290,18980106,0,0.00,87.36,173840.47,1,19.03,18.03,0.05
1991,0,18988782,8676,79.46,173919.92,2,19001734,12952,18988782,8676,79.46,87.35,173919.92,0,16.75,18.03,0.05
1992,0,19004170,15388,140.94,174060.88,2,19009428,5258,19004170,15388,140.94,87.38,174060.88,1,16.83,18.03,0.05
1993,0,19031047,26877,246.18,174307.05,2,19031047,0,19031047,26877,246.17,87.46,174307.05,0,15.63,18.03,0.00
1994,0,19060707,29660,271.66,174578.70,2,19060707,0,19060707,29660,271.66,87.55,174578.70,1,16.42,18.03,0.05
1995,0,19090526,29819,273.11,174851.81,2,19090526,0,19090526,29819,273.11,87.65,174851.81,0,16.97,18.03,0.05
1996,0,19120785,30259,277.14,175128.95,2,19120785,0,19120785,30259,277.14,87.74,175128.95,1,17.24,18.03,0.05
1997,0,19150661,29876,273.64,175402.58,2,19150661,0,19150661,29876,273.64,87.83,175402.58,0,16.40,18.03,0.05
1998,0,19180667,30006,274.85,175677.42,2,19180667,0,19180667,30006,274.83,87.93,175677.42,0,16.67,18.03,0.05
1999,0,19180667,0,0.00,175677.42,2,19190984,10317,19180667,0,0.00,87.88,175677.42,1,23.19,19.00,0.10
2000,0,19180667,0,0.00,175677.42,2,19196901,16234,19180667,0,0.00,87.84,175677.42,0,21.67,19.00,0.03
2001,0,19180667,0,0.00,175677.42,2,19201160,20493,19180667,0,0.00,87.79,175677.42,1,21.90,19.00,0.08
2002,0,19180667,0,0.00,175677.42,2,19204675,24008,19180667,0,0.00,87.75,175677.42,0,20.20,19.20,0.08
2003,0,19180667,0,0.00,175677.42,2,19208064,27397,19180667,0,0.00,87.71,175677.42,1,20.20,19.20,0.05
2004,0,19187297,6630,60.71,175738.14,2,19211379,24082,19187297,6630,60.72,87.69,175738.14,0,18.66,19.20,0.05
2005,0,19193683,6386,58.51,175796.64,2,19214572,20889,19193683,6386,58.49,87.68,175796.64,1,18.72,19.20,0.05
2006,0,19200023,6340,58.07,175854.72,2,19217742,17719,19200023,6340,58.07,87.66,175854.72,1,18.31,19.20,0.04
2007,0,19206441,6418,58.76,175913.48,2,19220951,14510,19206441,6418,58.78,87.65,175913.48,0,17.28,19.20,0.04
2008,0,19213941,7500,68.69,175982.17,2,19224701,10760,19213941,7500,68.69,87.64,175982.17,1,17.34,19.20,0.05
2009,0,19231149,17208,157.61,176139.78,2,19233305,2156,19231149,17208,157.61,87.68,176139.78,0,16.80,19.20,0.05
2010,0,19260309,29160,267.08,176406.86,2,19260309,0,19260309,29160,267.08,87.76,176406.86,1,16.95,19.20,0.05
2011,0,19290067,29758,272.57,176679.44,2,19290067,0,19290067,29758,272.56,87.86,176679.44,0,16.19,19.20,0.01
2012,0,19290067,0,0.00,176679.44,2,19300074,10007,19290067,0,0.00,87.81,176679.44,1,19.76,18.76,0.06
2013,0,19300614,10547,96.59,176776.03,2,19308882,8268,19300614,10547,96.60,87.82,176776.03,0,19.65,18.65,0.06
2014,0,19300614,0,0.00,176776.03,2,19315428,14814,19300614,0,0.00,87.77,176776.03,1,19.74,18.74,0.05
2015,0,19313312,12698,116.30,176892.33,2,19321777,8465,19313312,12698,116.30,87.79,176892.33,0,18.62,18.74,0.05
2016,0,19335423,22111,202.53,177094.86,2,19335423,0,19335423,22111,202.52,87.84,177094.86,1,18.74,18.74,0.05
2017,0,19365312,29889,273.75,177368.59,2,19365312,0,19365312,29889,273.76,87.94,177368.59,0,17.32,18.74,0.05
2018,0,19394877,29565,270.78,177639.38,2,19394877,0,19394877,29565,270.79,88.03,177639.38,0,17.58,18.74,0.05
2019,0,19394877,0,0.00,177639.38,2,19405116,10239,19394877,0,0.00,87.98,177639.38,1,21.26,19.00,0.10
2020,0,19394877,0,0.00,177639.38,2,19411238,16361,19394877,0,0.00,87.94,177639.38,0,22.07,19.00,0.06
2021,0,19394877,0,0.00,177639.38,2,19415755,20878,19394877,0,0.00,87.90,177639.38,1,22.07,19.00,0.11
2022,0,19394877,0,0.00,177639.38,2,19419601,24724,19394877,0,0.00,87.85,177639.38,0,21.98,19.00,0.03
2023,0,19394877,0,0.00,177639.38,2,19423002,28125,19394877,0,0.00,87.81,177639.38,1,22.26,19.00,0.08
2024,0,19394877,0,0.00,177639.38,2,19425779,30902,19394877,0,0.00,87.77,177639.38,1,19.43,18.43,0.08
2025,0,19394877,0,0.00,177639.38,2,19428357,33480,19394877,0,0.00,87.72,177639.38,0,19.43,18.43,0.05
2026,0,19394877,0,0.00,177639.38,2,19430965,36088,19394877,0,0.00,87.68,177639.38,1,19.43,18.43,0.10
2027,0,19394877,0,0.00,177639.38,2,19433429,38552,19394877,0,0.00,87.64,177639.38,1,19.42,18.42,0.04
2028,0,19394877,0,0.00,177639.38,2,19435768,40891,19394877,0,0.00,87.59,177639.38,0,18.72,17.72,0.04
2029,0,19394877,0,0.00,177639.38,2,19437985,43108,19394877,0,0.00,87.55,177639.38,0,18.72,17.72,0.05
2030,0,19394877,0,0.00,177639.38,2,19440062,45185,19394877,0,0.00,87.51,177639.38,1,18.72,17.72,0.10
2031,0,19398913,4036,36.97,177676.34,2,19442080,43167,19398913,4036,36.97,87.48,177676.34,0,16.99,17.72,0.02
2032,0,19402935,4022,36.86,177713.20,2,19444091,41156,19402935,4022,36.84,87.46,177713.20,1,17.03,17.72,0.07
2033,0,19406977,4042,37.00,177750.20,2,19446112,39135,19406977,4042,37.02,87.43,177750.20,0,15.86,17.72,0.03
2034,0,19410997,4020,36.82,177787.02,2,19448122,37125,19410997,4020,36.82,87.41,177787.02,1,16.74,17.72,0.08
2035,0,19415061,4064,37.22,177824.25,2,19450154,35093,19415061,4064,37.22,87.38,177824.25,0,16.12,17.72,0.08
2036,0,19419149,4088,37.44,177861.69,2,19452198,33049,19419149,4088,37.44,87.36,177861.69,1,16.15,17.72,0.05
2037,0,19423209,4060,37.19,177898.88,2,19454228,31019,19423209,4060,37.19,87.33,177898.88,0,15.10,17.72,0.01
2038,0,19427189,3980,36.45,177935.33,2,19456218,29029,19427189,3980,36.45,87.31,177935.33,1,15.23,17.72,0.06
2039,0,19431141,3952,36.20,177971.53,2,19458194,27053,19431141,3952,36.20,87.28,177971.53,0,13.30,17.72,0.06
2040,0,19435267,4126,37.81,178009.33,2,19460257,24990,19435267,4126,37.79,87.26,178009.33,1,13.33,17.72,0.05
2041,0,19439467,4200,38.47,178047.80,2,19462357,22890,19439467,4200,38.47,87.24,178047.80,0,12.41,17.72,0.03
2042,0,19443817,4350,39.82,178087.62,2,19464532,20715,19443817,4350,39.84,87.21,178087.62,1,12.44,17.72,0.08
2043,0,19448549,4732,43.34,178130.97,2,19466898,18349,19448549,4732,43.34,87.19,178130.97,0,11.19,17.72,0.03
2044,0,19453669,5120,46.89,178177.86,2,19469458,15789,19453669,5120,46.89,87.17,178177.86,1,11.23,17.72,0.08
2045,0,19460857,7188,65.84,178243.69,2,19473052,12195,19460857,7188,65.84,87.16,178243.69,0,9.87,17.72,0.03
2046,0,19477637,16780,153.69,178397.39,2,19481442,3805,19477637,16780,153.69,87.19,178397.39,1,9.93,17.72,0.08
2047,0,19507070,29433,269.59,178666.97,2,19507070,0,19507070,29433,269.58,87.28,178666.97,0,8.64,17.72,0.01
2048,0,19537754,30684,281.04,178948.02,2,19537754,0,19537754,30684,281.04,87.38,178948.02,1,10.04,17.72,0.06
2049,0,19568523,30769,281.83,179229.84,2,19568523,0,19568523,30769,281.82,87.47,179229.84,0,12.90,17.72,0.06
2050,0,19599007,30484,279.21,179509.05,2,19599007,0,19599007,30484,279.21,87.57,179509.05,1,13.18,17.72,0.05
2051,0,19629971,30964,283.60,179792.64,2,19629971,0,19629971,30964,283.60,87.66,179792.64,0,13.41,17.72,0.00
2052,0,19660594,30623,280.47,180073.11,2,19660594,0,19660594,30623,280.48,87.75,180073.11,1,14.81,17.72,0.05
2053,0,19690970,30376,278.22,180351.33,2,19690970,0,19690970,30376,278.22,87.85,180351.33,0,15.39,17.72,0.05
2054,0,19721546,30576,280.05,180631.38,2,19721546,0,19721546,30576,280.05,87.94,180631.38,1,15.66,17.72,0.05
2055,0,19727355,5809,53.21,180684.59,2,19736503,9148,19727355,5809,53.21,87.92,180684.59,0,18.01,17.01,0.05
2056,0,19727355,0,0.00,180684.59,2,19743036,15681,19727355,0,0.00,87.88,180684.59,1,18.06,17.06,0.05
2057,0,19737487,10132,92.80,180777.39,2,19748102,10615,19737487,10132,92.80,87.88,180777.39,0,17.01,17.06,0.05
2058,0,19737487,0,0.00,180777.39,2,19753141,15654,19737487,0,0.00,87.84,180777.39,0,17.10,16.10,0.05
2059,0,19737487,0,0.00,180777.39,2,19756726,19239,19737487,0,0.00,87.80,180777.39,1,17.10,16.10,0.10
2060,0,19744185,6698,61.33,180838.72,2,19760075,15890,19744185,6698,61.35,87.79,180838.72,1,15.56,16.10,0.03
2061,0,19753723,9538,87.38,180926.09,2,19764844,11121,19753723,9538,87.36,87.79,180926.09,0,14.20,16.10,0.03
2062,0,19772409,18686,171.13,181097.23,2,19774187,1778,19772409,18686,171.15,87.83,181097.23,1,14.28,16.10,0.05
2063,0,19803063,30654,280.78,181378.02,2,19803063,0,19803063,30654,280.76,87.92,181378.02,0,13.15,16.10,0.00
2064,0,19833553,30490,279.24,181657.25,2,19833553,0,19833553,30490,279.26,88.01,181657.25,1,14.73,16.10,0.05
2065,0,19864424,30871,282.76,181940.02,2,19864424,0,19864424,30871,282.75,88.11,181940.02,0,15.26,16.10,0.00
2066,0,19864424,0,0.00,181940.02,2,19874886,10462,19864424,0,0.00,88.06,181940.02,1,17.25,16.25,0.05
2067,0,19864424,0,0.00,181940.02,2,19880557,16133,19864424,0,0.00,88.02,181940.02,0,17.44,16.44,0.05
2068,0,19864424,0,0.00,181940.02,2,19884983,20559,19864424,0,0.00,87.98,181940.02,1,17.44,16.44,0.05
2069,0,19864424,0,0.00,181940.02,2,19888807,24383,19864424,0,0.00,87.94,181940.02,0,16.96,15.96,0.00
2070,0,19864424,0,0.00,181940.02,2,19892192,27768,19864424,0,0.00,87.89,181940.02,1,16.96,15.96,0.05
2071,0,19870872,6448,59.06,181999.06,2,19895416,24544,19870872,6448,59.06,87.88,181999.06,0,15.35,15.96,0.05
2072,0,19877336,6464,59.20,182058.27,2,19898648,21312,19877336,6464,59.20,87.87,182058.27,1,15.40,15.96,0.05
2073,0,19883722,6386,58.49,182116.77,2,19901841,18119,19883722,6386,58.49,87.85,182116.77,0,15.32,15.96,0.00
2074,0,19889956,6234,57.10,182173.86,2,19904958,15002,19889956,6234,57.10,87.84,182173.86,1,15.66,15.96,0.05
2075,0,19896426,6470,59.26,182233.12,2,19908193,11767,19896426,6470,59.26,87.82,182233.12,0,13.44,15.96,0.05
2076,0,19911186,14760,135.19,182368.31,2,19915573,4387,19911186,14760,135.19,87.85,182368.31,1,13.49,15.96,0.05
2077,0,19941225,30039,275.12,182643.42,2,19941225,0,19941225,30039,275.13,87.94,182643.42,0,14.38,15.96,0.01
2078,0,19941225,0,0.00,182643.42,2,19951422,10197,19941225,0,0.00,87.89,182643.42,0,16.36,15.36,0.06
2079,0,19941225,0,0.00,182643.42,2,19957369,16144,19941225,0,0.00,87.85,182643.42,1,16.65,15.65,0.10
2080,0,19941225,0,0.00,182643.42,2,19961813,20588,19941225,0,0.00,87.81,182643.42,0,16.53,15.53,0.02
2081,0,19941225,0,0.00,182643.42,2,19965606,24381,19941225,0,0.00,87.77,182643.42,1,16.82,15.82,0.07
2082,0,19948065,6840,62.65,182706.08,2,19969026,20961,19948065,6840,62.65,87.76,182706.08,0,15.17,15.82,0.00
2083,0,19954681,6616,60.60,182766.67,2,19972334,17653,19954681,6616,60.60,87.74,182766.67,1,15.71,15.82,0.05
2084,0,19957648,2967,27.18,182793.86,2,19975788,18140,19957648,2967,27.18,87.71,182793.86,0,15.88,14.88,0.05
2085,0,19957648,0,0.00,182793.86,2,19978880,21232,19957648,0,0.00,87.67,182793.86,1,15.91,14.91,0.05
2086,0,19963370,5722,52.41,182846.27,2,19981741,18371,19963370,5722,52.41,87.65,182846.27,0,14.77,14.91,0.02
2087,0,19969548,6178,56.58,182902.84,2,19984830,15282,19969548,6178,56.58,87.64,182902.84,1,14.82,14.91,0.06
2088,0,19979506,9958,91.21,182994.06,2,19989809,10303,19979506,9958,91.21,87.64,182994.06,1,13.46,14.91,0.01
2089,0,20000559,21053,192.84,183186.89,2,20000559,0,20000559,21053,192.83,87.69,183186.89,0,14.37,14.91,0.01
2090,0,20031504,30945,283.42,183470.31,2,20031504,0,20031504,30945,283.43,87.78,183470.31,1,14.56,14.91,0.05
2091,0,20062936,31432,287.89,183758.20,2,20062936,0,20062936,31432,287.89,87.88,183758.20,0,14.13,14.91,0.00
2092,0,20062936,0,0.00,183758.20,2,20073098,10162,20062936,0,0.00,87.84,183758.20,1,15.49,14.49,0.05
2093,0,20082972,20036,183.51,183941.70,2,20083116,144,20082972,20036,183.51,87.88,183941.70,0,14.13,14.49,0.00
2094,0,20082972,0,0.00,183941.70,2,20093103,10131,20082972,0,0.00,87.84,183941.70,1,16.65,15.65,0.05
2095,0,20082972,0,0.00,183941.70,2,20098384,15412,20082972,0,0.00,87.80,183941.70,1,17.16,16.16,0.02
2096,0,20082972,0,0.00,183941.70,2,20102375,19403,20082972,0,0.00,87.76,183941.70,0,16.76,15.76,0.02
2097,0,20082972,0,0.00,183941.70,2,20105820,22848,20082972,0,0.00,87.72,183941.70,0,16.76,15.76,0.05
2098,0,20082972,0,0.00,183941.70,2,20109015,26043,20082972,0,0.00,87.67,183941.70,1,17.38,16.38,0.10
2099,0,20082972,0,0.00,183941.70,2,20111995,29023,20082972,0,0.00,87.63,183941.70,0,16.65,15.65,0.04
2100,0,20082972,0,0.00,183941.70,2,20114891,31919,20082972,0,0.00,87.59,183941.70,1,16.94,15.94,0.09
2101,0,20088766,5794,53.07,183994.78,2,20117788,29022,20088766,5794,53.07,87.57,183994.78,1,15.80,15.94,0.06
2102,0,20094478,5712,52.32,184047.09,2,20120644,26166,20094478,5712,52.32,87.56,184047.09,0,14.58,15.94,0.02
2103,0,20099982,5504,50.41,184097.50,2,20123396,23414,20099982,5504,50.41,87.54,184097.50,1,14.63,15.94,0.06
2104,0,20105518,5536,50.70,184148.22,2,20126164,20646,20105518,5536,50.70,87.52,184148.22,0,13.23,15.94,0.01
2105,0,20110882,5364,49.13,184197.34,2,20128846,17964,20110882,5364,49.13,87.50,184197.34,1,13.28,15.94,0.06
2106,0,20116158,5276,48.32,184245.66,2,20131484,15326,20116158,5276,48.32,87.49,184245.66,0,11.72,15.94,0.06
2107,0,20122586,6428,58.87,184304.53,2,20134698,12112,20122586,6428,58.87,87.47,184304.53,0,11.77,15.94,0.05
2108,0,20137540,14954,136.96,184441.50,2,20142175,4635,20137540,14954,136.96,87.50,184441.50,1,11.82,15.94,0.09
2109,0,20168444,30904,283.05,184724.56,2,20168444,0,20168444,30904,283.05,87.59,184724.56,0,9.99,15.94,0.00
2110,0,20199693,31249,286.20,185010.77,2,20199693,0,20199693,31249,286.21,87.68,185010.77,1,12.27,15.94,0.05
2111,0,20230564,30871,282.76,185293.52,2,20230564,0,20230564,30871,282.75,87.78,185293.52,0,13.24,15.94,0.01
2112,0,20261660,31096,284.81,185578.33,2,20261660,0,20261660,31096,284.81,87.87,185578.33,1,15.54,15.94,0.05
2113,0,20292420,30760,281.73,185860.06,2,20292420,0,20292420,30760,281.73,87.96,185860.06,0,14.62,15.94,0.05
2114,0,20323428,31008,284.01,186144.06,2,20323428,0,20323428,31008,284.01,88.05,186144.06,1,14.90,15.94,0.05
2115,0,20354361,30933,283.31,186427.38,2,20354361,0,20354361,30933,283.32,88.15,186427.38,0,15.31,15.94,0.01
2116,0,20354361,0,0.00,186427.38,2,20364603,10242,20354361,0,0.00,88.10,186427.38,1,15.99,14.99,0.06
2117,0,20365369,11008,100.82,186528.20,2,20373485,8116,20365369,11008,100.82,88.11,186528.20,0,15.12,14.12,0.06
2118,0,20365369,0,0.00,186528.20,2,20379959,14590,20365369,0,0.00,88.07,186528.20,0,15.22,14.22,0.05
2119,0,20365369,0,0.00,186528.20,2,20383836,18467,20365369,0,0.00,88.03,186528.20,1,18.45,17.45,0.09
2120,0,20365369,0,0.00,186528.20,2,20386838,21469,20365369,0,0.00,87.99,186528.20,0,17.67,16.67,0.03
2121,0,20365369,0,0.00,186528.20,2,20389705,24336,20365369,0,0.00,87.94,186528.20,1,17.67,16.67,0.08
2122,0,20370987,5618,51.47,186579.67,2,20392514,21527,20370987,5618,51.46,87.93,186579.67,0,16.03,16.67,0.01
2123,0,20377227,6240,57.15,186636.83,2,20395634,18407,20377227,6240,57.15,87.91,186636.83,1,16.08,16.67,0.06
2124,0,20384125,6898,63.16,186699.98,2,20399083,14958,20384125,6898,63.18,87.90,186699.98,0,14.63,16.67,0.06
2125,0,20392613,8488,77.74,186777.73,2,20403327,10714,20392613,8488,77.74,87.90,186777.73,1,14.69,16.67,0.05
2126,0,20410041,17428,159.62,186937.36,2,20412041,2000,20410041,17428,159.62,87.93,186937.36,0,14.07,16.67,0.02
2127,0,20440286,30245,277.03,187214.38,2,20440286,0,20440286,30245,277.02,88.02,187214.38,1,15.06,16.67,0.06
2128,0,20470945,30659,280.80,187495.19,2,20470945,0,20470945,30659,280.81,88.11,187495.19,0,13.87,16.67,0.01
2129,0,20501773,30828,282.36,187777.53,2,20501773,0,20501773,30828,282.36,88.20,187777.53,1,14.82,16.67,0.06
2130,0,20532362,30589,280.18,188057.72,2,20532362,0,20532362,30589,280.17,88.29,188057.72,1,15.38,16.67,0.01
2131,0,20546952,14590,133.63,188191.34,2,20553223,6271,20546952,14590,133.63,88.31,188191.34,0,18.34,17.34,0.01
2132,0,20546952,0,0.00,188191.34,2,20560486,13534,20546952,0,0.00,88.27,188191.34,1,18.47,17.47,0.05
2133,0,20546952,0,0.00,188191.34,2,20565160,18208,20546952,0,0.00,88.23,188191.34,0,17.51,16.51,0.05
2134,0,20546952,0,0.00,188191.34,2,20569011,22059,20546952,0,0.00,88.19,188191.34,1,17.51,16.51,0.05
2135,0,20546952,0,0.00,188191.34,2,20572411,25459,20546952,0,0.00,88.15,188191.34,0,17.63,16.63,0.00
2136,0,20546952,0,0.00,188191.34,2,20575503,28551,20546952,0,0.00,88.10,188191.34,1,18.21,17.21,0.05
2137,0,20552766,5814,53.25,188244.59,2,20578410,25644,20552766,5814,53.25,88.09,188244.59,0,16.85,17.21,0.00
2138,0,20558782,6016,55.10,188299.70,2,20581418,22636,20558782,6016,55.10,88.07,188299.70,0,16.91,17.21,0.05
2139,0,20558782,0,0.00,188299.70,2,20584255,25473,20558782,0,0.00,88.03,188299.70,1,17.39,16.39,0.10
2140,0,20558782,0,0.00,188299.70,2,20586880,28098,20558782,0,0.00,87.99,188299.70,1,16.91,15.91,0.05
2141,0,20558782,0,0.00,188299.70,2,20589313,30531,20558782,0,0.00,87.95,188299.70,0,15.96,14.96,0.00
2142,0,20558782,0,0.00,188299.70,2,20591606,32824,20558782,0,0.00,87.91,188299.70,1,16.41,15.41,0.05
2143,0,20558782,0,0.00,188299.70,2,20593775,34993,20558782,0,0.00,87.87,188299.70,0,15.45,14.45,0.02
2144,0,20558782,0,0.00,188299.70,2,20595839,37057,20558782,0,0.00,87.83,188299.70,1,15.45,14.45,0.06
2145,0,20562804,4022,36.84,188336.53,2,20597850,35046,20562804,4022,36.84,87.80,188336.53,0,14.27,14.45,0.02
2146,0,20566662,3858,35.34,188371.88,2,20599779,33117,20566662,3858,35.34,87.78,188371.88,1,14.31,14.45,0.06
2147,0,20570526,3864,35.39,188407.27,2,20601711,31185,20570526,3864,35.39,87.75,188407.27,0,14.01,14.45,0.06
2148,0,20574392,3866,35.41,188442.67,2,20603644,29252,20574392,3866,35.41,87.73,188442.67,1,14.04,14.45,0.05
2149,0,20578330,3938,36.07,188478.73,2,20605613,27283,20578330,3938,36.07,87.71,188478.73,0,12.60,14.45,0.05
2150,0,20582300,3970,36.36,188515.09,2,20607598,25298,20582300,3970,36.36,87.68,188515.09,1,12.64,14.45,0.05
2151,0,20586416,4116,37.70,188552.80,2,20609656,23240,20586416,4116,37.70,87.66,188552.80,0,11.14,14.45,0.05
2152,0,20590820,4404,40.34,188593.14,2,20611858,21038,20590820,4404,40.34,87.64,188593.14,1,11.17,14.45,0.05
2153,0,20595382,4562,41.78,188634.92,2,20614139,18757,20595382,4562,41.78,87.61,188634.92,0,8.98,14.45,0.05
2154,0,20600274,4892,44.81,188679.72,2,20616585,16311,20600274,4892,44.81,87.60,188679.72,1,9.02,14.45,0.05
2155,0,20607312,7038,64.46,188744.19,2,20620104,12792,20607312,7038,64.46,87.58,188744.19,0,9.15,14.45,0.00
2156,0,20622806,15494,141.91,188886.09,2,20627851,5045,20622806,15494,141.91,87.61,188886.09,1,9.79,14.45,0.05
2157,0,20651645,28839,264.13,189150.23,2,20651645,0,20651645,28839,264.14,87.69,189150.23,0,9.95,14.45,0.05
2158,0,20682808,31163,285.43,189435.66,2,20682808,0,20682808,31163,285.42,87.78,189435.66,0,10.21,14.45,0.05
2159,0,20713988,31180,285.58,189721.23,2,20713988,0,20713988,31180,285.58,87.87,189721.23,0,11.45,14.45,0.09
2160,0,20745339,31351,287.16,190008.39,2,20745339,0,20745339,31351,287.15,87.97,190008.39,1,12.00,14.45,0.14
2161,0,20776101,30762,281.73,190290.12,2,20776101,0,20776101,30762,281.75,88.06,190290.12,1,11.90,14.45,0.07
2162,0,20806915,30814,282.25,190572.38,2,20806915,0,20806915,30814,282.23,88.15,190572.38,0,11.49,14.45,0.02
2163,0,20838119,31204,285.80,190858.17,2,20838119,0,20838119,31204,285.80,88.24,190858.17,1,12.24,14.45,0.06
2164,0,20851026,12907,118.21,190976.39,2,20857897,6871,20851026,12907,118.22,88.25,190976.39,0,16.83,15.83,0.06
2165,0,20851026,0,0.00,190976.39,2,20864854,13828,20851026,0,0.00,88.21,190976.39,1,16.95,15.95,0.05
2166,0,20864142,13116,120.13,191096.52,2,20871412,7270,20864142,13116,120.13,88.23,191096.52,0,15.90,15.95,0.02
2167,0,20864142,0,0.00,191096.52,2,20878261,14119,20864142,0,0.00,88.18,191096.52,1,18.09,17.09,0.07
2168,0,20878046,13904,127.35,191223.86,2,20885213,7167,20878046,13904,127.35,88.20,191223.86,0,16.99,17.09,0.02
2169,0,20878046,0,0.00,191223.86,2,20892255,14209,20878046,0,0.00,88.16,191223.86,1,17.19,16.19,0.07
2170,0,20891086,13040,119.43,191343.30,2,20898775,7689,20891086,13040,119.43,88.18,191343.30,1,16.07,16.19,0.03
2171,0,20914417,23331,213.68,191556.98,2,20914417,0,20914417,23331,213.69,88.23,191556.98,0,15.00,16.19,0.03
2172,0,20946122,31705,290.40,191847.38,2,20946122,0,20946122,31705,290.39,88.33,191847.38,1,15.21,16.19,0.05
2173,0,20976919,30797,282.08,192129.45,2,20976919,0,20976919,30797,282.07,88.42,192129.45,0,15.28,16.19,0.00
2174,0,20976919,0,0.00,192129.45,2,20987169,10250,20976919,0,0.00,88.38,192129.45,1,17.29,16.29,0.05
2175,0,20976919,0,0.00,192129.45,2,20992878,15959,20976919,0,0.00,88.34,192129.45,0,16.34,15.34,0.01
2176,0,20976919,0,0.00,192129.45,2,20997054,20135,20976919,0,0.00,88.29,192129.45,1,17.45,16.45,0.06
2177,0,20976919,0,0.00,192129.45,2,21000813,23894,20976919,0,0.00,88.25,192129.45,0,17.64,16.64,0.02
2178,0,20976919,0,0.00,192129.45,2,21004245,27326,20976919,0,0.00,88.21,192129.45,0,17.64,16.64,0.06
2179,0,20976919,0,0.00,192129.45,2,21007363,30444,20976919,0,0.00,88.17,192129.45,1,17.74,16.74,0.11
2180,0,20982875,5956,54.55,192184.02,2,21010341,27466,20982875,5956,54.55,88.16,192184.02,0,16.45,16.74,0.07
2181,0,20982875,0,0.00,192184.02,2,21013173,30298,20982875,0,0.00,88.12,192184.02,1,18.09,17.09,0.11
2182,0,20988245,5370,49.17,192233.17,2,21015858,27613,20988245,5370,49.18,88.10,192233.17,1,16.96,17.09,0.07
2183,0,20993625,5380,49.28,192282.45,2,21018548,24923,20993625,5380,49.28,88.08,192282.45,0,15.76,17.09,0.03
2184,0,20999049,5424,49.68,192332.12,2,21021260,22211,20999049,5424,49.68,88.06,192332.12,1,15.81,17.09,0.08
2185,0,21004361,5312,48.65,192380.78,2,21023916,19555,21004361,5312,48.65,88.05,192380.78,0,14.85,17.09,0.06
2186,0,21009523,5162,47.30,192428.08,2,21026497,16974,21009523,5162,47.28,88.03,192428.08,1,14.90,17.09,0.10
2187,0,21015147,5624,51.51,192479.59,2,21029309,14162,21015147,5624,51.51,88.01,192479.59,0,14.96,17.09,0.03
2188,0,21026113,10966,100.42,192580.02,2,21034792,8679,21026113,10966,100.44,88.02,192580.02,1,15.29,17.09,0.08
2189,0,21051408,25295,231.69,192811.70,2,21051408,0,21051408,25295,231.68,88.08,192811.70,0,14.35,17.09,0.06
2190,0,21082202,30794,282.04,193093.75,2,21082202,0,21082202,30794,282.04,88.17,193093.75,1,16.58,17.09,0.10
2191,0,21082202,0,0.00,193093.75,2,21092302,10100,21082202,0,0.00,88.13,193093.75,0,17.20,16.20,0.03
2192,0,21082202,0,0.00,193093.75,2,21098351,16149,21082202,0,0.00,88.09,193093.75,1,18.06,17.06,0.08
2193,0,21082202,0,0.00,193093.75,2,21102858,20656,21082202,0,0.00,88.05,193093.75,0,17.92,16.92,0.04
2194,0,21082202,0,0.00,193093.75,2,21106698,24496,21082202,0,0.00,88.01,193093.75,1,17.92,16.92,0.08
2195,0,21089316,7114,65.16,193158.91,2,21110255,20939,21089316,7114,65.16,88.00,193158.91,0,16.07,16.92,0.01
2196,0,21089316,0,0.00,193158.91,2,21113551,24235,21089316,0,0.00,87.96,193158.91,1,17.83,16.83,0.05
2197,0,21089316,0,0.00,193158.91,2,21116528,27212,21089316,0,0.00,87.92,193158.91,0,16.93,15.93,0.02
2198,0,21089316,0,0.00,193158.91,2,21119233,29917,21089316,0,0.00,87.88,193158.91,0,16.93,15.93,0.06
2199,0,21089316,0,0.00,193158.91,2,21121614,32298,21089316,0,0.00,87.84,193158.91,1,17.32,16.32,0.11
2200,0,21094018,4702,43.07,193201.97,2,21123965,29947,21094018,4702,43.07,87.82,193201.97,0,15.27,16.32,0.02
2201,0,21098878,4860,44.51,193246.48,2,21126395,27517,21098878,4860,44.51,87.80,193246.48,1,15.95,16.32,0.06
2202,0,21103768,4890,44.79,193291.27,2,21128840,25072,21103768,4890,44.79,87.78,193291.27,0,15.28,16.32,0.05
2203,0,21108754,4986,45.67,193336.94,2,21131333,22579,21108754,4986,45.67,87.76,193336.94,1,15.54,16.32,0.09
2204,0,21113860,5106,46.77,193383.70,2,21133886,20026,21113860,5106,46.77,87.74,193383.70,1,14.43,16.32,0.06
2205,0,21119308,5448,49.90,193433.61,2,21136610,17302,21119308,5448,49.90,87.72,193433.61,0,13.21,16.32,0.02
2206,0,21125046,5738,52.55,193486.16,2,21139479,14433,21125046,5738,52.55,87.71,193486.16,1,13.26,16.32,0.07
2207,0,21134334,9288,85.07,193571.23,2,21144123,9789,21134334,9288,85.07,87.71,193571.23,0,12.64,16.32,0.04
2208,0,21154472,20138,184.45,193755.67,2,21154472,0,21154472,20138,184.45,87.75,193755.67,1,12.79,16.32,0.08
2209,0,21185407,30935,283.35,194039.02,2,21185407,0,21185407,30935,283.34,87.84,194039.02,0,12.21,16.32,0.05
2210,0,21216219,30812,282.21,194321.23,2,21216219,0,21216219,30812,282.21,87.93,194321.23,1,13.00,16.32,0.09
2211,0,21246097,29878,273.64,194594.86,2,21246097,0,21246097,29878,273.66,88.01,194594.86,0,14.40,16.32,0.06
2212,0,21246097,0,0.00,194594.86,2,21256410,10313,21246097,0,0.00,87.97,194594.86,1,16.33,15.33,0.11
2213,0,21246097,0,0.00,194594.86,2,21262301,16204,21246097,0,0.00,87.93,194594.86,0,15.93,14.93,0.05
2214,0,21246097,0,0.00,194594.86,2,21266712,20615,21246097,0,0.00,87.89,194594.86,1,15.93,14.93,0.09
2215,0,21246097,0,0.00,194594.86,2,21270475,24378,21246097,0,0.00,87.85,194594.86,0,15.81,14.81,0.07
2216,0,21246097,0,0.00,194594.86,2,21273801,27704,21246097,0,0.00,87.81,194594.86,1,16.19,15.19,0.11
2217,0,21252321,6224,57.01,194651.88,2,21276913,24592,21252321,6224,57.01,87.80,194651.88,0,14.31,15.19,0.03
2218,0,21258467,6146,56.31,194708.19,2,21279986,21519,21258467,6146,56.29,87.79,194708.19,1,14.36,15.19,0.08
2219,0,21264379,5912,54.15,194762.33,2,21282942,18563,21264379,5912,54.15,87.77,194762.33,0,13.44,15.19,0.06
2220,0,21270655,6276,57.48,194819.81,2,21286080,15425,21270655,6276,57.48,87.76,194819.81,1,13.49,15.19,0.10
2221,0,21277339,6684,61.22,194881.03,2,21289422,12083,21277339,6684,61.22,87.74,194881.03,0,12.09,15.19,0.05
2222,0,21290053,12714,116.43,194997.47,2,21295779,5726,21290053,12714,116.45,87.76,194997.47,1,12.15,15.19,0.09
2223,0,21315361,25308,231.80,195229.27,2,21315361,0,21315361,25308,231.80,87.82,195229.27,0,11.28,15.19,0.05
2224,0,21345191,29830,273.23,195502.50,2,21345191,0,21345191,29830,273.22,87.91,195502.50,1,11.78,15.19,0.10
2225,0,21376328,31137,285.18,195787.67,2,21376328,0,21376328,31137,285.19,87.99,195787.67,0,12.78,15.19,0.06
2226,0,21376328,0,0.00,195787.67,2,21386968,10640,21376328,0,0.00,87.95,195787.67,1,15.50,14.50,0.10
2227,0,21397140,20812,190.62,195978.30,2,21397374,234,21397140,20812,190.62,88.00,195978.30,0,13.84,14.50,0.03
2228,0,21429946,32806,300.47,196278.77,2,21429946,0,21429946,32806,300.47,88.10,196278.77,1,14.03,14.50,0.07
2229,0,21429946,0,0.00,196278.77,2,21440608,10662,21429946,0,0.00,88.06,196278.77,0,14.86,13.86,0.04
2230,0,21429946,0,0.00,196278.77,2,21446422,16476,21429946,0,0.00,88.02,196278.77,1,14.91,13.91,0.09
2231,0,21439742,9796,89.72,196368.48,2,21451320,11578,21439742,9796,89.72,88.02,196368.48,0,13.00,13.91,0.00
2232,0,21439742,0,0.00,196368.48,2,21455962,16220,21439742,0,0.00,87.98,196368.48,1,14.32,13.32,0.05
2233,0,21439742,0,0.00,196368.48,2,21459560,19818,21439742,0,0.00,87.94,196368.48,0,13.47,12.47,0.02
2234,0,21439742,0,0.00,196368.48,2,21462730,22988,21439742,0,0.00,87.90,196368.48,1,13.79,12.79,0.07
2235,0,21443404,3662,33.54,196402.03,2,21465740,22336,21443404,3662,33.54,87.88,196402.03,0,13.50,12.50,0.07
2236,0,21443404,0,0.00,196402.03,2,21468560,25156,21443404,0,0.00,87.84,196402.03,1,13.53,12.53,0.04
2237,0,21443404,0,0.00,196402.03,2,21471206,27802,21443404,0,0.00,87.80,196402.03,0,12.58,11.58,0.04
2238,0,21443404,0,0.00,196402.03,2,21473536,30132,21443404,0,0.00,87.76,196402.03,1,12.58,11.58,0.04
2239,0,21447958,4554,41.71,196443.73,2,21475813,27855,21447958,4554,41.71,87.74,196443.73,0,11.13,11.58,0.04
2240,0,21452800,4842,44.35,196488.09,2,21478234,25434,21452800,4842,44.35,87.72,196488.09,1,11.17,11.58,0.04
2241,0,21458072,5272,48.29,196536.38,2,21480870,22798,21458072,5272,48.29,87.70,196536.38,0,10.54,11.58,0.04
2242,0,21463490,5418,49.62,196586.00,2,21483579,20089,21463490,5418,49.62,87.68,196586.00,1,10.59,11.58,0.04
2243,0,21469100,5610,51.38,196637.38,2,21486384,17284,21469100,5610,51.38,87.67,196637.38,1,10.20,11.58,0.00
2244,0,21475270,6170,56.51,196693.89,2,21489469,14199,21475270,6170,56.51,87.65,196693.89,0,9.25,11.58,0.00
2245,0,21484920,9650,88.39,196782.28,2,21494294,9374,21484920,9650,88.39,87.65,196782.28,1,9.31,11.58,0.04
2246,0,21508257,23337,213.74,196996.02,2,21508257,0,21508257,23337,213.75,87.71,196996.02,0,8.04,11.58,0.00
2247,0,21541645,33388,305.80,197301.81,2,21541645,0,21541645,33388,305.80,87.81,197301.81,1,10.27,11.58,0.04
2248,0,21541645,0,0.00,197301.81,2,21552327,10682,21541645,0,0.00,87.77,197301.81,0,11.73,10.73,0.03
2249,0,21541645,0,0.00,197301.81,2,21558308,16663,21541645,0,0.00,87.73,197301.81,1,11.86,10.86,0.08
2250,0,21551821,10176,93.20,197395.02,2,21563396,11575,21551821,10176,93.20,87.73,197395.02,0,10.59,10.86,0.04
2251,0,21568017,16196,148.34,197543.36,2,21571494,3477,21568017,16196,148.34,87.76,197543.36,0,10.75,10.86,0.08
2252,0,21568017,0,0.00,197543.36,2,21580441,12424,21568017,0,0.00,87.72,197543.36,1,11.79,10.79,0.13
2253,0,21568017,0,0.00,197543.36,2,21585914,17897,21568017,0,0.00,87.68,197543.36,0,11.24,10.24,0.08
2254,0,21568017,0,0.00,197543.36,2,21589209,21192,21568017,0,0.00,87.64,197543.36,1,11.51,10.51,0.12
2255,0,21574305,6288,57.59,197600.95,2,21592353,18048,21574305,6288,57.59,87.63,197600.95,0,9.52,10.51,0.02
2256,0,21582319,8014,73.42,197674.38,2,21596360,14041,21582319,8014,73.40,87.62,197674.38,1,9.85,10.51,0.07
2257,0,21594551,12232,112.03,197786.41,2,21602476,7925,21594551,12232,112.03,87.63,197786.41,0,8.65,10.51,0.03
2258,0,21620440,25889,237.11,198023.52,2,21620440,0,21620440,25889,237.12,87.70,198023.52,0,8.76,10.51,0.07
2259,0,21654932,34492,315.92,198339.44,2,21654932,0,21654932,34492,315.92,87.80,198339.44,1,9.61,10.51,0.12
2260,0,21689491,34559,316.54,198655.97,2,21689491,0,21689491,34559,316.53,87.90,198655.97,1,8.91,10.51,0.04
2261,0,21689491,0,0.00,198655.97,2,21700119,10628,21689491,0,0.00,87.86,198655.97,0,13.82,12.82,0.04
2262,0,21689491,0,0.00,198655.97,2,21705942,16451,21689491,0,0.00,87.82,198655.97,1,13.82,12.82,0.04
2263,0,21699605,10114,92.62,198748.58,2,21710999,11394,21699605,10114,92.64,87.83,198748.58,0,12.50,12.82,0.00
2264,0,21716851,17246,157.98,198906.56,2,21719622,2771,21716851,17246,157.96,87.86,198906.56,1,12.59,12.82,0.05
2265,0,21739313,22462,205.71,199112.28,2,21743263,3950,21739313,22462,205.73,87.91,199112.28,0,12.84,11.84,0.05
2266,0,21739313,0,0.00,199112.28,2,21752208,12895,21739313,0,0.00,87.87,199112.28,1,13.04,12.04,0.04
2267,0,21756529,17216,157.68,199269.95,2,21760816,4287,21756529,17216,157.68,87.90,199269.95,0,11.77,12.04,0.04
2268,0,21787607,31078,284.66,199554.62,2,21787607,0,21787607,31078,284.65,87.99,199554.62,1,11.93,12.04,0.04
2269,0,21794063,6456,59.13,199613.75,2,21803007,8944,21794063,6456,59.13,87.97,199613.75,0,14.04,13.04,0.04
2270,0,21794063,0,0.00,199613.75,2,21809438,15375,21794063,0,0.00,87.94,199613.75,1,14.09,13.09,0.04
2271,0,21801815,7752,71.00,199684.75,2,21815143,13328,21801815,7752,71.00,87.93,199684.75,0,13.42,12.42,0.04
2272,0,21801815,0,0.00,199684.75,2,21819614,17799,21801815,0,0.00,87.89,199684.75,1,13.49,12.49,0.04
2273,0,21804544,2729,24.99,199709.73,2,21823411,18867,21804544,2729,25.00,87.86,199709.73,0,12.67,11.67,0.04
2274,0,21804544,0,0.00,199709.73,2,21826436,21892,21804544,0,0.00,87.82,199709.73,1,12.70,11.70,0.04
2275,0,21810506,5962,54.61,199764.34,2,21829417,18911,21810506,5962,54.61,87.81,199764.34,0,11.22,11.70,0.04
2276,0,21817022,6516,59.68,199824.03,2,21832675,15653,21817022,6516,59.68,87.80,199824.03,1,11.28,11.70,0.04
2277,0,21825822,8800,80.60,199904.62,2,21837075,11253,21825822,8800,80.60,87.79,199904.62,0,9.52,11.70,0.04
2278,0,21845112,19290,176.68,200081.31,2,21846720,1608,21845112,19290,176.68,87.83,200081.31,0,9.60,11.70,0.04
2279,0,21878190,33078,302.96,200384.27,2,21878190,0,21878190,33078,302.96,87.93,200384.27,1,10.51,11.70,0.09
2280,0,21911492,33302,305.02,200689.28,2,21911492,0,21911492,33302,305.02,88.02,200689.28,0,10.01,11.70,0.02
2281,0,21944189,32697,299.47,200988.75,2,21944189,0,21944189,32697,299.47,88.11,200988.75,1,11.17,11.70,0.07
2282,0,21976320,32131,294.30,201283.05,2,21976577,257,21976320,32131,294.29,88.20,201283.05,0,11.94,10.94,0.07
2283,0,21976320,0,0.00,201283.05,2,21986939,10619,21976320,0,0.00,88.17,201283.05,1,12.23,11.23,0.04
2284,0,21996754,20434,187.16,201470.20,2,21997156,402,21996754,20434,187.16,88.21,201470.20,1,9.45,11.23,0.04
2285,0,22030993,34239,313.59,201783.80,2,22030993,0,22030993,34239,313.60,88.31,201783.80,0,9.64,11.23,0.04
2286,0,22030993,0,0.00,201783.80,2,22041607,10614,22030993,0,0.00,88.27,201783.80,1,14.65,13.65,0.09
2287,0,22030993,0,0.00,201783.80,2,22047468,16475,22030993,0,0.00,88.23,201783.80,0,14.49,13.49,0.03
2288,0,22030993,0,0.00,201783.80,2,22051676,20683,22030993,0,0.00,88.19,201783.80,1,14.94,13.94,0.07
2289,0,22039475,8482,77.71,201861.50,2,22055917,16442,22039475,8482,77.69,88.19,201861.50,0,13.45,13.94,0.02
2290,0,22048377,8902,81.52,201943.02,2,22060368,11991,22048377,8902,81.53,88.18,201943.02,1,13.53,13.94,0.07
2291,0,22062547,14170,129.80,202072.83,2,22067453,4906,22062547,14170,129.78,88.20,202072.83,0,12.14,13.94,0.02
2292,0,22093035,30488,279.24,202352.06,2,22093035,0,22093035,30488,279.24,88.29,202352.06,1,13.37,13.94,0.06
2293,0,22100408,7373,67.52,202419.58,2,22109348,8940,22100408,7373,67.53,88.28,202419.58,0,14.58,13.58,0.06
2294,0,22100408,0,0.00,202419.58,2,22115607,15199,22100408,0,0.00,88.24,202419.58,1,14.64,13.64,0.04
2295,0,22107043,6635,60.78,202480.36,2,22121170,14127,22107043,6635,60.77,88.23,202480.36,0,13.70,12.70,0.04
2296,0,22107043,0,0.00,202480.36,2,22125636,18593,22107043,0,0.00,88.19,202480.36,1,13.76,12.76,0.04
2297,0,22115051,8008,73.35,202553.70,2,22129640,14589,22115051,8008,73.35,88.18,202553.70,0,12.43,12.76,0.04
2298,0,22125167,10116,92.65,202646.36,2,22134698,9531,22125167,10116,92.65,88.18,202646.36,1,12.50,12.76,0.04
2299,0,22148779,23612,216.26,202862.62,2,22148779,0,22148779,23612,216.26,88.24,202862.62,0,11.94,12.76,0.04
2300,0,22180850,32071,293.73,203156.36,2,22180850,0,22180850,32071,293.74,88.33,203156.36,1,12.15,12.76,0.04
2301,0,22213317,32467,297.36,203453.72,2,22213317,0,22213317,32467,297.37,88.42,203453.72,0,12.48,12.76,0.04
2302,0,22213317,0,0.00,203453.72,2,22223874,10557,22213317,0,0.00,88.38,203453.72,1,12.77,11.77,0.04
2303,0,22213317,0,0.00,203453.72,2,22229606,16289,22213317,0,0.00,88.34,203453.72,0,11.96,10.96,0.04
2304,0,22213317,0,0.00,203453.72,2,22234225,20908,22213317,0,0.00,88.30,203453.72,1,11.96,10.96,0.04
2305,0,22213317,0,0.00,203453.72,2,22238291,24974,22213317,0,0.00,88.27,203453.72,0,11.17,10.17,0.04
2306,0,22213317,0,0.00,203453.72,2,22241679,28362,22213317,0,0.00,88.23,203453.72,1,11.17,10.17,0.04
2307,0,22219711,6394,58.58,203512.30,2,22244876,25165,22219711,6394,58.56,88.22,203512.30,0,9.13,10.17,0.04
2308,0,22226413,6702,61.37,203573.67,2,22248227,21814,22226413,6702,61.38,88.20,203573.67,1,9.18,10.17,0.04
2309,0,22233067,6654,60.96,203634.62,2,22251554,18487,22233067,6654,60.94,88.19,203634.62,0,7.80,10.17,0.04
2310,0,22239577,6510,59.61,203694.23,2,22254809,15232,22239577,6510,59.63,88.18,203694.23,1,7.86,10.17,0.04
2311,0,22246457,6880,63.01,203757.25,2,22258249,11792,22246457,6880,63.01,88.17,203757.25,0,5.39,10.17,0.04
2312,0,22261065,14608,133.80,203891.05,2,22265553,4488,22261065,14608,133.80,88.19,203891.05,1,5.45,10.17,0.04
2313,0,22267059,5994,54.92,203945.97,2,22276137,9078,22267059,5994,54.90,88.17,203945.97,0,10.74,9.74,0.04
2314,0,22267059,0,0.00,203945.97,2,22281935,14876,22267059,0,0.00,88.14,203945.97,1,10.79,9.79,0.04
2315,0,22271115,4056,37.15,203983.11,2,22286673,15558,22271115,4056,37.15,88.11,203983.11,0,10.68,9.68,0.04
2316,0,22271115,0,0.00,203983.11,2,22290126,19011,22271115,0,0.00,88.08,203983.11,1,10.72,9.72,0.04
2317,0,22277871,6756,61.88,204045.00,2,22293504,15633,22277871,6756,61.88,88.06,204045.00,0,9.67,9.72,0.00
2318,0,22277871,0,0.00,204045.00,2,22296958,19087,22277871,0,0.00,88.03,204045.00,1,9.73,8.73,0.05
2319,0,22284787,6916,63.34,204108.34,2,22300416,15629,22284787,6916,63.34,88.02,204108.34,0,8.59,8.73,0.05
2320,0,22295527,10740,98.37,204206.70,2,22305786,10259,22295527,10740,98.37,88.02,204206.70,1,8.65,8.73,0.04
2321,0,22315211,19684,180.29,204387.00,2,22315628,417,22315211,19684,180.29,88.06,204387.00,0,7.87,8.73,0.01
2322,0,22348567,33356,305.51,204692.50,2,22348567,0,22348567,33356,305.51,88.15,204692.50,1,8.04,8.73,0.05
2323,0,22378841,30274,277.26,204969.77,2,22378841,0,22378841,30274,277.28,88.23,204969.77,0,7.76,8.73,0.01
2324,0,22378841,0,0.00,204969.77,2,22389742,10901,22378841,0,0.00,88.20,204969.77,1,10.07,9.07,0.05
2325,0,22402146,23305,213.46,205183.23,2,22402146,0,22402146,23305,213.45,88.25,205183.23,0,8.45,9.07,0.05
2326,0,22437174,35028,320.82,205504.05,2,22437174,0,22437174,35028,320.82,88.35,205504.05,1,8.66,9.07,0.04
2327,0,22437174,0,0.00,205504.05,2,22447941,10767,22437174,0,0.00,88.31,205504.05,0,11.12,10.12,0.04
2328,0,22437174,0,0.00,205504.05,2,22453859,16685,22437174,0,0.00,88.27,205504.05,1,11.12,10.12,0.04
2329,0,22441052,3878,35.52,205539.58,2,22458780,17728,22441052,3878,35.52,88.25,205539.58,0,11.44,10.44,0.04
2330,0,22441052,0,0.00,205539.58,2,22462871,21819,22441052,0,0.00,88.21,205539.58,1,11.48,10.48,0.04
2331,0,22448204,7152,65.51,205605.08,2,22466447,18243,22448204,7152,65.51,88.20,205605.08,0,9.81,10.48,0.04
2332,0,22455346,7142,65.41,205670.50,2,22470018,14672,22455346,7142,65.41,88.19,205670.50,1,9.87,10.48,0.04
2333,0,22464242,8896,81.48,205751.97,2,22474466,10224,22464242,8896,81.48,88.19,205751.97,0,8.61,10.48,0.00
2334,0,22484998,20756,190.11,205942.08,2,22484998,0,22484998,20756,190.11,88.24,205942.08,1,10.01,10.48,0.05
2335,0,22518838,33840,309.94,206252.02,2,22518838,0,22518838,33840,309.94,88.33,206252.02,0,9.04,10.48,0.05
2336,0,22553136,34298,314.14,206566.16,2,22553136,0,22553136,34298,314.14,88.43,206566.16,1,9.34,10.48,0.04
2337,0,22587171,34035,311.74,206877.91,2,22587171,0,22587171,34035,311.73,88.52,206877.91,0,10.27,10.48,0.04
2338,0,22587171,0,0.00,206877.91,2,22597914,10743,22587171,0,0.00,88.48,206877.91,0,10.57,9.57,0.04
2339,0,22587171,0,0.00,206877.91,2,22603650,16479,22587171,0,0.00,88.45,206877.91,1,11.20,10.20,0.09
2340,0,22597323,10152,92.98,206970.88,2,22608726,11403,22597323,10152,92.98,88.45,206970.88,1,10.17,10.20,0.04
2341,0,22616685,19362,177.32,207148.20,2,22618407,1722,22616685,19362,177.34,88.49,207148.20,0,9.15,10.20,0.04
2342,0,22650987,34302,314.19,207462.39,2,22650987,0,22650987,34302,314.18,88.58,207462.39,1,9.32,10.20,0.04
2343,0,22658672,7685,70.38,207532.78,2,22667520,8848,22658672,7685,70.39,88.58,207532.78,0,12.07,11.07,0.04
2344,0,22658672,0,0.00,207532.78,2,22673996,15324,22658672,0,0.00,88.54,207532.78,1,12.13,11.13,0.04
2345,0,22658834,162,1.48,207534.25,2,22678629,19795,22658834,162,1.48,88.50,207534.25,0,12.09,11.09,0.04
2346,0,22658834,0,0.00,207534.25,2,22682699,23865,22658834,0,0.00,88.46,207534.25,1,12.09,11.09,0.04
2347,0,22658834,0,0.00,207534.25,2,22686350,27516,22658834,0,0.00,88.43,207534.25,0,11.51,10.51,0.04
2348,0,22658834,0,0.00,207534.25,2,22689483,30649,22658834,0,0.00,88.39,207534.25,1,11.51,10.51,0.04
2349,0,22664820,5986,54.83,207589.08,2,22692476,27656,22664820,5986,54.83,88.37,207589.08,0,9.60,10.51,0.04
2350,0,22671086,6266,57.39,207646.47,2,22695609,24523,22671086,6266,57.39,88.36,207646.47,1,9.65,10.51,0.04
2351,0,22677388,6302,57.72,207704.20,2,22698760,21372,22677388,6302,57.72,88.35,207704.20,0,8.43,10.51,0.01
2352,0,22683564,6176,56.57,207760.77,2,22701848,18284,22683564,6176,56.57,88.33,207760.77,1,8.49,10.51,0.05
2353,0,22689602,6038,55.30,207816.06,2,22704867,15265,22689602,6038,55.30,88.32,207816.06,1,6.90,10.51,0.05
2354,0,22696324,6722,61.57,207877.62,2,22708228,11904,22696324,6722,61.57,88.31,207877.62,0,6.96,10.51,0.04
2355,0,22712054,15730,144.07,208021.70,2,22716093,4039,22712054,15730,144.07,88.33,208021.70,0,7.02,10.51,0.08
2356,0,22744508,32454,297.25,208318.95,2,22744508,0,22744508,32454,297.25,88.42,208318.95,1,7.44,10.51,0.13
2357,0,22779276,34768,318.44,208637.39,2,22779276,0,22779276,34768,318.44,88.52,208637.39,0,7.31,10.51,0.04
2358,0,22813695,34419,315.26,208952.66,2,22813695,0,22813695,34419,315.25,88.61,208952.66,1,8.52,10.51,0.08
2359,0,22848090,34395,315.02,209267.67,2,22848090,0,22848090,34395,315.03,88.71,209267.67,0,9.13,10.51,0.05
2360,0,22882453,34363,314.72,209582.39,2,22882453,0,22882453,34363,314.73,88.81,209582.39,1,9.43,10.51,0.09
2361,0,22916731,34278,313.97,209896.38,2,22916731,0,22916731,34278,313.96,88.90,209896.38,0,8.03,10.51,0.03
2362,0,22916731,0,0.00,209896.38,2,22927452,10721,22916731,0,0.00,88.86,209896.38,1,14.00,13.00,0.07
2363,0,22916731,0,0.00,209896.38,2,22933125,16394,22916731,0,0.00,88.83,209896.38,0,14.75,13.75,0.04
2364,0,22916731,0,0.00,209896.38,2,22937417,20686,22916731,0,0.00,88.79,209896.38,1,14.75,13.75,0.08
2365,0,22924635,7904,72.39,209968.77,2,22941369,16734,22924635,7904,72.39,88.78,209968.77,0,12.87,13.75,0.01
2366,0,22932635,8000,73.27,210042.03,2,22945369,12734,22932635,8000,73.27,88.78,210042.03,1,12.95,13.75,0.05
2367,0,22943677,11042,101.12,210143.16,2,22950890,7213,22943677,11042,101.13,88.78,210143.16,0,11.82,13.75,0.02
2368,0,22972367,28690,262.79,210405.94,2,22972367,0,22972367,28690,262.77,88.85,210405.94,1,12.20,13.75,0.06
2369,0,22978136,5769,52.83,210458.77,2,22987419,9283,22978136,5769,52.84,88.84,210458.77,0,14.47,13.47,0.06
2370,0,22978136,0,0.00,210458.77,2,22993607,15471,22978136,0,0.00,88.80,210458.77,1,14.53,13.53,0.04
2371,0,22988827,10691,97.93,210556.70,2,22999160,10333,22988827,10691,97.92,88.81,210556.70,0,13.53,12.53,0.04
2372,0,22988827,0,0.00,210556.70,2,23004698,15871,22988827,0,0.00,88.77,210556.70,1,13.62,12.62,0.04
2373,0,22998665,9838,90.09,210646.80,2,23009617,10952,22998665,9838,90.11,88.77,210646.80,0,12.05,12.62,0.04
2374,0,23016343,17678,161.93,210808.72,2,23018456,2113,23016343,17678,161.91,88.80,210808.72,1,12.14,12.62,0.04
2375,0,23037457,21114,193.37,211002.09,2,23042699,5242,23037457,21114,193.38,88.84,211002.09,0,12.95,11.95,0.04
2376,0,23037457,0,0.00,211002.09,2,23050510,13053,23037457,0,0.00,88.81,211002.09,1,13.14,12.14,0.04
2377,0,23037457,0,0.00,211002.09,2,23055280,17823,23037457,0,0.00,88.77,211002.09,0,12.33,11.33,0.04
2378,0,23037457,0,0.00,211002.09,2,23059365,21908,23037457,0,0.00,88.73,211002.09,1,12.33,11.33,0.04
2379,0,23045191,7734,70.85,211072.94,2,23063232,18041,23045191,7734,70.84,88.72,211072.94,0,10.79,11.33,0.04
2380,0,23052989,7798,71.40,211144.34,2,23067131,14142,23052989,7798,71.42,88.72,211144.34,1,10.86,11.33,0.04
2381,0,23062101,9112,83.46,211227.81,2,23071687,9586,23062101,9112,83.46,88.71,211227.81,0,9.89,11.33,0.04
2382,0,23083353,21252,194.65,211422.45,2,23083353,0,23083353,21252,194.65,88.76,211422.45,1,9.97,11.33,0.04
2383,0,23116506,33153,303.66,211726.11,2,23116506,0,23116506,33153,303.65,88.85,211726.11,0,9.56,11.33,0.04
2384,0,23149224,32718,299.67,212025.78,2,23149224,0,23149224,32718,299.67,88.94,212025.78,1,9.86,11.33,0.04
2385,0,23182333,33109,303.24,212329.02,2,23182333,0,23182333,33109,303.25,89.03,212329.02,0,10.09,11.33,0.00
2386,0,23182333,0,0.00,212329.02,2,23192887,10554,23182333,0,0.00,88.99,212329.02,1,17.35,16.35,0.04
2387,0,23182333,0,0.00,212329.02,2,23198640,16307,23182333,0,0.00,88.95,212329.02,0,18.92,17.92,0.04
2388,0,23182333,0,0.00,212329.02,2,23202981,20648,23182333,0,0.00,88.92,212329.02,1,18.92,17.92,0.04
2389,0,23190723,8390,76.86,212405.89,2,23207176,16453,23190723,8390,76.84,88.91,212405.89,0,17.08,17.92,0.04
2390,0,23199395,8672,79.43,212485.31,2,23211512,12117,23199395,8672,79.43,88.91,212485.31,1,17.16,17.92,0.04
2391,0,23212979,13584,124.42,212609.73,2,23218304,5325,23212979,13584,124.42,88.92,212609.73,0,15.89,17.92,0.00
2392,0,23242819,29840,273.31,212883.03,2,23242819,0,23242819,29840,273.31,89.00,212883.03,1,16.61,17.92,0.04
2393,0,23273423,30604,280.30,213163.34,2,23273658,235,23273423,30604,280.30,89.08,213163.34,0,18.23,17.23,0.04
2394,0,23273423,0,0.00,213163.34,2,23284183,10760,23273423,0,0.00,89.04,213163.34,1,18.51,17.51,0.04
2395,0,23273423,0,0.00,213163.34,2,23289964,16541,23273423,0,0.00,89.00,213163.34,0,17.65,16.65,0.04
2396,0,23273423,0,0.00,213163.34,2,23294698,21275,23273423,0,0.00,88.97,213163.34,1,17.65,16.65,0.04
2397,0,23281453,8030,73.53,213236.88,2,23298713,17260,23281453,8030,73.55,88.96,213236.88,0,16.32,16.65,0.04
2398,0,23289497,8044,73.68,213310.55,2,23302735,13238,23289497,8044,73.68,88.95,213310.55,0,16.39,16.65,0.04
2399,0,23299229,9732,89.14,213399.69,2,23307601,8372,23299229,9732,89.14,88.95,213399.69,1,16.46,16.65,0.08
2400,0,23324948,25719,235.57,213635.25,2,23324948,0,23324948,25719,235.56,89.01,213635.25,0,14.93,16.65,0.03
2401,0,23357132,32184,294.78,213930.03,2,23357132,0,23357132,32184,294.78,89.10,213930.03,1,16.45,16.65,0.07
2402,0,23357132,0,0.00,213930.03,2,23367525,10393,23357132,0,0.00,89.06,213930.03,0,17.19,16.19,0.01
2403,0,23357132,0,0.00,213930.03,2,23373208,16076,23357132,0,0.00,89.03,213930.03,1,17.23,16.23,0.05
2404,0,23367052,9920,90.86,214020.89,2,23378168,11116,23367052,9920,90.86,89.03,214020.89,0,15.88,16.23,0.00
2405,0,23367052,0,0.00,214020.89,2,23382800,15748,23367052,0,0.00,88.99,214020.89,1,16.47,15.47,0.04
2406,0,23367052,0,0.00,214020.89,2,23386324,19272,23367052,0,0.00,88.95,214020.89,0,15.80,14.80,0.02
2407,0,23367052,0,0.00,214020.89,2,23389370,22318,23367052,0,0.00,88.92,214020.89,1,15.80,14.80,0.06
2408,0,23372852,5800,53.12,214074.02,2,23392270,19418,23372852,5800,53.12,88.90,214074.02,1,14.37,14.80,0.02
2409,0,23378776,5924,54.26,214128.27,2,23395232,16456,23378776,5924,54.26,88.89,214128.27,0,13.59,14.80,0.02
2410,0,23386688,7912,72.47,214200.73,2,23399188,12500,23386688,7912,72.47,88.88,214200.73,1,13.64,14.80,0.04
2411,0,23401580,14892,136.40,214337.14,2,23406634,5054,23401580,14892,136.40,88.90,214337.14,0,12.51,14.80,0.01
2412,0,23432050,30470,279.08,214616.22,2,23432050,0,23432050,30470,279.08,88.98,214616.22,1,13.56,14.80,0.05
2413,0,23463526,31476,288.29,214904.50,2,23463526,0,23463526,31476,288.29,89.06,214904.50,0,14.55,14.80,0.02
2414,0,23463526,0,0.00,214904.50,2,23473950,10424,23463526,0,0.00,89.02,214904.50,1,18.26,17.26,0.06
2415,0,23463526,0,0.00,214904.50,2,23479776,16250,23463526,0,0.00,88.99,214904.50,0,18.00,17.00,0.02
2416,0,23463526,0,0.00,214904.50,2,23484156,20630,23463526,0,0.00,88.95,214904.50,1,18.17,17.17,0.06
2417,0,23471694,8168,74.81,214979.31,2,23488240,16546,23471694,8168,74.81,88.94,214979.31,0,16.87,17.17,0.03
2418,0,23479622,7928,72.61,215051.92,2,23492204,12582,23479622,7928,72.61,88.94,215051.92,0,16.94,17.17,0.07
2419,0,23491042,11420,104.60,215156.53,2,23497914,6872,23491042,11420,104.60,88.94,215156.53,1,17.02,17.17,0.11
2420,0,23519692,28650,262.41,215418.94,2,23519692,0,23519692,28650,262.41,89.02,215418.94,0,15.95,17.17,0.08
2421,0,23519692,0,0.00,215418.94,2,23530190,10498,23519692,0,0.00,88.98,215418.94,1,18.21,17.21,0.12
2422,0,23519692,0,0.00,215418.94,2,23535867,16175,23519692,0,0.00,88.94,215418.94,0,17.77,16.77,0.09
2423,0,23519692,0,0.00,215418.94,2,23540383,20691,23519692,0,0.00,88.91,215418.94,1,19.20,18.20,0.13
2424,0,23519692,0,0.00,215418.94,2,23544374,24682,23519692,0,0.00,88.87,215418.94,1,18.44,17.44,0.09
2425,0,23519692,0,0.00,215418.94,2,23547939,28247,23519692,0,0.00,88.83,215418.94,0,17.61,16.61,0.08
2426,0,23519692,0,0.00,215418.94,2,23551199,31507,23519692,0,0.00,88.80,215418.94,1,17.61,16.61,0.12
2427,0,23525324,5632,51.58,215470.52,2,23554015,28691,23525324,5632,51.58,88.78,215470.52,0,16.40,16.61,0.09
2428,0,23525324,0,0.00,215470.52,2,23556826,31502,23525324,0,0.00,88.74,215470.52,1,16.70,15.70,0.13
2429,0,23530792,5468,50.08,215520.59,2,23559560,28768,23530792,5468,50.08,88.73,215520.59,0,15.63,15.70,0.09
2430,0,23530792,0,0.00,215520.59,2,23562234,31442,23530792,0,0.00,88.69,215520.59,1,15.93,14.93,0.13
2431,0,23535868,5076,46.49,215567.09,2,23564772,28904,23535868,5076,46.49,88.67,215567.09,0,14.36,14.93,0.07
2432,0,23540868,5000,45.80,215612.89,2,23567272,26404,23540868,5000,45.80,88.66,215612.89,1,14.41,14.93,0.12
2433,0,23545796,4928,45.14,215658.02,2,23569736,23940,23545796,4928,45.14,88.64,215658.02,0,12.62,14.93,0.05
2434,0,23550644,4848,44.40,215702.42,2,23572160,21516,23550644,4848,44.40,88.62,215702.42,1,13.09,14.93,0.09
2435,0,23555494,4850,44.42,215746.84,2,23574585,19091,23555494,4850,44.42,88.60,215746.84,0,11.87,14.93,0.04
2436,0,23560654,5160,47.26,215794.11,2,23577165,16511,23560654,5160,47.26,88.59,215794.11,1,12.03,14.93,0.08
2437,0,23566502,5848,53.56,215847.67,2,23580089,13587,23566502,5848,53.56,88.57,215847.67,0,10.36,14.93,0.02
2438,0,23577422,10920,100.02,215947.69,2,23585549,8127,23577422,10920,100.02,88.58,215947.69,0,11.10,14.93,0.06
2439,0,23600809,23387,214.19,216161.88,2,23600809,0,23600809,23387,214.20,88.63,216161.88,1,11.69,14.93,0.10
2440,0,23633344,32535,298.00,216459.88,2,23633344,0,23633344,32535,297.99,88.71,216459.88,1,11.65,14.93,0.06
2441,0,23666263,32919,301.52,216761.39,2,23666263,0,23666263,32919,301.51,88.80,216761.39,0,12.74,14.93,0.02
2442,0,23699297,33034,302.54,217063.94,2,23699297,0,23699297,33034,302.56,88.89,217063.94,1,13.41,14.93,0.06
2443,0,23732048,32751,299.98,217363.92,2,23732048,0,23732048,32751,299.97,88.97,217363.92,1,13.79,14.93,0.04
2444,0,23764815,32767,300.12,217664.05,2,23764815,0,23764815,32767,300.12,89.06,217664.05,0,14.37,14.93,0.05
2445,0,23764815,0,0.00,217664.05,2,23775273,10458,23764815,0,0.00,89.02,217664.05,1,16.68,15.68,0.09
2446,0,23764815,0,0.00,217664.05,2,23781136,16321,23764815,0,0.00,88.99,217664.05,0,17.61,16.61,0.09
2447,0,23764815,0,0.00,217664.05,2,23785651,20836,23764815,0,0.00,88.95,217664.05,1,17.61,16.61,0.13
2448,0,23772973,8158,74.70,217738.75,2,23789730,16757,23772973,8158,74.72,88.95,217738.75,0,16.51,16.61,0.10
2449,0,23772973,0,0.00,217738.75,2,23793482,20509,23772973,0,0.00,88.91,217738.75,1,17.01,16.01,0.14
2450,0,23779835,6862,62.87,217801.61,2,23796913,17078,23779835,6862,62.85,88.90,217801.61,0,15.53,16.01,0.08
2451,0,23786723,6888,63.09,217864.70,2,23800357,13634,23786723,6888,63.09,88.89,217864.70,0,15.59,16.01,0.12
2452,0,23797251,10528,96.43,217961.12,2,23805621,8370,23797251,10528,96.43,88.89,217961.12,1,15.83,16.01,0.17
2453,0,23821423,24172,221.39,218182.52,2,23821423,0,23821423,24172,221.39,88.95,218182.52,0,14.93,16.01,0.09
2454,0,23821423,0,0.00,218182.52,2,23832182,10759,23821423,0,0.00,88.91,218182.52,1,16.74,15.74,0.13
2455,0,23842499,21076,193.04,218375.56,2,23842720,221,23842499,21076,193.04,88.95,218375.56,0,14.78,15.74,0.01
2456,0,23875991,33492,306.76,218682.31,2,23875991,0,23875991,33492,306.76,89.04,218682.31,1,15.01,15.74,0.05
2457,0,23908702,32711,299.59,218981.91,2,23908702,0,23908702,32711,299.60,89.13,218981.91,0,15.18,15.74,0.05
2458,0,23941280,32578,298.38,219280.30,2,23941280,0,23941280,32578,298.38,89.21,219280.30,0,15.47,15.74,0.04
2459,0,23941280,0,0.00,219280.30,2,23951848,10568,23941280,0,0.00,89.17,219280.30,0,17.31,16.31,0.08
2460,0,23941280,0,0.00,219280.30,2,23957774,16494,23941280,0,0.00,89.14,219280.30,1,17.70,16.70,0.12
2461,0,23951792,10512,96.28,219376.58,2,23963030,11238,23951792,10512,96.28,89.14,219376.58,1,15.36,16.70,0.02
2462,0,23969794,18002,164.88,219541.45,2,23972031,2237,23969794,18002,164.88,89.17,219541.45,0,13.39,16.70,0.02
2463,0,24002139,32345,296.26,219837.72,2,24002139,0,24002139,32345,296.25,89.26,219837.72,0,13.55,16.70,0.04
2464,0,24034761,32622,298.77,220136.48,2,24034761,0,24034761,32622,298.79,89.34,220136.48,1,14.59,16.70,0.08
2465,0,24064114,29353,268.86,220405.34,2,24065684,1570,24064114,29353,268.85,89.41,220405.34,1,19.37,18.37,0.08
2466,0,24064114,0,0.00,220405.34,2,24075254,11140,24064114,0,0.00,89.38,220405.34,0,19.64,18.64,0.04
2467,0,24064114,0,0.00,220405.34,2,24080896,16782,24064114,0,0.00,89.34,220405.34,1,21.02,19.00,0.08
2468,0,24064114,0,0.00,220405.34,2,24085497,21383,24064114,0,0.00,89.31,220405.34,1,19.20,18.20,0.01
2469,0,24072578,8464,77.52,220482.86,2,24089729,17151,24072578,8464,77.52,89.30,220482.86,0,17.70,18.20,0.01
2470,0,24081006,8428,77.19,220560.06,2,24093943,12937,24081006,8428,77.19,89.30,220560.06,1,17.78,18.20,0.04
2471,0,24090728,9722,89.04,220649.09,2,24098804,8076,24090728,9722,89.04,89.30,220649.09,0,16.26,18.20,0.04
2472,0,24115965,25237,231.14,220880.23,2,24115965,0,24115965,25237,231.15,89.35,220880.23,1,16.35,18.20,0.04
2473,0,24139423,23458,214.87,221095.11,2,24143398,3975,24139423,23458,214.85,89.40,221095.11,0,18.27,17.27,0.04
2474,0,24139423,0,0.00,221095.11,2,24151868,12445,24139423,0,0.00,89.37,221095.11,1,18.48,17.48,0.04
2475,0,24155349,15926,145.85,221240.97,2,24159831,4482,24155349,15926,145.87,89.39,221240.97,0,17.08,17.48,0.04
2476,0,24185354,30005,274.83,221515.78,2,24185354,0,24185354,30005,274.82,89.47,221515.78,0,17.22,17.48,0.04
2477,0,24185354,0,0.00,221515.78,2,24195785,10431,24185354,0,0.00,89.43,221515.78,1,19.75,18.75,0.08
2478,0,24185354,0,0.00,221515.78,2,24201579,16225,24185354,0,0.00,89.39,221515.78,0,19.50,18.50,0.08
2479,0,24185354,0,0.00,221515.78,2,24206109,20755,24185354,0,0.00,89.36,221515.78,1,19.50,18.50,0.04
2480,0,24185642,288,2.64,221518.42,2,24210145,24503,24185642,288,2.64,89.32,221518.42,0,19.25,18.25,0.04
2481,0,24185642,0,0.00,221518.42,2,24213724,28082,24185642,0,0.00,89.29,221518.42,1,19.25,18.25,0.04
2482,0,24192368,6726,61.60,221580.03,2,24217087,24719,24192368,6726,61.60,89.27,221580.03,1,15.99,18.25,0.04
2483,0,24199074,6706,61.42,221641.45,2,24220440,21366,24199074,6706,61.42,89.26,221641.45,0,16.05,18.25,0.04
2484,0,24205572,6498,59.52,221700.97,2,24223689,18117,24205572,6498,59.52,89.25,221700.97,1,16.37,18.25,0.08
2485,0,24211680,6108,55.94,221756.91,2,24226743,15063,24211680,6108,55.94,89.24,221756.91,1,16.37,18.25,0.05
2486,0,24218286,6606,60.50,221817.42,2,24230046,11760,24218286,6606,60.50,89.23,221817.42,0,15.68,18.25,0.01
2487,0,24232538,14252,130.54,221947.95,2,24237172,4634,24232538,14252,130.54,89.24,221947.95,1,15.74,18.25,0.05
2488,0,24263787,31249,286.22,222234.17,2,24263787,0,24263787,31249,286.21,89.32,222234.17,0,15.23,18.25,0.05
2489,0,24296424,32637,298.92,222533.09,2,24296424,0,24296424,32637,298.93,89.41,222533.09,1,15.51,18.25,0.04
2490,0,24328572,32148,294.45,222827.53,2,24328572,0,24328572,32148,294.45,89.49,222827.53,0,14.75,18.25,0.04
2491,0,24361589,33017,302.40,223129.94,2,24361589,0,24361589,33017,302.41,89.57,223129.94,0,15.04,18.25,0.04
2492,0,24361589,0,0.00,223129.94,2,24372313,10724,24361589,0,0.00,89.54,223129.94,1,20.40,19.40,0.08
2493,0,24366737,5148,47.15,223177.08,2,24380049,13312,24366737,5148,47.15,89.52,223177.08,0,19.68,18.68,0.08
2494,0,24366737,0,0.00,223177.08,2,24384658,17921,24366737,0,0.00,89.49,223177.08,1,19.73,18.73,0.04
2495,0,24374519,7782,71.29,223248.38,2,24388549,14030,24374519,7782,71.28,89.48,223248.38,0,18.08,18.73,0.04
2496,0,24386297,11778,107.86,223356.23,2,24394438,8141,24386297,11778,107.88,89.49,223356.23,1,18.15,18.73,0.04
2497,0,24411177,24880,227.88,223584.11,2,24411177,0,24411177,24880,227.88,89.54,223584.11,0,17.03,18.73,0.04
2498,0,24443441,32264,295.51,223879.62,2,24443441,0,24443441,32264,295.51,89.62,223879.62,0,17.25,18.73,0.04
2499,0,24475970,32529,297.95,224177.56,2,24475970,0,24475970,32529,297.94,89.71,224177.56,1,17.82,18.73,0.08
2500,0,24475970,0,0.00,224177.56,2,24486447,10477,24475970,0,0.00,89.67,224177.56,0,19.75,18.75,0.04
2501,0,24475970,0,0.00,224177.56,2,24492171,16201,24475970,0,0.00,89.64,224177.56,1,20.75,19.75,0.08
2502,0,24486500,10530,96.45,224274.02,2,24497436,10936,24486500,10530,96.45,89.64,224274.02,0,18.63,19.75,0.08
2503,0,24506128,19628,179.77,224453.78,2,24507250,1122,24506128,19628,179.77,89.67,224453.78,1,18.72,19.75,0.04
2504,0,24538530,32402,296.77,224750.56,2,24538530,0,24538530,32402,296.77,89.76,224750.56,1,16.03,19.75,0.04
2505,0,24569719,31189,285.67,225036.23,2,24569719,0,24569719,31189,285.66,89.83,225036.23,0,16.32,19.75,0.04
2506,0,24598230,28511,261.13,225297.36,2,24598230,0,24598230,28511,261.13,89.90,225297.36,1,18.82,19.75,0.08
2507,0,24629321,31091,284.76,225582.11,2,24629321,0,24629321,31091,284.77,89.98,225582.11,0,18.91,19.75,0.02
2508,0,24629321,0,0.00,225582.11,2,24640115,10794,24629321,0,0.00,89.95,225582.11,1,20.89,19.89,0.06
2509,0,24629321,0,0.00,225582.11,2,24645815,16494,24629321,0,0.00,89.91,225582.11,0,21.31,19.00,0.06
2510,0,24629321,0,0.00,225582.11,2,24650354,21033,24629321,0,0.00,89.87,225582.11,1,21.31,19.00,0.04
2511,0,24629321,0,0.00,225582.11,2,24654238,24917,24629321,0,0.00,89.84,225582.11,0,21.25,19.00,0.04
2512,0,24629321,0,0.00,225582.11,2,24657844,28523,24629321,0,0.00,89.80,225582.11,1,21.25,19.00,0.04
2513,0,24636107,6786,62.17,225644.28,2,24661237,25130,24636107,6786,62.15,89.79,225644.28,1,17.32,19.00,0.04
2514,0,24642689,6582,60.27,225704.55,2,24664528,21839,24642689,6582,60.29,89.78,225704.55,0,17.38,19.00,0.04
2515,0,24649163,6474,59.31,225763.86,2,24667765,18602,24649163,6474,59.30,89.77,225763.86,0,17.44,19.00,0.08
2516,0,24649163,0,0.00,225763.86,2,24670778,21615,24649163,0,0.00,89.73,225763.86,1,19.20,18.20,0.12
2517,0,24654405,5242,47.99,225811.86,2,24673399,18994,24654405,5242,48.01,89.71,225811.86,0,16.98,18.20,0.02
2518,0,24659797,5392,49.39,225861.25,2,24676095,16298,24659797,5392,49.39,89.70,225861.25,0,17.03,18.20,0.06
2519,0,24666075,6278,57.52,225918.77,2,24679234,13159,24666075,6278,57.50,89.69,225918.77,1,17.07,18.20,0.10
2520,0,24678485,12410,113.65,226032.41,2,24685439,6954,24678485,12410,113.66,89.70,226032.41,0,15.61,18.20,0.05
2521,0,24704983,26498,242.72,226275.12,2,24704983,0,24704983,26498,242.70,89.76,226275.12,1,16.15,18.20,0.09
2522,0,24740710,35727,327.22,226602.34,2,24740710,0,24740710,35727,327.23,89.85,226602.34,0,15.91,18.20,0.09
2523,0,24775680,34970,320.29,226922.64,2,24775680,0,24775680,34970,320.29,89.94,226922.64,0,16.23,18.20,0.04
2524,0,24810722,35042,320.95,227243.59,2,24810722,0,24810722,35042,320.95,90.03,227243.59,1,17.67,18.20,0.08
2525,0,24822160,11438,104.76,227348.34,2,24823632,1472,24822160,11438,104.76,90.04,227348.34,1,19.28,18.28,0.08
2526,0,24822160,0,0.00,227348.34,2,24833710,11550,24822160,0,0.00,90.00,227348.34,0,19.38,18.38,0.04
2527,0,24822160,0,0.00,227348.34,2,24838914,16754,24822160,0,0.00,89.97,227348.34,1,19.83,18.83,0.08
2528,0,24831914,9754,89.34,227437.69,2,24843791,11877,24831914,9754,89.34,89.97,227437.69,0,17.55,18.83,0.08
2529,0,24850230,18316,167.76,227605.45,2,24852949,2719,24850230,18316,167.76,90.00,227605.45,1,17.64,18.83,0.04
2530,0,24884417,34187,313.11,227918.56,2,24884417,0,24884417,34187,313.12,90.09,227918.56,1,16.59,18.83,0.01
2531,0,24893225,8808,80.67,227999.23,2,24902505,9280,24893225,8808,80.67,90.08,227999.23,0,21.00,19.00,0.01
2532,0,24893225,0,0.00,227999.23,2,24909317,16092,24893225,0,0.00,90.05,227999.23,1,21.08,19.00,0.04
2533,0,24893225,0,0.00,227999.23,2,24914244,21019,24893225,0,0.00,90.01,227999.23,0,21.38,19.00,0.04
2534,0,24893225,0,0.00,227999.23,2,24918456,25231,24893225,0,0.00,89.98,227999.23,1,21.38,19.00,0.04
2535,0,24893225,0,0.00,227999.23,2,24922313,29088,24893225,0,0.00,89.94,227999.23,0,19.96,18.96,0.04
2536,0,24893225,0,0.00,227999.23,2,24925873,32648,24893225,0,0.00,89.91,227999.23,1,19.96,18.96,0.04
2537,0,24899275,6050,55.43,228054.66,2,24928898,29623,24899275,6050,55.41,89.89,228054.66,0,18.39,18.96,0.04
2538,0,24904423,5148,47.15,228101.81,2,24931472,27049,24904423,5148,47.15,89.87,228101.81,1,18.44,18.96,0.04
2539,0,24909777,5354,49.02,228150.83,2,24934149,24372,24909777,5354,49.04,89.86,228150.83,0,16.88,18.96,0.04
2540,0,24915279,5502,50.41,228201.25,2,24936900,21621,24915279,5502,50.39,89.84,228201.25,1,16.93,18.96,0.04
2541,0,24920691,5412,49.57,228250.81,2,24939606,18915,24920691,5412,49.57,89.83,228250.81,0,15.22,18.96,0.04
2542,0,24926033,5342,48.91,228299.72,2,24942277,16244,24926033,5342,48.93,89.81,228299.72,1,15.27,18.96,0.04
2543,0,24931653,5620,51.47,228351.20,2,24945087,13434,24931653,5620,51.47,89.80,228351.20,0,13.37,18.96,0.04
2544,0,24940067,8414,77.08,228428.28,2,24949294,9227,24940067,8414,77.06,89.79,228428.28,1,13.42,18.96,0.04
2545,0,24957647,17580,161.02,228589.30,2,24958084,437,24957647,17580,161.02,89.82,228589.30,0,13.65,18.96,0.04
2546,0,24979366,21719,198.92,228788.22,2,24979366,0,24979366,21719,198.93,89.86,228788.22,1,13.80,18.96,0.04
2547,0,25001635,22269,203.97,228992.19,2,25001635,0,25001635,22269,203.96,89.91,228992.19,0,14.15,18.96,0.04
2548,0,25024415,22780,208.64,229200.83,2,25024415,0,25024415,22780,208.64,89.95,229200.83,1,14.35,18.96,0.04
2549,0,25046330,21915,200.71,229401.55,2,25046330,0,25046330,21915,200.72,90.00,229401.55,0,15.53,18.96,0.04
2550,0,25068527,22197,203.31,229604.86,2,25068527,0,25068527,22197,203.30,90.04,229604.86,1,15.72,18.96,0.04
2551,0,25091913,23386,214.18,229819.03,2,25091913,0,25091913,23386,214.19,90.09,229819.03,0,17.26,18.96,0.04
2552,0,25114527,22614,207.14,230026.17,2,25114527,0,25114527,22614,207.12,90.14,230026.17,1,17.47,18.96,0.04
2553,0,25136596,22069,202.12,230228.30,2,25136596,0,25136596,22069,202.13,90.18,230228.30,0,17.88,18.96,0.04
2554,0,25158720,22124,202.64,230430.94,2,25158720,0,25158720,22124,202.64,90.22,230430.94,1,18.08,18.96,0.04
2555,0,25181021,22301,204.25,230635.19,2,25181021,0,25181021,22301,204.26,90.27,230635.19,0,17.99,18.96,0.04
2556,0,25203042,22021,201.70,230836.89,2,25203042,0,25203042,22021,201.69,90.31,230836.89,1,18.19,18.96,0.04
2557,0,25225221,22179,203.13,231040.02,2,25225221,0,25225221,22179,203.14,90.36,231040.02,0,18.33,18.96,0.04
2558,0,25248920,23699,217.07,231257.08,2,25248920,0,25248920,23699,217.06,90.41,231257.08,0,18.53,18.96,0.04
2559,0,25248920,0,0.00,231257.08,2,25257690,8770,25248920,0,0.00,90.37,231257.08,1,19.41,18.41,0.08
2560,0,25248920,0,0.00,231257.08,2,25263900,14980,25248920,0,0.00,90.33,231257.08,0,19.57,18.57,0.01
2561,0,25248920,0,0.00,231257.08,2,25268320,19400,25248920,0,0.00,90.30,231257.08,1,19.57,18.57,0.05
2562,0,25256878,7958,72.89,231329.97,2,25272299,15421,25256878,7958,72.89,90.29,231329.97,0,17.82,18.57,0.05
2563,0,25264992,8114,74.32,231404.28,2,25276356,11364,25264992,8114,74.32,90.29,231404.28,1,17.89,18.57,0.04
2564,0,25276748,11756,107.67,231511.97,2,25282234,5486,25276748,11756,107.67,90.29,231511.97,0,15.85,18.57,0.04
2565,0,25297768,21020,192.52,231704.48,2,25297768,0,25297768,21020,192.52,90.33,231704.48,1,15.96,18.57,0.04
2566,0,25321224,23456,214.84,231919.33,2,25321224,0,25321224,23456,214.84,90.38,231919.33,0,15.64,18.57,0.01
2567,0,25344284,23060,211.21,232130.53,2,25344284,0,25344284,23060,211.21,90.43,232130.53,1,17.25,18.57,0.05
2568,0,25366628,22344,204.65,232335.19,2,25366628,0,25366628,22344,204.65,90.47,232335.19,1,16.43,18.57,0.00
2569,0,25389019,22391,205.09,232540.27,2,25389019,0,25389019,22391,205.08,90.52,232540.27,0,16.95,18.57,0.00
2570,0,25412996,23977,219.60,232759.88,2,25412996,0,25412996,23977,219.61,90.57,232759.88,1,17.15,18.57,0.04
2571,0,25437081,24085,220.59,232980.45,2,25437081,0,25437081,24085,220.60,90.62,232980.45,0,16.02,18.57,0.00
2572,0,25460302,23221,212.69,233193.16,2,25460302,0,25460302,23221,212.68,90.67,233193.16,1,16.24,18.57,0.04
2573,0,25483755,23453,214.82,233407.97,2,25483755,0,25483755,23453,214.81,90.71,233407.97,0,16.12,18.57,0.00
2574,0,25508122,24367,223.17,233631.14,2,25508122,0,25508122,24367,223.18,90.77,233631.14,1,16.33,18.57,0.04
2575,0,25531584,23462,214.89,233846.03,2,25531584,0,25531584,23462,214.89,90.81,233846.03,0,16.55,18.57,0.00
2576,0,25554812,23228,212.75,234058.78,2,25554812,0,25554812,23228,212.75,90.86,234058.78,1,18.29,18.57,0.04
2577,0,25554812,0,0.00,234058.78,2,25564575,9763,25554812,0,0.00,90.83,234058.78,0,24.40,19.00,0.01
2578,0,25554812,0,0.00,234058.78,2,25570093,15281,25554812,0,0.00,90.79,234058.78,1,26.48,19.00,0.05
2579,0,25554812,0,0.00,234058.78,2,25574051,19239,25554812,0,0.00,90.76,234058.78,0,25.70,19.00,0.01
2580,0,25554812,0,0.00,234058.78,2,25577770,22958,25554812,0,0.00,90.72,234058.78,1,25.70,19.00,0.05
2581,0,25554812,0,0.00,234058.78,2,25581064,26252,25554812,0,0.00,90.69,234058.78,0,24.72,19.00,0.00
2582,0,25554812,0,0.00,234058.78,2,25584044,29232,25554812,0,0.00,90.65,234058.78,1,25.84,19.00,0.04
2583,0,25554812,0,0.00,234058.78,2,25586773,31961,25554812,0,0.00,90.62,234058.78,0,24.34,19.00,0.04
2584,0,25554812,0,0.00,234058.78,2,25589337,34525,25554812,0,0.00,90.58,234058.78,1,24.34,19.00,0.04
2585,0,25554812,0,0.00,234058.78,2,25591760,36948,25554812,0,0.00,90.54,234058.78,0,23.61,19.00,0.02
2586,0,25554812,0,0.00,234058.78,2,25594046,39234,25554812,0,0.00,90.51,234058.78,1,24.06,19.00,0.06
2587,0,25554812,0,0.00,234058.78,2,25596243,41431,25554812,0,0.00,90.47,234058.78,1,22.76,19.00,0.00
2588,0,25554812,0,0.00,234058.78,2,25598323,43511,25554812,0,0.00,90.44,234058.78,0,22.19,19.00,0.00
2589,0,25554812,0,0.00,234058.78,2,25600233,45421,25554812,0,0.00,90.41,234058.78,0,22.19,19.00,0.04
2590,0,25554812,0,0.00,234058.78,2,25602038,47226,25554812,0,0.00,90.37,234058.78,1,22.19,19.00,0.08
2591,0,25554812,0,0.00,234058.78,2,25603726,48914,25554812,0,0.00,90.34,234058.78,0,20.31,19.31,0.01
2592,0,25554812,0,0.00,234058.78,2,25605563,50751,25554812,0,0.00,90.30,234058.78,1,20.31,19.31,0.05
2593,0,25558466,3654,33.47,234092.25,2,25607390,48924,25558466,3654,33.47,90.28,234092.25,0,18.95,19.31,0.05
2594,0,25562110,3644,33.38,234125.62,2,25609212,47102,25562110,3644,33.38,90.26,234125.62,1,18.98,19.31,0.04
2595,0,25565762,3652,33.45,234159.06,2,25611038,45276,25565762,3652,33.45,90.23,234159.06,0,17.20,19.31,0.04
2596,0,25569392,3630,33.25,234192.31,2,25612853,43461,25569392,3630,33.25,90.21,234192.31,1,17.23,19.31,0.04
2597,0,25572902,3510,32.15,234224.47,2,25614608,41706,25572902,3510,32.15,90.19,234224.47,0,14.92,19.31,0.04
2598,0,25576564,3662,33.54,234258.00,2,25616439,39875,25576564,3662,33.54,90.17,234258.00,1,14.95,19.31,0.04
2599,0,25580202,3638,33.32,234291.33,2,25618258,38056,25580202,3638,33.32,90.15,234291.33,0,13.50,19.31,0.04
2600,0,25583842,3640,33.34,234324.66,2,25620078,36236,25583842,3640,33.34,90.12,234324.66,1,13.53,19.31,0.04
2601,0,25587560,3718,34.05,234358.72,2,25621937,34377,25587560,3718,34.05,90.10,234358.72,0,11.65,19.31,0.04
2602,0,25591180,3620,33.16,234391.88,2,25623747,32567,25591180,3620,33.16,90.08,234391.88,1,11.68,19.31,0.04
2603,0,25594778,3598,32.95,234424.83,2,25625546,30768,25594778,3598,32.95,90.06,234424.83,0,10.58,19.31,0.04
2604,0,25598510,3732,34.18,234459.02,2,25627412,28902,25598510,3732,34.18,90.04,234459.02,1,10.62,19.31,0.04
2605,0,25602126,3616,33.12,234492.12,2,25629220,27094,25602126,3616,33.12,90.02,234492.12,0,9.12,19.31,0.04
2606,0,25605732,3606,33.03,234525.16,2,25631023,25291,25605732,3606,33.03,89.99,234525.16,1,9.16,19.31,0.04
2607,0,25609242,3510,32.15,234557.30,2,25632778,23536,25609242,3510,32.15,89.97,234557.30,0,7.41,19.31,0.04
2608,0,25612870,3628,33.23,234590.53,2,25634592,21722,25612870,3628,33.23,89.95,234590.53,1,7.45,19.31,0.04
2609,0,25617006,4136,37.88,234628.42,2,25636660,19654,25617006,4136,37.88,89.93,234628.42,0,6.42,19.31,0.02
2610,0,25621410,4404,40.34,234668.75,2,25638862,17452,25621410,4404,40.34,89.91,234668.75,1,6.45,19.31,0.06
2611,0,25626366,4956,45.39,234714.14,2,25641340,14974,25626366,4956,45.39,89.89,234714.14,0,5.54,19.31,0.04
2612,0,25634508,8142,74.57,234788.72,2,25645411,10903,25634508,8142,74.57,89.89,234788.72,1,5.58,19.31,0.08
2613,0,25649542,15034,137.70,234926.42,2,25652928,3386,25649542,15034,137.70,89.91,234926.42,1,4.19,19.31,0.04
2614,0,25672726,23184,212.34,235138.77,2,25672726,0,25672726,23184,212.34,89.95,235138.77,0,3.60,19.31,0.04
2615,0,25698227,25501,233.58,235372.33,2,25698227,0,25698227,25501,233.57,90.01,235372.33,0,7.88,19.31,0.08
2616,0,25721940,23713,217.18,235589.52,2,25721940,0,25721940,23713,217.19,90.06,235589.52,1,10.18,19.31,0.11
2617,0,25745611,23671,216.81,235806.33,2,25745611,0,25745611,23671,216.80,90.11,235806.33,0,9.80,19.31,0.08
2618,0,25769734,24123,220.94,236027.27,2,25769734,0,25769734,24123,220.94,90.16,236027.27,0,12.01,19.31,0.12
2619,0,25794290,24556,224.91,236252.17,2,25794290,0,25794290,24556,224.91,90.21,236252.17,1,14.23,19.31,0.16
2620,0,25818207,23917,219.07,236471.25,2,25818207,0,25818207,23917,219.06,90.26,236471.25,1,15.07,19.31,0.16
2621,0,25841491,23284,213.26,236684.50,2,25841491,0,25841491,23284,213.26,90.30,236684.50,0,14.67,19.31,0.13
2622,0,25864885,23394,214.25,236898.75,2,25864885,0,25864885,23394,214.27,90.35,236898.75,1,16.88,19.31,0.16
2623,0,25889781,24896,228.02,237126.78,2,25889781,0,25889781,24896,228.02,90.40,237126.78,0,18.05,19.31,0.14
2624,0,25912472,22691,207.84,237334.61,2,25912472,0,25912472,22691,207.83,90.45,237334.61,1,18.69,19.31,0.18
2625,0,25935231,22759,208.46,237543.08,2,25935231,0,25935231,22759,208.45,90.49,237543.08,0,19.12,19.31,0.18
2626,0,25935231,0,0.00,237543.08,2,25945046,9815,25935231,0,0.00,90.46,237543.08,1,19.32,18.32,0.21
2627,0,25953279,18048,165.30,237708.38,2,25954070,791,25953279,18048,165.30,90.49,237708.38,0,18.18,18.32,0.19
2628,0,25953279,0,0.00,237708.38,2,25962352,9073,25953279,0,0.00,90.45,237708.38,1,18.35,17.35,0.23
2629,0,25953279,0,0.00,237708.38,2,25968219,14940,25953279,0,0.00,90.42,237708.38,1,17.53,16.53,0.20
2630,0,25953279,0,0.00,237708.38,2,25971734,18455,25953279,0,0.00,90.38,237708.38,0,16.58,15.58,0.18
2631,0,25953279,0,0.00,237708.38,2,25974582,21303,25953279,0,0.00,90.35,237708.38,0,16.58,15.58,0.22
2632,0,25953279,0,0.00,237708.38,2,25977218,23939,25953279,0,0.00,90.31,237708.38,1,16.58,15.58,0.25
2633,0,25958693,5414,49.57,237757.95,2,25979925,21232,25958693,5414,49.59,90.30,237757.95,0,14.90,15.58,0.20
2634,0,25958693,0,0.00,237757.95,2,25982585,23892,25958693,0,0.00,90.26,237757.95,1,15.80,14.80,0.24
2635,0,25958693,0,0.00,237757.95,2,25984889,26196,25958693,0,0.00,90.23,237757.95,0,15.66,14.66,0.22
2636,0,25958693,0,0.00,237757.95,2,25986876,28183,25958693,0,0.00,90.20,237757.95,1,15.94,14.94,0.26
2637,0,25963301,4608,42.21,237800.16,2,25989180,25879,25963301,4608,42.21,90.18,237800.16,0,14.54,14.94,0.22
2638,0,25968083,4782,43.82,237843.97,2,25991571,23488,25968083,4782,43.80,90.16,237843.97,1,14.58,14.94,0.26
2639,0,25972889,4806,44.00,237887.97,2,25993974,21085,25972889,4806,44.02,90.14,237887.97,0,13.39,14.94,0.23
2640,0,25977859,4970,45.54,237933.52,2,25996459,18600,25977859,4970,45.52,90.13,237933.52,1,13.92,14.94,0.27
2641,0,25983357,5498,50.34,237983.84,2,25999208,15851,25983357,5498,50.36,90.11,237983.84,0,13.65,14.94,0.24
2642,0,25989869,6512,59.64,238043.48,2,26002464,12595,25989869,6512,59.64,90.10,238043.48,1,14.38,14.94,0.27
2643,0,26002807,12938,118.52,238162.02,2,26008933,6126,26002807,12938,118.50,90.11,238162.02,0,13.45,14.94,0.25
2644,0,26024494,21687,198.62,238360.64,2,26024494,0,26024494,21687,198.63,90.15,238360.64,1,13.71,14.94,0.29
2645,0,26047585,23091,211.48,238572.12,2,26047585,0,26047585,23091,211.49,90.20,238572.12,0,14.20,14.94,0.26
2646,0,26047585,0,0.00,238572.12,2,26055976,8391,26047585,0,0.00,90.16,238572.12,1,16.41,15.41,0.29
2647,0,26069154,21569,197.56,238769.67,2,26069154,0,26069154,21569,197.55,90.20,238769.67,0,15.14,15.41,0.26
2648,0,26069154,0,0.00,238769.67,2,26079027,9873,26069154,0,0.00,90.17,238769.67,1,17.47,16.47,0.30
2649,0,26069154,0,0.00,238769.67,2,26083981,14827,26069154,0,0.00,90.14,238769.67,0,17.61,16.61,0.27
2650,0,26069154,0,0.00,238769.67,2,26088173,19019,26069154,0,0.00,90.10,238769.67,1,18.06,17.06,0.31
2651,0,26076836,7682,70.36,238840.05,2,26092014,15178,26076836,7682,70.36,90.09,238840.05,0,16.77,17.06,0.27
2652,0,26086060,9224,84.48,238924.52,2,26096626,10566,26086060,9224,84.48,90.09,238924.52,1,16.83,17.06,0.31
2653,0,26086060,0,0.00,238924.52,2,26101439,15379,26086060,0,0.00,90.06,238924.52,0,17.38,16.38,0.28
2654,0,26086060,0,0.00,238924.52,2,26104650,18590,26086060,0,0.00,90.02,238924.52,1,17.66,16.66,0.32
2655,0,26092432,6372,58.36,238982.89,2,26107836,15404,26092432,6372,58.36,90.01,238982.89,0,16.39,16.66,0.29
2656,0,26102948,10516,96.32,239079.20,2,26113094,10146,26102948,10516,96.32,90.01,239079.20,1,16.45,16.66,0.33
2657,0,26102948,0,0.00,239079.20,2,26117783,14835,26102948,0,0.00,89.98,239079.20,0,17.07,16.07,0.29
2658,0,26102948,0,0.00,239079.20,2,26121914,18966,26102948,0,0.00,89.95,239079.20,0,17.53,16.53,0.33
2659,0,26102948,0,0.00,239079.20,2,26124749,21801,26102948,0,0.00,89.91,239079.20,1,17.65,16.65,0.37
2660,0,26108384,5436,49.79,239128.98,2,26127467,19083,26108384,5436,49.79,89.90,239128.98,0,16.64,16.65,0.35
2661,0,26108384,0,0.00,239128.98,2,26130226,21842,26108384,0,0.00,89.86,239128.98,1,17.93,16.93,0.39
2662,0,26108384,0,0.00,239128.98,2,26132531,24147,26108384,0,0.00,89.83,239128.98,1,17.35,16.35,0.38
2663,0,26108384,0,0.00,239128.98,2,26134555,26171,26108384,0,0.00,89.80,239128.98,0,16.53,15.53,0.37
2664,0,26108384,0,0.00,239128.98,2,26136442,28058,26108384,0,0.00,89.76,239128.98,1,16.53,15.53,0.41
2665,0,26108384,0,0.00,239128.98,2,26138226,29842,26108384,0,0.00,89.73,239128.98,1,15.95,14.95,0.41
2666,0,26108384,0,0.00,239128.98,2,26139950,31566,26108384,0,0.00,89.70,239128.98,0,15.11,14.11,0.40
2667,0,26108384,0,0.00,239128.98,2,26141608,33224,26108384,0,0.00,89.66,239128.98,1,15.11,14.11,0.44
2668,0,26108384,0,0.00,239128.98,2,26143200,34816,26108384,0,0.00,89.63,239128.98,0,14.38,13.38,0.42
2669,0,26108384,0,0.00,239128.98,2,26144630,36246,26108384,0,0.00,89.59,239128.98,0,15.53,14.53,0.46
2670,0,26108384,0,0.00,239128.98,2,26145989,37605,26108384,0,0.00,89.56,239128.98,1,15.81,14.81,0.50
2671,0,26108384,0,0.00,239128.98,2,26147247,38863,26108384,0,0.00,89.53,239128.98,0,15.01,14.01,0.48
2672,0,26108384,0,0.00,239128.98,2,26148565,40181,26108384,0,0.00,89.49,239128.98,1,15.17,14.17,0.52
2673,0,26110976,2592,23.74,239152.73,2,26149861,38885,26110976,2592,23.74,89.47,239152.73,0,13.89,14.17,0.48
2674,0,26113864,2888,26.45,239179.19,2,26151305,37441,26113864,2888,26.45,89.45,239179.19,1,13.91,14.17,0.52
2675,0,26116944,3080,28.21,239207.39,2,26152845,35901,26116944,3080,28.21,89.42,239207.39,0,13.09,14.17,0.50
2676,0,26120148,3204,29.35,239236.73,2,26154447,34299,26120148,3204,29.35,89.40,239236.73,1,13.33,14.17,0.54
2677,0,26123462,3314,30.35,239267.09,2,26156104,32642,26123462,3314,30.35,89.38,239267.09,0,11.75,14.17,0.48
2678,0,26126872,3410,31.23,239298.33,2,26157809,30937,26126872,3410,31.23,89.36,239298.33,1,11.78,14.17,0.52
2679,0,26130404,3532,32.35,239330.67,2,26159575,29171,26130404,3532,32.35,89.34,239330.67,0,11.08,14.17,0.50
2680,0,26134164,3760,34.44,239365.11,2,26161455,27291,26134164,3760,34.44,89.32,239365.11,1,11.85,14.17,0.53
2681,0,26138082,3918,35.89,239401.00,2,26163414,25332,26138082,3918,35.89,89.30,239401.00,0,10.72,14.17,0.50
2682,0,26141766,3684,33.74,239434.73,2,26165256,23490,26141766,3684,33.74,89.27,239434.73,1,10.82,14.17,0.54
2683,0,26145646,3880,35.54,239470.28,2,26167196,21550,26145646,3880,35.54,89.25,239470.28,0,9.90,14.17,0.53
2684,0,26149600,3954,36.22,239506.48,2,26169173,19573,26149600,3954,36.22,89.23,239506.48,1,9.93,14.17,0.56
2685,0,26153808,4208,38.54,239545.03,2,26171277,17469,26153808,4208,38.54,89.22,239545.03,0,8.97,14.17,0.55
2686,0,26158698,4890,44.79,239589.83,2,26173722,15024,26158698,4890,44.79,89.20,239589.83,1,9.01,14.17,0.58
2687,0,26165826,7128,65.29,239655.11,2,26177286,11460,26165826,7128,65.29,89.19,239655.11,0,8.19,14.17,0.58
2688,0,26176756,10930,100.11,239755.22,2,26182751,5995,26176756,10930,100.11,89.19,239755.22,1,8.25,14.17,0.61
2689,0,26198494,21738,199.10,239954.31,2,26198494,0,26198494,21738,199.10,89.24,239954.31,0,7.55,14.17,0.61
2690,0,26223331,24837,227.49,240181.81,2,26223331,0,26223331,24837,227.48,89.29,240181.81,1,9.73,14.17,0.64
2691,0,26247906,24575,225.08,240406.89,2,26247906,0,26247906,24575,225.08,89.34,240406.89,0,9.88,14.17,0.63
2692,0,26273153,25247,231.23,240638.11,2,26273153,0,26273153,25247,231.24,89.39,240638.11,1,10.10,14.17,0.67
2693,0,26298116,24963,228.65,240866.77,2,26298116,0,26298116,24963,228.64,89.44,240866.77,0,9.61,14.17,0.66
2694,0,26326527,28411,260.23,241126.98,2,26326527,0,26326527,28411,260.22,89.51,241126.98,1,9.83,14.17,0.69
2695,0,26358187,31660,289.98,241416.97,2,26358187,0,26358187,31660,289.98,89.58,241416.97,0,12.13,14.17,0.68
2696,0,26358187,0,0.00,241416.97,2,26368418,10231,26358187,0,0.00,89.55,241416.97,1,14.58,13.58,0.72
2697,0,26358187,0,0.00,241416.97,2,26373806,15619,26358187,0,0.00,89.51,241416.97,0,13.68,12.68,0.71
2698,0,26358187,0,0.00,241416.97,2,26378121,19934,26358187,0,0.00,89.48,241416.97,1,15.32,14.32,0.74
2699,0,26358187,0,0.00,241416.97,2,26381944,23757,26358187,0,0.00,89.45,241416.97,0,14.61,13.61,0.73
2700,0,26358187,0,0.00,241416.97,2,26385389,27202,26358187,0,0.00,89.41,241416.97,1,14.64,13.64,0.77
2701,0,26358187,0,0.00,241416.97,2,26388546,30359,26358187,0,0.00,89.38,241416.97,0,13.79,12.79,0.76
2702,0,26358187,0,0.00,241416.97,2,26391431,33244,26358187,0,0.00,89.35,241416.97,1,13.80,12.80,0.79
2703,0,26358187,0,0.00,241416.97,2,26394130,35943,26358187,0,0.00,89.31,241416.97,0,12.98,11.98,0.79
2704,0,26358187,0,0.00,241416.97,2,26396682,38495,26358187,0,0.00,89.28,241416.97,1,13.01,12.01,0.82
2705,0,26358187,0,0.00,241416.97,2,26399086,40899,26358187,0,0.00,89.25,241416.97,0,12.12,11.12,0.81
2706,0,26358187,0,0.00,241416.97,2,26401235,43048,26358187,0,0.00,89.22,241416.97,1,12.49,11.49,0.85
2707,0,26358187,0,0.00,241416.97,2,26403151,44964,26358187,0,0.00,89.18,241416.97,0,11.58,10.58,0.82
2708,0,26358187,0,0.00,241416.97,2,26405262,47075,26358187,0,0.00,89.15,241416.97,1,11.84,10.84,0.86
2709,0,26358187,0,0.00,241416.97,2,26407282,49095,26358187,0,0.00,89.12,241416.97,0,11.02,10.02,0.85
2710,0,26358187,0,0.00,241416.97,2,26409223,51036,26358187,0,0.00,89.08,241416.97,1,11.02,10.02,0.89
2711,0,26362015,3828,35.06,241452.03,2,26411137,49122,26362015,3828,35.06,89.06,241452.03,0,9.61,10.02,0.85
2712,0,26365845,3830,35.06,241487.09,2,26413052,47207,26365845,3830,35.08,89.04,241487.09,1,9.65,10.02,0.89
2713,0,26369671,3826,35.06,241522.16,2,26414965,45294,26369671,3826,35.04,89.02,241522.16,0,8.93,10.02,0.88
2714,0,26373487,3816,34.95,241557.09,2,26416873,43386,26373487,3816,34.95,89.00,241557.09,1,9.64,10.02,0.92
2715,0,26377295,3808,34.88,241591.98,2,26418777,41482,26377295,3808,34.88,88.98,241591.98,0,8.68,10.02,0.90
2716,0,26381085,3790,34.69,241626.67,2,26420672,39587,26381085,3790,34.71,88.96,241626.67,0,8.91,10.02,0.93
2717,0,26384881,3796,34.77,241661.44,2,26422570,37689,26384881,3796,34.77,88.94,241661.44,1,8.94,10.02,0.97
2718,0,26388673,3792,34.73,241696.17,2,26424466,35793,26388673,3792,34.73,88.92,241696.17,0,7.99,10.02,0.95
2719,0,26392443,3770,34.55,241730.72,2,26426351,33908,26392443,3770,34.53,88.90,241730.72,0,8.06,10.02,0.99
2720,0,26396199,3756,34.40,241765.12,2,26428229,32030,26396199,3756,34.40,88.88,241765.12,1,8.10,10.02,1.03
2721,0,26399959,3760,34.44,241799.56,2,26430109,30150,26399959,3760,34.44,88.86,241799.56,0,7.26,10.02,1.02
2722,0,26403641,3682,33.71,241833.27,2,26431950,28309,26403641,3682,33.72,88.84,241833.27,1,7.30,10.02,1.05
2723,0,26407211,3570,32.72,241865.98,2,26433735,26524,26407211,3570,32.70,88.82,241865.98,1,6.38,10.02,1.04
2724,0,26410457,3246,29.71,241895.69,2,26435358,24901,26410457,3246,29.73,88.80,241895.69,1,6.05,10.02,1.05
2725,0,26414081,3624,33.19,241928.89,2,26437170,23089,26414081,3624,33.19,88.78,241928.89,1,5.97,10.02,1.07
2726,0,26417853,3772,34.55,241963.44,2,26439056,21203,26417853,3772,34.55,88.76,241963.44,0,5.64,10.02,1.08
2727,0,26421865,4012,36.75,242000.19,2,26441062,19197,26421865,4012,36.75,88.74,242000.19,1,5.73,10.02,1.12
2728,0,26426461,4596,42.10,242042.28,2,26443360,16899,26426461,4596,42.10,88.73,242042.28,0,5.25,10.02,1.13
2729,0,26432071,5610,51.40,242093.67,2,26446165,14094,26432071,5610,51.38,88.71,242093.67,0,5.29,10.02,1.17
2730,0,26443745,11674,106.90,242200.58,2,26452002,8257,26443745,11674,106.92,88.72,242200.58,1,5.34,10.02,1.20
2731,0,26469577,25832,236.60,242437.17,2,26469577,0,26469577,25832,236.60,88.77,242437.17,1,4.12,10.02,1.17
2732,0,26502047,32470,297.41,242734.59,2,26502047,0,26502047,32470,297.40,88.85,242734.59,0,4.38,10.02,1.14
2733,0,26534745,32698,299.47,243034.06,2,26534745,0,26534745,32698,299.48,88.93,243034.06,1,5.81,10.02,1.18
2734,0,26567161,32416,296.90,243330.95,2,26567161,0,26567161,32416,296.90,89.00,243330.95,0,6.37,10.02,1.16
2735,0,26599307,32146,294.45,243625.41,2,26599307,0,26599307,32146,294.43,89.08,243625.41,0,6.94,10.02,1.20
2736,0,26633584,34277,313.94,243939.34,2,26633584,0,26633584,34277,313.95,89.16,243939.34,1,7.52,10.02,1.24
2737,0,26667278,33694,308.61,244247.95,2,26667278,0,26667278,33694,308.61,89.24,244247.95,0,8.40,10.02,1.16
2738,0,26667278,0,0.00,244247.95,2,26677577,10299,26667278,0,0.00,89.21,244247.95,0,15.27,14.27,1.20
2739,0,26667278,0,0.00,244247.95,2,26683002,15724,26667278,0,0.00,89.17,244247.95,1,15.56,14.56,1.23
2740,0,26667278,0,0.00,244247.95,2,26687132,19854,26667278,0,0.00,89.14,244247.95,0,15.35,14.35,1.17
2741,0,26667278,0,0.00,244247.95,2,26690824,23546,26667278,0,0.00,89.11,244247.95,1,15.48,14.48,1.20
2742,0,26674538,7260,66.49,244314.44,2,26694454,19916,26674538,7260,66.49,89.10,244314.44,0,13.69,14.48,1.14
2743,0,26682010,7472,68.44,244382.88,2,26698190,16180,26682010,7472,68.44,89.09,244382.88,1,13.76,14.48,1.18
2744,0,26689422,7412,67.89,244450.77,2,26701896,12474,26689422,7412,67.89,89.09,244450.77,0,12.15,14.48,1.13
2745,0,26701728,12306,112.71,244563.48,2,26708049,6321,26701728,12306,112.71,89.09,244563.48,1,12.21,14.48,1.17
2746,0,26730407,28679,262.68,244826.16,2,26730407,0,26730407,28679,262.67,89.16,244826.16,1,10.80,14.48,1.12
2747,0,26761617,31210,285.84,245112.00,2,26761617,0,26761617,31210,285.86,89.23,245112.00,0,9.41,14.48,1.07
2748,0,26793523,31906,292.25,245404.25,2,26793523,0,26793523,31906,292.23,89.30,245404.25,0,9.70,14.48,1.11
2749,0,26824521,30998,283.90,245688.14,2,26824521,0,26824521,30998,283.91,89.37,245688.14,1,12.00,14.48,1.14
2750,0,26855478,30957,283.55,245971.69,2,26855478,0,26855478,30957,283.54,89.44,245971.69,1,12.62,14.48,1.10
2751,0,26886292,30814,282.23,246253.92,2,26886292,0,26886292,30814,282.23,89.51,246253.92,0,13.31,14.48,1.06
2752,0,26886292,0,0.00,246253.92,2,26896405,10113,26886292,0,0.00,89.48,246253.92,1,15.59,14.59,1.09
2753,0,26886292,0,0.00,246253.92,2,26902658,16366,26886292,0,0.00,89.45,246253.92,0,15.57,14.57,1.05
2754,0,26886292,0,0.00,246253.92,2,26907419,21127,26886292,0,0.00,89.42,246253.92,1,16.14,15.14,1.09
2755,0,26894838,8546,78.27,246332.19,2,26911692,16854,26894838,8546,78.27,89.41,246332.19,0,14.68,15.14,1.05
2756,0,26894838,0,0.00,246332.19,2,26915234,20396,26894838,0,0.00,89.38,246332.19,1,15.33,14.33,1.09
2757,0,26894838,0,0.00,246332.19,2,26918517,23679,26894838,0,0.00,89.35,246332.19,0,15.25,14.25,1.04
2758,0,26894838,0,0.00,246332.19,2,26921526,26688,26894838,0,0.00,89.32,246332.19,0,15.25,14.25,1.08
2759,0,26894838,0,0.00,246332.19,2,26924300,29462,26894838,0,0.00,89.28,246332.19,1,15.25,14.25,1.11
2760,0,26900092,5254,48.12,246380.31,2,26926927,26835,26900092,5254,48.12,89.27,246380.31,0,13.80,14.25,1.08
2761,0,26905284,5192,47.55,246427.88,2,26929523,24239,26905284,5192,47.55,89.25,246427.88,1,14.13,14.25,1.11
2762,0,26910466,5182,47.46,246475.33,2,26932114,21648,26910466,5182,47.46,89.24,246475.33,0,14.10,14.25,1.07
2763,0,26910466,0,0.00,246475.33,2,26934552,24086,26910466,0,0.00,89.21,246475.33,1,14.54,13.54,1.10
2764,0,26915252,4786,43.84,246519.17,2,26936945,21693,26915252,4786,43.84,89.19,246519.17,0,13.28,13.54,1.06
2765,0,26920310,5058,46.33,246565.48,2,26939474,19164,26920310,5058,46.33,89.17,246565.48,1,13.32,13.54,1.10
2766,0,26925492,5182,47.46,246612.95,2,26942065,16573,26925492,5182,47.46,89.16,246612.95,1,12.50,13.54,1.08
2767,0,26931714,6222,56.99,246669.94,2,26945176,13462,26931714,6222,56.99,89.15,246669.94,0,11.30,13.54,1.05
2768,0,26941420,9706,88.90,246758.84,2,26950029,8609,26941420,9706,88.90,89.15,246758.84,1,12.74,13.54,1.09
2769,0,26967007,25587,234.36,246993.20,2,26967007,0,26967007,25587,234.35,89.20,246993.20,1,12.02,13.54,1.08
2770,0,26998954,31947,292.60,247285.80,2,26998954,0,26998954,31947,292.61,89.27,247285.80,0,13.32,13.54,1.06
2771,0,26998954,0,0.00,247285.80,2,27009800,10846,26998954,0,0.00,89.24,247285.80,1,14.37,13.37,1.09
2772,0,27018106,19152,175.41,247461.22,2,27019376,1270,27018106,19152,175.41,89.27,247461.22,0,12.89,13.37,1.05
2773,0,27051568,33462,306.48,247767.70,2,27051568,0,27051568,33462,306.48,89.35,247767.70,0,13.06,13.37,1.09
2774,0,27051568,0,0.00,247767.70,2,27062413,10845,27051568,0,0.00,89.32,247767.70,1,15.61,14.61,1.13
2775,0,27051568,0,0.00,247767.70,2,27068568,17000,27051568,0,0.00,89.29,247767.70,0,15.11,14.11,1.07
2776,0,27051568,0,0.00,247767.70,2,27073049,21481,27051568,0,0.00,89.25,247767.70,1,15.77,14.77,1.10
2777,0,27058656,7088,64.92,247832.61,2,27076593,17937,27058656,7088,64.92,89.24,247832.61,0,14.71,14.77,1.07
2778,0,27058656,0,0.00,247832.61,2,27080398,21742,27058656,0,0.00,89.21,247832.61,0,15.37,14.37,1.10
2779,0,27058656,0,0.00,247832.61,2,27083740,25084,27058656,0,0.00,89.18,247832.61,1,15.97,14.97,1.14
2780,0,27064948,6292,57.63,247890.25,2,27086886,21938,27064948,6292,57.63,89.17,247890.25,0,14.35,14.97,1.06
2781,0,27071126,6178,56.58,247946.83,2,27089975,18849,27071126,6178,56.58,89.16,247946.83,1,14.70,14.97,1.09
2782,0,27077352,6226,57.02,248003.86,2,27093088,15736,27077352,6226,57.02,89.15,248003.86,0,13.99,14.97,1.06
2783,0,27084342,6990,64.02,248067.88,2,27096583,12241,27084342,6990,64.02,89.14,248067.88,1,14.05,14.97,1.10
2784,0,27098774,14432,132.18,248200.06,2,27103799,5025,27098774,14432,132.18,89.15,248200.06,1,13.45,14.97,1.05
2785,0,27124656,25882,237.06,248437.11,2,27124656,0,27124656,25882,237.06,89.21,248437.11,0,13.37,14.97,1.03
2786,0,27124656,0,0.00,248437.11,2,27135830,11174,27124656,0,0.00,89.17,248437.11,1,15.70,14.70,1.07
2787,0,27141990,17334,158.76,248595.88,2,27144497,2507,27141990,17334,158.76,89.20,248595.88,1,14.56,14.70,1.04
2788,0,27141990,0,0.00,248595.88,2,27154074,12084,27141990,0,0.00,89.17,248595.88,0,15.39,14.39,1.01
2789,0,27141990,0,0.00,248595.88,2,27159353,17363,27141990,0,0.00,89.13,248595.88,1,15.44,14.44,1.04
2790,0,27150984,8994,82.38,248678.25,2,27163850,12866,27150984,8994,82.38,89.13,248678.25,0,13.93,14.44,1.00
2791,0,27165260,14276,130.76,248809.02,2,27170988,5728,27165260,14276,130.76,89.15,248809.02,1,14.01,14.44,1.04
2792,0,27193061,27801,254.62,249063.64,2,27193061,0,27193061,27801,254.63,89.21,249063.64,0,12.30,14.44,0.98
2793,0,27222334,29273,268.12,249331.75,2,27222334,0,27222334,29273,268.11,89.27,249331.75,0,12.55,14.44,1.01
2794,0,27222334,0,0.00,249331.75,2,27232102,9768,27222334,0,0.00,89.24,249331.75,1,14.72,13.72,1.05
2795,0,27222334,0,0.00,249331.75,2,27237484,15150,27222334,0,0.00,89.21,249331.75,0,14.11,13.11,0.96
2796,0,27222334,0,0.00,249331.75,2,27242256,19922,27222334,0,0.00,89.17,249331.75,1,14.75,13.75,1.00
2797,0,27231044,8710,79.78,249411.53,2,27246611,15567,27231044,8710,79.78,89.17,249411.53,0,13.38,13.75,0.95
2798,0,27231044,0,0.00,249411.53,2,27250564,19520,27231044,0,0.00,89.14,249411.53,0,14.57,13.57,0.98
2799,0,27231044,0,0.00,249411.53,2,27253918,22874,27231044,0,0.00,89.11,249411.53,1,14.79,13.79,1.02
2800,0,27237376,6332,58.00,249469.53,2,27257084,19708,27237376,6332,58.00,89.10,249469.53,0,12.79,13.79,0.94
2801,0,27243698,6322,57.90,249527.44,2,27260245,16547,27243698,6322,57.90,89.09,249527.44,1,12.99,13.79,0.98
2802,0,27250764,7066,64.72,249592.16,2,27263778,13014,27250764,7066,64.72,89.08,249592.16,0,12.02,13.79,0.93
2803,0,27260410,9646,88.35,249680.50,2,27268601,8191,27260410,9646,88.35,89.08,249680.50,1,12.81,13.79,0.96
2804,0,27286903,26493,242.66,249923.16,2,27286903,0,27286903,26493,242.65,89.13,249923.16,0,11.87,13.79,0.93
2805,0,27316673,29770,272.65,250195.81,2,27316673,0,27316673,29770,272.67,89.20,250195.81,1,12.11,13.79,0.96
2806,0,27345822,29149,266.99,250462.80,2,27345822,0,27345822,29149,266.98,89.26,250462.80,1,13.33,13.79,0.95
2807,0,27376275,30453,278.93,250741.72,2,27376275,0,27376275,30453,278.92,89.33,250741.72,0,12.22,13.79,0.91
2808,0,27406469,30194,276.53,251018.25,2,27406469,0,27406469,30194,276.55,89.39,251018.25,1,12.49,13.79,0.95
2809,0,27437064,30595,280.23,251298.48,2,27437064,0,27437064,30595,280.22,89.46,251298.48,0,13.34,13.79,0.91
2810,0,27437064,0,0.00,251298.48,2,27447495,10431,27437064,0,0.00,89.43,251298.48,1,15.60,14.60,0.95
2811,0,27437064,0,0.00,251298.48,2,27452846,15782,27437064,0,0.00,89.40,251298.48,0,16.23,15.23,0.93
2812,0,27437064,0,0.00,251298.48,2,27457040,19976,27437064,0,0.00,89.37,251298.48,1,16.52,15.52,0.96
2813,0,27445932,8868,81.22,251379.70,2,27461474,15542,27445932,8868,81.22,89.36,251379.70,0,15.37,15.52,0.94
2814,0,27445932,0,0.00,251379.70,2,27465536,19604,27445932,0,0.00,89.33,251379.70,1,15.71,14.71,0.97
2815,0,27453288,7356,67.37,251447.08,2,27469214,15926,27453288,7356,67.37,89.32,251447.08,0,14.34,14.71,0.93
2816,0,27461868,8580,78.58,251525.67,2,27473504,11636,27461868,8580,78.58,89.32,251525.67,1,14.41,14.71,0.97
2817,0,27479744,17876,163.73,251689.39,2,27482442,2698,27479744,17876,163.73,89.35,251689.39,0,13.29,14.71,0.94
2818,0,27511159,31415,287.74,251977.14,2,27511159,0,27511159,31415,287.73,89.42,251977.14,0,13.70,14.71,0.97
2819,0,27511159,0,0.00,251977.14,2,27522053,10894,27511159,0,0.00,89.39,251977.14,1,15.09,14.09,1.01
2820,0,27511159,0,0.00,251977.14,2,27527597,16438,27511159,0,0.00,89.35,251977.14,0,15.70,14.70,0.96
2821,0,27511159,0,0.00,251977.14,2,27532137,20978,27511159,0,0.00,89.32,251977.14,1,15.70,14.70,1.00
2822,0,27511159,0,0.00,251977.14,2,27536087,24928,27511159,0,0.00,89.29,251977.14,1,14.93,13.93,0.96
2823,0,27511159,0,0.00,251977.14,2,27539616,28457,27511159,0,0.00,89.26,251977.14,0,15.13,14.13,0.94
2824,0,27511159,0,0.00,251977.14,2,27542843,31684,27511159,0,0.00,89.23,251977.14,1,15.13,14.13,0.97
2825,0,27517303,6144,56.27,252033.41,2,27545915,28612,27517303,6144,56.27,89.22,252033.41,0,13.93,14.13,0.95
2826,0,27523399,6096,55.83,252089.25,2,27548963,25564,27523399,6096,55.83,89.20,252089.25,1,13.98,14.13,0.98
2827,0,27529317,5918,54.19,252143.44,2,27551922,22605,27529317,5918,54.20,89.19,252143.44,0,12.39,14.13,0.93
2828,0,27534961,5644,51.69,252195.12,2,27554744,19783,27534961,5644,51.69,89.18,252195.12,1,12.50,14.13,0.96
2829,0,27540781,5820,53.31,252248.44,2,27557654,16873,27540781,5820,53.31,89.17,252248.44,0,10.99,14.13,0.91
2830,0,27546807,6026,55.21,252303.64,2,27560667,13860,27546807,6026,55.19,89.15,252303.64,1,11.13,14.13,0.95
2831,0,27555323,8516,78.00,252381.64,2,27564925,9602,27555323,8516,78.00,89.15,252381.64,0,9.17,14.13,0.88
2832,0,27578513,23190,212.38,252594.02,2,27578513,0,27578513,23190,212.40,89.19,252594.02,1,9.58,14.13,0.91
2833,0,27611957,33444,306.32,252900.34,2,27611957,0,27611957,33444,306.32,89.27,252900.34,0,9.18,14.13,0.87
2834,0,27644540,32583,298.44,253198.78,2,27644540,0,27644540,32583,298.43,89.34,253198.78,1,9.80,14.13,0.90
2835,0,27678010,33470,306.55,253505.33,2,27678010,0,27678010,33470,306.55,89.42,253505.33,0,8.92,14.13,0.83
2836,0,27710201,32191,294.83,253800.16,2,27710201,0,27710201,32191,294.84,89.49,253800.16,1,11.47,14.13,0.87
2837,0,27742414,32213,295.05,254095.22,2,27742414,0,27742414,32213,295.04,89.56,254095.22,0,13.69,14.13,0.81
2838,0,27742414,0,0.00,254095.22,2,27752922,10508,27742414,0,0.00,89.53,254095.22,0,16.78,15.78,0.85
2839,0,27742414,0,0.00,254095.22,2,27758643,16229,27742414,0,0.00,89.50,254095.22,1,17.03,16.03,0.88
2840,0,27752674,10260,93.97,254189.19,2,27763773,11099,27752674,10260,93.97,89.50,254189.19,0,15.68,16.03,0.85
2841,0,27772584,19910,182.36,254371.55,2,27773728,1144,27772584,19910,182.36,89.54,254371.55,1,15.77,16.03,0.88
2842,0,27804211,31627,289.68,254661.23,2,27804211,0,27804211,31627,289.67,89.61,254661.23,0,14.48,16.03,0.84
2843,0,27804211,0,0.00,254661.23,2,27814531,10320,27804211,0,0.00,89.57,254661.23,1,16.99,15.99,0.88
2844,0,27804211,0,0.00,254661.23,2,27820077,15866,27804211,0,0.00,89.54,254661.23,1,17.42,16.42,0.84
2845,0,27814447,10236,93.75,254754.98,2,27825195,10748,27814447,10236,93.75,89.54,254754.98,0,16.33,16.42,0.82
2846,0,27814447,0,0.00,254754.98,2,27830162,15715,27814447,0,0.00,89.51,254754.98,1,16.70,15.70,0.86
2847,0,27814447,0,0.00,254754.98,2,27833606,19159,27814447,0,0.00,89.48,254754.98,0,16.95,15.95,0.82
2848,0,27814447,0,0.00,254754.98,2,27836769,22322,27814447,0,0.00,89.45,254754.98,1,16.95,15.95,0.86
2849,0,27820385,5938,54.37,254809.34,2,27839738,19353,27820385,5938,54.39,89.44,254809.34,0,15.61,15.95,0.82
2850,0,27826243,5858,53.67,254863.02,2,27842667,16424,27826243,5858,53.65,89.43,254863.02,1,15.67,15.95,0.86
2851,0,27834053,7810,71.51,254934.53,2,27846572,12519,27834053,7810,71.53,89.42,254934.53,0,14.41,15.95,0.82
2852,0,27849331,15278,139.95,255074.48,2,27854211,4880,27849331,15278,139.93,89.44,255074.48,1,14.67,15.95,0.86
2853,0,27880089,30758,281.70,255356.19,2,27880089,0,27880089,30758,281.72,89.50,255356.19,0,13.08,15.95,0.81
2854,0,27911543,31454,288.11,255644.30,2,27911543,0,27911543,31454,288.09,89.57,255644.30,1,14.26,15.95,0.84
2855,0,27942973,31430,287.85,255932.14,2,27942973,0,27942973,31430,287.87,89.64,255932.14,0,14.91,15.95,0.81
2856,0,27974628,31655,289.94,256222.08,2,27974628,0,27974628,31655,289.93,89.71,256222.08,0,15.63,15.95,0.85
2857,0,28005558,30930,283.29,256505.38,2,28005558,0,28005558,30930,283.29,89.78,256505.38,1,15.92,15.95,0.88
2858,0,28037051,31493,288.46,256793.83,2,28037051,0,28037051,31493,288.45,89.85,256793.83,0,15.67,15.95,0.81
2859,0,28037051,0,0.00,256793.83,2,28047350,10299,28037051,0,0.00,89.82,256793.83,1,16.89,15.89,0.85
2860,0,28037051,0,0.00,256793.83,2,28052902,15851,28037051,0,0.00,89.79,256793.83,0,18.23,17.23,0.82
2861,0,28037051,0,0.00,256793.83,2,28057301,20250,28037051,0,0.00,89.76,256793.83,1,18.23,17.23,0.86
2862,0,28045311,8260,75.65,256869.48,2,28061431,16120,28045311,8260,75.65,89.75,256869.48,0,16.73,17.23,0.82
2863,0,28053311,8000,73.27,256942.75,2,28065431,12120,28053311,8000,73.27,89.75,256942.75,1,17.09,17.23,0.85
2864,0,28065937,12626,115.62,257058.38,2,28071744,5807,28065937,12626,115.64,89.76,257058.38,1,17.10,17.23,0.81
2865,0,28065937,0,0.00,257058.38,2,28079795,13858,28065937,0,0.00,89.72,257058.38,0,17.82,16.82,0.80
2866,0,28065937,0,0.00,257058.38,2,28084653,18716,28065937,0,0.00,89.69,257058.38,1,20.95,19.95,0.83
2867,0,28075067,9130,83.64,257142.02,2,28089218,14151,28075067,9130,83.62,89.69,257142.02,0,19.78,19.95,0.80
2868,0,28075067,0,0.00,257142.02,2,28094014,18947,28075067,0,0.00,89.66,257142.02,1,19.98,18.98,0.84
2869,0,28075067,0,0.00,257142.02,2,28096951,21884,28075067,0,0.00,89.63,257142.02,0,19.57,18.57,0.80
2870,0,28075067,0,0.00,257142.02,2,28099150,24083,28075067,0,0.00,89.60,257142.02,1,19.76,18.76,0.84
2871,0,28079579,4512,41.33,257183.34,2,28101406,21827,28079579,4512,41.33,89.58,257183.34,0,18.06,18.76,0.79
2872,0,28084967,5388,49.35,257232.70,2,28104100,19133,28084967,5388,49.35,89.57,257232.70,1,18.10,18.76,0.82
2873,0,28091807,6840,62.65,257295.34,2,28107520,15713,28091807,6840,62.65,89.56,257295.34,0,16.90,18.76,0.80
2874,0,28101863,10056,92.10,257387.45,2,28112548,10685,28101863,10056,92.10,89.56,257387.45,1,18.10,18.76,0.83
2875,0,28119431,17568,160.91,257548.36,2,28121332,1901,28119431,17568,160.91,89.58,257548.36,0,17.22,18.76,0.77
2876,0,28152259,32828,300.67,257849.03,2,28152259,0,28152259,32828,300.67,89.66,257849.03,1,17.80,18.76,0.80
2877,0,28184337,32078,293.79,258142.81,2,28184337,0,28184337,32078,293.81,89.73,258142.81,0,17.58,18.76,0.78
2878,0,28216329,31992,293.02,258435.83,2,28216329,0,28216329,31992,293.02,89.80,258435.83,1,18.70,18.76,0.82
2879,0,28248276,31947,292.61,258728.45,2,28248276,0,28248276,31947,292.61,89.87,258728.45,0,18.20,18.76,0.76
2880,0,28248276,0,0.00,258728.45,2,28258647,10371,28248276,0,0.00,89.84,258728.45,1,19.40,18.40,0.80
2881,0,28248276,0,0.00,258728.45,2,28264363,16087,28248276,0,0.00,89.81,258728.45,0,18.44,17.44,0.78
2882,0,28248276,0,0.00,258728.45,2,28268930,20654,28248276,0,0.00,89.77,258728.45,1,18.44,17.44,0.82
2883,0,28256628,8352,76.50,258804.95,2,28273106,16478,28256628,8352,76.50,89.77,258804.95,0,17.21,17.44,0.79
2884,0,28265260,8632,79.06,258884.00,2,28277422,12162,28265260,8632,79.06,89.77,258884.00,1,17.29,17.44,0.83
2885,0,28279706,14446,132.31,259016.31,2,28284645,4939,28279706,14446,132.31,89.78,259016.31,0,15.92,17.44,0.79
2886,0,28279706,0,0.00,259016.31,2,28292144,12438,28279706,0,0.00,89.75,259016.31,1,18.21,17.21,0.82
2887,0,28279706,0,0.00,259016.31,2,28296899,17193,28279706,0,0.00,89.72,259016.31,1,17.59,16.59,0.78
2888,0,28279706,0,0.00,259016.31,2,28299988,20282,28279706,0,0.00,89.69,259016.31,0,21.50,19.00,0.75
2889,0,28279706,0,0.00,259016.31,2,28302327,22621,28279706,0,0.00,89.66,259016.31,0,21.66,19.00,0.79
2890,0,28279706,0,0.00,259016.31,2,28304402,24696,28279706,0,0.00,89.63,259016.31,1,21.66,19.00,0.82
2891,0,28279706,0,0.00,259016.31,2,28306338,26632,28279706,0,0.00,89.59,259016.31,0,19.73,18.73,0.76
2892,0,28279706,0,0.00,259016.31,2,28308185,28479,28279706,0,0.00,89.56,259016.31,1,19.73,18.73,0.79
2893,0,28279706,0,0.00,259016.31,2,28309968,30262,28279706,0,0.00,89.53,259016.31,0,18.74,17.74,0.77
2894,0,28279706,0,0.00,259016.31,2,28311697,31991,28279706,0,0.00,89.50,259016.31,1,19.83,18.83,0.80
2895,0,28283196,3490,31.97,259048.28,2,28313442,30246,28283196,3490,31.97,89.48,259048.28,0,18.48,18.83,0.76
2896,0,28286876,3680,33.71,259081.98,2,28315282,28406,28286876,3680,33.71,89.46,259081.98,1,18.68,18.83,0.79
2897,0,28290848,3972,36.38,259118.38,2,28317268,26420,28290848,3972,36.38,89.44,259118.38,0,17.57,18.83,0.77
2898,0,28295168,4320,39.57,259157.94,2,28319428,24260,28295168,4320,39.57,89.43,259157.94,0,17.60,18.83,0.80
2899,0,28299726,4558,41.75,259199.69,2,28321707,21981,28299726,4558,41.75,89.41,259199.69,1,17.64,18.83,0.84
2900,0,28304430,4704,43.08,259242.77,2,28324059,19629,28304430,4704,43.08,89.39,259242.77,1,15.95,18.83,0.79
2901,0,28309448,5018,45.96,259288.73,2,28326568,17120,28309448,5018,45.96,89.38,259288.73,0,14.99,18.83,0.77
2902,0,28315116,5668,51.91,259340.64,2,28329402,14286,28315116,5668,51.91,89.37,259340.64,1,15.03,18.83,0.80
2903,0,28324206,9090,83.26,259423.91,2,28333947,9741,28324206,9090,83.26,89.36,259423.91,1,13.83,18.83,0.78
2904,0,28344909,20703,189.61,259613.52,2,28344909,0,28344909,20703,189.62,89.40,259613.52,0,12.87,18.83,0.74
2905,0,28377200,32291,295.77,259909.28,2,28377200,0,28377200,32291,295.76,89.47,259909.28,1,13.83,18.83,0.77
2906,0,28409247,32047,293.53,260202.81,2,28409247,0,28409247,32047,293.52,89.54,260202.81,0,13.32,18.83,0.73
2907,0,28441686,32439,297.10,260499.91,2,28441686,0,28441686,32439,297.11,89.61,260499.91,1,14.88,18.83,0.76
2908,0,28474251,32565,298.27,260798.19,2,28474251,0,28474251,32565,298.27,89.68,260798.19,0,14.94,18.83,0.73
2909,0,28506593,32342,296.20,261094.39,2,28506593,0,28506593,32342,296.22,89.75,261094.39,1,15.39,18.83,0.76
2910,0,28538922,32329,296.11,261390.50,2,28538922,0,28538922,32329,296.10,89.82,261390.50,0,13.79,18.83,0.70
2911,0,28570479,31557,289.04,261679.55,2,28570479,0,28570479,31557,289.03,89.89,261679.55,1,14.91,18.83,0.74
2912,0,28570479,0,0.00,261679.55,2,28580542,10063,28570479,0,0.00,89.86,261679.55,0,19.52,18.52,0.66
2913,0,28570479,0,0.00,261679.55,2,28586389,15910,28570479,0,0.00,89.83,261679.55,0,21.24,19.00,0.69
2914,0,28570479,0,0.00,261679.55,2,28591019,20540,28570479,0,0.00,89.80,261679.55,1,21.82,19.00,0.73
2915,0,28579015,8536,78.18,261757.72,2,28595287,16272,28579015,8536,78.18,89.80,261757.72,0,18.69,19.00,0.61
2916,0,28587893,8878,81.30,261839.02,2,28599726,11833,28587893,8878,81.31,89.79,261839.02,1,18.76,19.00,0.64
2917,0,28603103,15210,139.33,261978.34,2,28607331,4228,28603103,15210,139.31,89.81,261978.34,0,16.71,19.00,0.57
2918,0,28633336,30233,276.90,262255.25,2,28633336,0,28633336,30233,276.91,89.88,262255.25,0,17.17,19.00,0.60
2919,0,28665728,32392,296.68,262551.94,2,28665728,0,28665728,32392,296.68,89.95,262551.94,1,18.78,19.00,0.64
2920,0,28698394,32666,299.19,262851.12,2,28698394,0,28698394,32666,299.19,90.02,262851.12,0,16.76,19.00,0.54
2921,0,28731118,32724,299.72,263150.84,2,28731118,0,28731118,32724,299.72,90.09,263150.84,1,18.06,19.00,0.58
2922,0,28763424,32306,295.89,263446.75,2,28763424,0,28763424,32306,295.89,90.16,263446.75,0,17.28,19.00,0.50
2923,0,28794798,31374,287.36,263734.09,2,28794798,0,28794798,31374,287.36,90.23,263734.09,1,18.83,19.00,0.53
2924,0,28827453,32655,299.08,264033.19,2,28827453,0,28827453,32655,299.09,90.30,264033.19,0,17.19,19.00,0.47
2925,0,28860010,32557,298.20,264331.38,2,28860010,0,28860010,32557,298.19,90.37,264331.38,1,17.48,19.00,0.51
2926,0,28893338,33328,305.25,264636.62,2,28893338,0,28893338,33328,305.25,90.44,264636.62,1,17.11,19.00,0.45
2927,0,28893338,0,0.00,264636.62,2,28903884,10546,28893338,0,0.00,90.41,264636.62,0,19.74,18.74,0.39
2928,0,28893338,0,0.00,264636.62,2,28909406,16068,28893338,0,0.00,90.38,264636.62,1,19.74,18.74,0.42
2929,0,28893338,0,0.00,264636.62,2,28913758,20420,28893338,0,0.00,90.35,264636.62,0,21.32,19.00,0.37
2930,0,28893338,0,0.00,264636.62,2,28917714,24376,28893338,0,0.00,90.32,264636.62,1,24.71,19.00,0.40
2931,0,28893338,0,0.00,264636.62,2,28921203,27865,28893338,0,0.00,90.29,264636.62,0,22.78,19.00,0.34
2932,0,28893338,0,0.00,264636.62,2,28924490,31152,28893338,0,0.00,90.26,264636.62,1,22.78,19.00,0.38
2933,0,28893338,0,0.00,264636.62,2,28927540,34202,28893338,0,0.00,90.23,264636.62,0,20.86,19.86,0.32
2934,0,28893338,0,0.00,264636.62,2,28930145,36807,28893338,0,0.00,90.20,264636.62,1,22.57,19.00,0.35
2935,0,28893338,0,0.00,264636.62,2,28932655,39317,28893338,0,0.00,90.17,264636.62,0,20.92,19.92,0.29
2936,0,28893338,0,0.00,264636.62,2,28935124,41786,28893338,0,0.00,90.14,264636.62,1,20.92,19.92,0.32
2937,0,28898148,4810,44.06,264680.69,2,28937529,39381,28898148,4810,44.06,90.12,264680.69,0,18.99,19.92,0.26
2938,0,28902884,4736,43.38,264724.06,2,28939897,37013,28902884,4736,43.38,90.10,264724.06,1,19.03,19.92,0.30
2939,0,28907546,4662,42.70,264766.75,2,28942228,34682,28907546,4662,42.70,90.09,264766.75,0,17.22,19.92,0.24
2940,0,28912232,4686,42.92,264809.69,2,28944571,32339,28912232,4686,42.92,90.07,264809.69,1,17.33,19.92,0.28
2941,0,28916820,4588,42.02,264851.69,2,28946865,30045,28916820,4588,42.02,90.05,264851.69,0,15.75,19.92,0.22
2942,0,28921364,4544,41.62,264893.31,2,28949137,27773,28921364,4544,41.62,90.04,264893.31,1,15.86,19.92,0.25
2943,0,28925874,4510,41.31,264934.62,2,28951392,25518,28925874,4510,41.31,90.02,264934.62,0,14.21,19.92,0.20
2944,0,28930340,4466,40.90,264975.53,2,28953625,23285,28930340,4466,40.90,90.01,264975.53,1,14.27,19.92,0.23
2945,0,28934788,4448,40.74,265016.28,2,28955849,21061,28934788,4448,40.74,89.99,265016.28,0,11.96,19.92,0.15
2946,0,28939410,4622,42.33,265058.59,2,28958160,18750,28939410,4622,42.33,89.97,265058.59,1,12.18,19.92,0.19
2947,0,28944326,4916,45.03,265103.62,2,28960618,16292,28944326,4916,45.03,89.96,265103.62,0,11.40,19.92,0.16
2948,0,28949856,5530,50.65,265154.28,2,28963383,13527,28949856,5530,50.65,89.94,265154.28,1,11.45,19.92,0.19
2949,0,28960676,10820,99.10,265253.38,2,28968793,8117,28960676,10820,99.10,89.95,265253.38,0,9.36,19.92,0.11
2950,0,28986018,25342,232.11,265485.50,2,28986018,0,28986018,25342,232.11,90.00,265485.50,1,9.66,19.92,0.14
2951,0,29019848,33830,309.85,265795.34,2,29019848,0,29019848,33830,309.85,90.07,265795.34,0,9.59,19.92,0.12
2952,0,29052448,32600,298.59,266093.94,2,29052448,0,29052448,32600,298.59,90.14,266093.94,1,10.39,19.92,0.15
2953,0,29085390,32942,301.72,266395.66,2,29085390,0,29085390,32942,301.72,90.21,266395.66,0,9.69,19.92,0.09
2954,0,29117687,32297,295.82,266691.47,2,29117687,0,29117687,32297,295.81,90.28,266691.47,1,16.04,19.92,0.13
2955,0,29150122,32435,297.07,266988.53,2,29150122,0,29150122,32435,297.08,90.35,266988.53,0,15.99,19.92,0.05
2956,0,29182256,32134,294.32,267282.84,2,29182256,0,29182256,32134,294.32,90.42,267282.84,1,18.28,19.92,0.08
2957,0,29214417,32161,294.56,267577.41,2,29214417,0,29214417,32161,294.57,90.49,267577.41,0,18.93,19.92,0.03
2958,0,29214417,0,0.00,267577.41,2,29225092,10675,29214417,0,0.00,90.46,267577.41,0,21.10,19.00,0.06
2959,0,29214417,0,0.00,267577.41,2,29231355,16938,29214417,0,0.00,90.43,267577.41,1,21.93,19.00,0.10
2960,0,29214417,0,0.00,267577.41,2,29236277,21860,29214417,0,0.00,90.40,267577.41,0,20.81,19.81,0.02
2961,0,29214417,0,0.00,267577.41,2,29240623,26206,29214417,0,0.00,90.37,267577.41,1,20.81,19.81,0.05
2962,0,29222191,7774,71.22,267648.62,2,29244510,22319,29222191,7774,71.20,90.36,267648.62,0,19.25,19.81,0.05
2963,0,29229583,7392,67.70,267716.34,2,29248206,18623,29229583,7392,67.70,90.35,267716.34,1,19.32,19.81,0.03
2964,0,29236281,6698,61.33,267777.66,2,29251555,15274,29236281,6698,61.35,90.34,267777.66,0,17.76,19.81,0.03
2965,0,29243437,7156,65.54,267843.22,2,29255133,11696,29243437,7156,65.54,90.33,267843.22,1,17.82,19.81,0.03
2966,0,29257627,14190,129.99,267973.19,2,29262228,4601,29257627,14190,129.97,90.35,267973.19,1,14.61,19.81,0.03
2967,0,29288198,30571,279.99,268253.19,2,29288198,0,29288198,30571,280.00,90.41,268253.19,0,14.73,19.81,0.03
2968,0,29320782,32584,298.44,268551.62,2,29320782,0,29320782,32584,298.44,90.48,268551.62,1,15.01,19.81,0.07
2969,0,29353463,32681,299.34,268850.97,2,29353463,0,29353463,32681,299.33,90.55,268850.97,0,15.03,19.81,0.02
2970,0,29385723,32260,295.47,269146.44,2,29385723,0,29385723,32260,295.47,90.62,269146.44,1,17.32,19.81,0.06
2971,0,29418003,32280,295.66,269442.09,2,29418003,0,29418003,32280,295.66,90.69,269442.09,0,17.94,19.81,0.01
2972,0,29418003,0,0.00,269442.09,2,29428537,10534,29418003,0,0.00,90.66,269442.09,1,20.23,19.23,0.04
2973,0,29418003,0,0.00,269442.09,2,29434369,16366,29418003,0,0.00,90.63,269442.09,0,20.63,19.63,0.04
2974,0,29418003,0,0.00,269442.09,2,29438449,20446,29418003,0,0.00,90.60,269442.09,1,20.63,19.63,0.03
2975,0,29418003,0,0.00,269442.09,2,29442047,24044,29418003,0,0.00,90.57,269442.09,0,20.85,19.85,0.03
2976,0,29418003,0,0.00,269442.09,2,29445433,27430,29418003,0,0.00,90.54,269442.09,1,20.85,19.85,0.03
2977,0,29424673,6670,61.07,269503.16,2,29448768,24095,29424673,6670,61.09,90.53,269503.16,0,19.49,19.85,0.03
2978,0,29431169,6496,59.50,269562.66,2,29452016,20847,29431169,6496,59.50,90.52,269562.66,1,19.55,19.85,0.03
2979,0,29437509,6340,58.07,269620.72,2,29455186,17677,29437509,6340,58.07,90.51,269620.72,0,18.81,19.85,0.03
2980,0,29443995,6486,59.42,269680.16,2,29458429,14434,29443995,6486,59.41,90.50,269680.16,1,18.87,19.85,0.03
2981,0,29451379,7384,67.63,269747.78,2,29462121,10742,29451379,7384,67.63,90.49,269747.78,1,16.89,19.85,0.03
2982,0,29468859,17480,160.10,269907.88,2,29470861,2002,29468859,17480,160.10,90.51,269907.88,0,16.95,19.85,0.03
2983,0,29499657,30798,282.06,270189.94,2,29499657,0,29499657,30798,282.08,90.58,270189.94,0,17.97,19.85,0.07
2984,0,29499657,0,0.00,270189.94,2,29510041,10384,29499657,0,0.00,90.55,270189.94,1,19.97,18.97,0.10
2985,0,29499657,0,0.00,270189.94,2,29515992,16335,29499657,0,0.00,90.52,270189.94,0,19.25,18.25,0.03
2986,0,29499657,0,0.00,270189.94,2,29520741,21084,29499657,0,0.00,90.49,270189.94,1,19.81,18.81,0.06
2987,0,29499657,0,0.00,270189.94,2,29524753,25096,29499657,0,0.00,90.46,270189.94,0,19.47,18.47,0.01
2988,0,29499657,0,0.00,270189.94,2,29528238,28581,29499657,0,0.00,90.43,270189.94,1,19.78,18.78,0.04
2989,0,29506189,6532,59.83,270249.78,2,29531504,25315,29506189,6532,59.83,90.41,270249.78,0,18.10,18.78,0.04
2990,0,29512609,6420,58.80,270308.56,2,29534714,22105,29512609,6420,58.80,90.40,270308.56,1,18.16,18.78,0.03
2991,0,29518611,6002,54.99,270363.56,2,29537715,19104,29518611,6002,54.97,90.39,270363.56,0,16.02,18.78,0.03
2992,0,29524465,5854,53.60,270417.16,2,29540642,16177,29524465,5854,53.62,90.38,270417.16,1,16.08,18.78,0.03
2993,0,29530799,6334,58.03,270475.19,2,29543809,13010,29530799,6334,58.01,90.37,270475.19,0,14.14,18.78,0.03
2994,0,29541203,10404,95.29,270570.50,2,29549011,7808,29541203,10404,95.29,90.37,270570.50,1,14.19,18.78,0.03
2995,0,29565670,24467,224.09,270794.56,2,29565670,0,29565670,24467,224.10,90.42,270794.56,0,13.66,18.78,0.03
2996,0,29596699,31029,284.21,271078.78,2,29596699,0,29596699,31029,284.20,90.48,271078.78,0,13.88,18.78,0.03
2997,0,29628858,32159,294.54,271373.31,2,29628858,0,29628858,32159,294.55,90.55,271373.31,1,15.36,18.78,0.07
2998,0,29661359,32501,297.69,271671.00,2,29661359,0,29661359,32501,297.68,90.62,271671.00,0,13.77,18.78,0.01
2999,0,29694183,32824,300.64,271971.66,2,29694183,0,29694183,32824,300.64,90.69,271971.66,1,14.06,18.78,0.04
3000,0,29726946,32763,300.07,272271.72,2,29726946,0,29726946,32763,300.08,90.76,272271.72,0,18.51,18.78,0.00
3001,0,29726946,0,0.00,272271.72,2,29737512,10566,29726946,0,0.00,90.73,272271.72,1,21.88,19.00,0.04
3002,0,29726946,0,0.00,272271.72,2,29743140,16194,29726946,0,0.00,90.70,272271.72,1,20.53,19.53,0.01
3003,0,29736400,9454,86.59,272358.31,2,29747867,11467,29736400,9454,86.59,90.70,272358.31,0,19.33,19.53,0.01
3004,0,29751418,15018,137.55,272495.88,2,29755376,3958,29751418,15018,137.55,90.71,272495.88,1,19.41,19.53,0.03
3005,0,29781088,29670,271.75,272767.62,2,29781088,0,29781088,29670,271.75,90.77,272767.62,0,18.30,19.53,0.01
3006,0,29781088,0,0.00,272767.62,2,29792049,10961,29781088,0,0.00,90.74,272767.62,1,20.56,19.56,0.04
3007,0,29799198,18110,165.87,272933.47,2,29801104,1906,29799198,18110,165.87,90.77,272933.47,0,19.13,19.56,0.01
3008,0,29799198,0,0.00,272933.47,2,29810292,11094,29799198,0,0.00,90.74,272933.47,1,21.64,19.00,0.04
3009,0,29799198,0,0.00,272933.47,2,29815885,16687,29799198,0,0.00,90.71,272933.47,0,21.67,19.00,0.01
3010,0,29799198,0,0.00,272933.47,2,29819271,20073,29799198,0,0.00,90.68,272933.47,1,21.89,19.00,0.04
3011,0,29799198,0,0.00,272933.47,2,29822127,22929,29799198,0,0.00,90.65,272933.47,0,20.14,19.14,0.04
3012,0,29799198,0,0.00,272933.47,2,29824668,25470,29799198,0,0.00,90.62,272933.47,1,20.14,19.14,0.03
3013,0,29804154,4956,45.39,272978.88,2,29827146,22992,29804154,4956,45.39,90.60,272978.88,0,18.87,19.14,0.01
3014,0,29810042,5888,53.93,273032.81,2,29830090,20048,29810042,5888,53.93,90.59,273032.81,1,18.91,19.14,0.04
3015,0,29816576,6534,59.85,273092.66,2,29833357,16781,29816576,6534,59.85,90.58,273092.66,0,17.81,19.14,0.04
3016,0,29823632,7056,64.63,273157.28,2,29836885,13253,29823632,7056,64.63,90.57,273157.28,1,17.87,19.14,0.03
3017,0,29835234,11602,106.26,273263.53,2,29842686,7452,29835234,11602,106.26,90.57,273263.53,0,16.39,19.14,0.03
3018,0,29861811,26577,243.43,273506.97,2,29861811,0,29861811,26577,243.42,90.63,273506.97,0,16.50,19.14,0.03
3019,0,29892964,31153,285.32,273792.28,2,29892964,0,29892964,31153,285.33,90.69,273792.28,1,18.14,19.14,0.07
3020,0,29925202,32238,295.27,274087.56,2,29925202,0,29925202,32238,295.27,90.76,274087.56,0,17.12,19.14,0.01
3021,0,29957571,32369,296.48,274384.03,2,29957571,0,29957571,32369,296.47,90.83,274384.03,1,18.11,19.14,0.04
3022,0,29989795,32224,295.14,274679.19,2,29989795,0,29989795,32224,295.14,90.89,274679.19,1,17.52,19.14,0.01
3023,0,30015646,25851,236.76,274915.94,2,30018615,2969,30015646,25851,236.77,90.94,274915.94,0,23.22,19.00,0.01
3024,0,30015646,0,0.00,274915.94,2,30027862,12216,30015646,0,0.00,90.91,274915.94,1,23.45,19.00,0.03
3025,0,30015646,0,0.00,274915.94,2,30033013,17367,30015646,0,0.00,90.88,274915.94,0,23.73,19.00,0.03
3026,0,30015646,0,0.00,274915.94,2,30037203,21557,30015646,0,0.00,90.85,274915.94,1,24.01,19.00,0.03
3027,0,30015646,0,0.00,274915.94,2,30040785,25139,30015646,0,0.00,90.82,274915.94,0,23.63,19.00,0.03
3028,0,30015646,0,0.00,274915.94,2,30044255,28609,30015646,0,0.00,90.79,274915.94,1,23.63,19.00,0.03
3029,0,30015646,0,0.00,274915.94,2,30047465,31819,30015646,0,0.00,90.76,274915.94,0,21.63,19.00,0.03
3030,0,30015646,0,0.00,274915.94,2,30050177,34531,30015646,0,0.00,90.73,274915.94,1,21.63,19.00,0.03
3031,0,30015646,0,0.00,274915.94,2,30052939,37293,30015646,0,0.00,90.70,274915.94,0,20.37,19.37,0.03
3032,0,30015646,0,0.00,274915.94,2,30055592,39946,30015646,0,0.00,90.67,274915.94,1,20.37,19.37,0.03
3033,0,30020808,5162,47.28,274963.22,2,30058173,37365,30020808,5162,47.28,90.66,274963.22,0,18.90,19.37,0.03
3034,0,30025888,5080,46.53,275009.75,2,30060713,34825,30025888,5080,46.53,90.64,275009.75,1,18.95,19.37,0.03
3035,0,30030682,4794,43.91,275053.66,2,30063110,32428,30030682,4794,43.91,90.63,275053.66,0,17.27,19.37,0.03
3036,0,30035476,4794,43.91,275097.56,2,30065507,30031,30035476,4794,43.91,90.61,275097.56,1,17.31,19.37,0.03
3037,0,30040252,4776,43.74,275141.31,2,30067895,27643,30040252,4776,43.74,90.60,275141.31,0,16.65,19.37,0.03
3038,0,30045164,4912,44.99,275186.31,2,30070351,25187,30045164,4912,44.99,90.58,275186.31,0,16.70,19.37,0.03
3039,0,30049970,4806,44.02,275230.31,2,30072754,22784,30049970,4806,44.02,90.57,275230.31,1,16.92,19.37,0.07
3040,0,30054790,4820,44.15,275274.47,2,30075164,20374,30054790,4820,44.15,90.55,275274.47,0,15.12,19.37,0.01
3041,0,30059562,4772,43.71,275318.19,2,30077550,17988,30059562,4772,43.71,90.54,275318.19,1,15.16,19.37,0.04
3042,0,30064666,5104,46.75,275364.94,2,30080102,15436,30064666,5104,46.75,90.52,275364.94,0,13.67,19.37,0.04
3043,0,30070734,6068,55.58,275420.50,2,30083136,12402,30070734,6068,55.58,90.51,275420.50,1,13.71,19.37,0.03
3044,0,30083958,13224,121.12,275541.62,2,30089748,5790,30083958,13224,121.12,90.52,275541.62,1,12.63,19.37,0.03
3045,0,30112227,28269,258.93,275800.56,2,30112227,0,30112227,28269,258.92,90.57,275800.56,0,12.75,19.37,0.03
3046,0,30144859,32632,298.88,276099.44,2,30144859,0,30144859,32632,298.88,90.64,276099.44,1,13.02,19.37,0.07
3047,0,30177459,32600,298.59,276398.03,2,30177459,0,30177459,32600,298.59,90.71,276398.03,0,12.81,19.37,0.02
3048,0,30210479,33020,302.43,276700.44,2,30210479,0,30210479,33020,302.43,90.78,276700.44,1,14.04,19.37,0.05
3049,0,30242826,32347,296.26,276996.72,2,30242826,0,30242826,32347,296.27,90.85,276996.72,0,13.85,19.37,0.02
3050,0,30274915,32089,293.92,277290.62,2,30274915,0,30274915,32089,293.91,90.91,277290.62,1,14.80,19.37,0.05
3051,0,30307519,32604,298.62,277589.25,2,30307519,0,30307519,32604,298.62,90.98,277589.25,0,14.19,19.37,0.01
3052,0,30339626,32107,294.06,277883.31,2,30339626,0,30339626,32107,294.07,91.05,277883.31,1,15.46,19.37,0.04
3053,0,30339626,0,0.00,277883.31,2,30350332,10706,30339626,0,0.00,91.02,277883.31,0,20.72,19.72,0.01
3054,0,30339626,0,0.00,277883.31,2,30356497,16871,30339626,0,0.00,90.99,277883.31,1,21.88,19.00,0.04
3055,0,30339626,0,0.00,277883.31,2,30361195,21569,30339626,0,0.00,90.96,277883.31,0,21.19,19.00,0.04
3056,0,30339626,0,0.00,277883.31,2,30365352,25726,30339626,0,0.00,90.93,277883.31,1,21.19,19.00,0.03
3057,0,30339626,0,0.00,277883.31,2,30368869,29243,30339626,0,0.00,90.90,277883.31,0,20.27,19.27,0.03
3058,0,30339626,0,0.00,277883.31,2,30371962,32336,30339626,0,0.00,90.87,277883.31,0,20.27,19.27,0.03
3059,0,30339626,0,0.00,277883.31,2,30374988,35362,30339626,0,0.00,90.84,277883.31,1,20.38,19.38,0.07
3060,0,30345464,5838,53.47,277936.78,2,30377907,32443,30345464,5838,53.47,90.83,277936.78,0,18.46,19.38,0.01
3061,0,30351268,5804,53.16,277989.94,2,30380809,29541,30351268,5804,53.16,90.82,277989.94,1,18.52,19.38,0.04
3062,0,30356846,5578,51.09,278041.03,2,30383598,26752,30356846,5578,51.09,90.80,278041.03,0,17.23,19.38,0.01
3063,0,30362138,5292,48.47,278089.50,2,30386244,24106,30362138,5292,48.47,90.79,278089.50,1,17.28,19.38,0.04
3064,0,30367616,5478,50.17,278139.66,2,30388983,21367,30367616,5478,50.17,90.78,278139.66,1,14.38,19.38,0.04
3065,0,30373056,5440,49.83,278189.50,2,30391703,18647,30373056,5440,49.83,90.76,278189.50,0,14.43,19.38,0.03
3066,0,30378586,5530,50.65,278240.16,2,30394468,15882,30378586,5530,50.65,90.75,278240.16,1,14.48,19.38,0.07
3067,0,30384930,6344,58.11,278298.25,2,30397640,12710,30384930,6344,58.11,90.74,278298.25,0,12.98,19.38,0.03
3068,0,30397182,12252,112.22,278410.47,2,30403766,6584,30397182,12252,112.22,90.75,278410.47,1,13.04,19.38,0.06
3069,0,30424125,26943,246.76,278657.22,2,30424125,0,30424125,26943,246.77,90.80,278657.22,0,11.85,19.38,0.02
3070,0,30456337,32212,295.03,278952.28,2,30456337,0,30456337,32212,295.03,90.86,278952.28,1,13.16,19.38,0.06
3071,0,30488621,32284,295.69,279247.97,2,30488621,0,30488621,32284,295.69,90.93,279247.97,0,13.98,19.38,0.02
3072,0,30520456,31835,291.59,279539.53,2,30520456,0,30520456,31835,291.58,91.00,279539.53,1,16.35,19.38,0.05
3073,0,30552742,32286,295.71,279835.25,2,30552742,0,30552742,32286,295.71,91.06,279835.25,0,17.52,19.38,0.02
3074,0,30552742,0,0.00,279835.25,2,30563467,10725,30552742,0,0.00,91.03,279835.25,1,19.59,18.59,0.05
3075,0,30552742,0,0.00,279835.25,2,30569366,16624,30552742,0,0.00,91.00,279835.25,0,19.60,18.60,0.00
3076,0,30552742,0,0.00,279835.25,2,30573995,21253,30552742,0,0.00,90.97,279835.25,1,19.93,18.93,0.03
3077,0,30552742,0,0.00,279835.25,2,30577978,25236,30552742,0,0.00,90.94,279835.25,0,19.59,18.59,0.03
3078,0,30552742,0,0.00,279835.25,2,30581526,28784,30552742,0,0.00,90.91,279835.25,0,19.59,18.59,0.03
3079,0,30552742,0,0.00,279835.25,2,30584776,32034,30552742,0,0.00,90.89,279835.25,1,20.24,19.24,0.06
3080,0,30558982,6240,57.15,279892.41,2,30587896,28914,30558982,6240,57.15,90.87,279892.41,0,18.15,19.24,0.00
3081,0,30565080,6098,55.85,279948.25,2,30590945,25865,30565080,6098,55.85,90.86,279948.25,1,18.53,19.24,0.03
3082,0,30570750,5670,51.93,280000.19,2,30593780,23030,30570750,5670,51.93,90.85,280000.19,0,17.76,19.24,0.00
3083,0,30576372,5622,51.49,280051.69,2,30596591,20219,30576372,5622,51.49,90.84,280051.69,1,18.38,19.24,0.03
3084,0,30582304,5932,54.33,280106.03,2,30599557,17253,30582304,5932,54.33,90.83,280106.03,1,15.89,19.24,0.03
3085,0,30588326,6022,55.16,280161.19,2,30602568,14242,30588326,6022,55.16,90.81,280161.19,0,15.94,19.24,0.03
3086,0,30596376,8050,73.73,280234.91,2,30606593,10217,30596376,8050,73.73,90.81,280234.91,1,16.28,19.24,0.06
3087,0,30617723,21347,195.53,280430.44,2,30617723,0,30617723,21347,195.52,90.84,280430.44,0,16.34,19.24,0.04
3088,0,30650119,32396,296.72,280727.16,2,30650119,0,30650119,32396,296.72,90.91,280727.16,1,16.66,19.24,0.07
3089,0,30682435,32316,295.99,281023.12,2,30682435,0,30682435,32316,295.99,90.98,281023.12,0,17.37,19.24,0.03
3090,0,30715071,32636,298.92,281322.06,2,30715071,0,30715071,32636,298.92,91.04,281322.06,1,18.71,19.24,0.06
3091,0,30747793,32722,299.69,281621.75,2,30747793,0,30747793,32722,299.70,91.11,281621.75,0,17.69,19.24,0.03
3092,0,30780577,32784,300.27,281922.00,2,30780577,0,30780577,32784,300.27,91.18,281922.00,1,18.93,19.24,0.07
3093,0,30780577,0,0.00,281922.00,2,30791177,10600,30780577,0,0.00,91.15,281922.00,0,20.01,19.01,0.04
3094,0,30780577,0,0.00,281922.00,2,30796844,16267,30780577,0,0.00,91.12,281922.00,1,22.01,19.00,0.07
3095,0,30780577,0,0.00,281922.00,2,30801202,20625,30780577,0,0.00,91.09,281922.00,0,20.89,19.89,0.05
3096,0,30780577,0,0.00,281922.00,2,30805023,24446,30780577,0,0.00,91.06,281922.00,1,21.18,19.00,0.09
3097,0,30780577,0,0.00,281922.00,2,30808310,27733,30780577,0,0.00,91.03,281922.00,0,21.24,19.00,0.06
3098,0,30780577,0,0.00,281922.00,2,30811362,30785,30780577,0,0.00,91.00,281922.00,0,21.52,19.00,0.09
3099,0,30780577,0,0.00,281922.00,2,30814251,33674,30780577,0,0.00,90.97,281922.00,1,21.52,19.00,0.12
3100,0,30780577,0,0.00,281922.00,2,30816980,36403,30780577,0,0.00,90.94,281922.00,0,20.56,19.56,0.11
3101,0,30780577,0,0.00,281922.00,2,30819551,38974,30780577,0,0.00,90.91,281922.00,1,20.85,19.85,0.14
3102,0,30780577,0,0.00,281922.00,2,30822102,41525,30780577,0,0.00,90.88,281922.00,1,20.73,19.73,0.10
3103,0,30785555,4978,45.61,281967.62,2,30824591,39036,30785555,4978,45.59,90.87,281967.62,0,19.65,19.73,0.07
3104,0,30790521,4966,45.47,282013.09,2,30827074,36553,30790521,4966,45.48,90.85,282013.09,1,19.69,19.73,0.10
3105,0,30795403,4882,44.73,282057.81,2,30829515,34112,30795403,4882,44.71,90.84,282057.81,0,18.75,19.73,0.09
3106,0,30800261,4858,44.48,282102.28,2,30831944,31683,30800261,4858,44.49,90.82,282102.28,1,18.79,19.73,0.12
3107,0,30805049,4788,43.85,282146.16,2,30834338,29289,30805049,4788,43.85,90.81,282146.16,1,17.03,19.73,0.07
3108,0,30809809,4760,43.60,282189.75,2,30836718,26909,30809809,4760,43.60,90.79,282189.75,0,16.86,19.73,0.06
3109,0,30814329,4520,41.40,282231.16,2,30838978,24649,30814329,4520,41.40,90.78,282231.16,0,17.76,19.73,0.09
3110,0,30818769,4440,40.67,282271.81,2,30841198,22429,30818769,4440,40.67,90.76,282271.81,1,18.26,19.73,0.12
3111,0,30823223,4454,40.81,282312.62,2,30843425,20202,30823223,4454,40.79,90.75,282312.62,0,16.12,19.73,0.05
3112,0,30828113,4890,44.77,282357.41,2,30845870,17757,30828113,4890,44.79,90.73,282357.41,1,16.44,19.73,0.08
3113,0,30833257,5144,47.11,282404.50,2,30848442,15185,30833257,5144,47.11,90.72,282404.50,0,15.79,19.73,0.07
3114,0,30839809,6552,60.01,282464.53,2,30851718,11909,30839809,6552,60.01,90.71,282464.53,1,15.84,19.73,0.10
3115,0,30854701,14892,136.40,282600.91,2,30859164,4463,30854701,14892,136.40,90.72,282600.91,0,14.67,19.73,0.02
3116,0,30884546,29845,273.36,282874.28,2,30884546,0,30884546,29845,273.35,90.78,282874.28,1,14.86,19.73,0.06
3117,0,30917082,32536,298.00,283172.28,2,30917082,0,30917082,32536,298.00,90.85,283172.28,0,14.56,19.73,0.05
3118,0,30949554,32472,297.41,283469.69,2,30949554,0,30949554,32472,297.41,90.91,283469.69,1,15.20,19.73,0.08
3119,0,30981515,31961,292.74,283762.44,2,30981515,0,30981515,31961,292.73,90.98,283762.44,0,15.92,19.73,0.04
3120,0,31013251,31736,290.67,284053.09,2,31013251,0,31013251,31736,290.67,91.04,284053.09,1,16.45,19.73,0.07
3121,0,31044907,31656,289.94,284343.06,2,31044907,0,31044907,31656,289.94,91.11,284343.06,0,15.95,19.73,0.04
3122,0,31076376,31469,288.22,284631.28,2,31076376,0,31076376,31469,288.23,91.17,284631.28,1,17.77,19.73,0.08
3123,0,31108414,32038,293.44,284924.72,2,31108414,0,31108414,32038,293.44,91.23,284924.72,0,18.81,19.73,0.05
3124,0,31108414,0,0.00,284924.72,2,31118981,10567,31108414,0,0.00,91.21,284924.72,1,24.19,19.00,0.09
3125,0,31108414,0,0.00,284924.72,2,31124783,16369,31108414,0,0.00,91.18,284924.72,0,24.63,19.00,0.06
3126,0,31108414,0,0.00,284924.72,2,31129343,20929,31108414,0,0.00,91.15,284924.72,1,24.91,19.00,0.09
3127,0,31108414,0,0.00,284924.72,2,31133304,24890,31108414,0,0.00,91.12,284924.72,0,23.64,19.00,0.07
3128,0,31108414,0,0.00,284924.72,2,31136782,28368,31108414,0,0.00,91.09,284924.72,1,23.80,19.00,0.10
3129,0,31108414,0,0.00,284924.72,2,31139850,31436,31108414,0,0.00,91.06,284924.72,0,22.41,19.00,0.05
3130,0,31108414,0,0.00,284924.72,2,31142902,34488,31108414,0,0.00,91.03,284924.72,1,22.57,19.00,0.09
3131,0,31108414,0,0.00,284924.72,2,31145750,37336,31108414,0,0.00,91.00,284924.72,0,21.42,19.00,0.07
3132,0,31108414,0,0.00,284924.72,2,31148428,40014,31108414,0,0.00,90.97,284924.72,1,21.42,19.00,0.10
3133,0,31108414,0,0.00,284924.72,2,31150943,42529,31108414,0,0.00,90.94,284924.72,0,19.43,18.43,0.04
3134,0,31108414,0,0.00,284924.72,2,31153334,44920,31108414,0,0.00,90.91,284924.72,1,19.43,18.43,0.07
3135,0,31113020,4606,42.19,284966.91,2,31155637,42617,31113020,4606,42.19,90.90,284966.91,0,18.35,18.43,0.05
3136,0,31117650,4630,42.41,285009.31,2,31157952,40302,31117650,4630,42.41,90.88,285009.31,1,18.39,18.43,0.09
3137,0,31122196,4546,41.64,285050.94,2,31160225,38029,31122196,4546,41.64,90.87,285050.94,0,16.74,18.43,0.04
3138,0,31126712,4516,41.36,285092.31,2,31162483,35771,31126712,4516,41.36,90.85,285092.31,0,16.78,18.43,0.07
3139,0,31131076,4364,39.97,285132.28,2,31164665,33589,31131076,4364,39.97,90.84,285132.28,1,16.82,18.43,0.11
3140,0,31135458,4382,40.14,285172.41,2,31166856,31398,31135458,4382,40.14,90.82,285172.41,0,15.48,18.43,0.07
3141,0,31139586,4128,37.81,285210.22,2,31168920,29334,31139586,4128,37.81,90.80,285210.22,1,15.58,18.43,0.11
3142,0,31143514,3928,35.98,285246.19,2,31170884,27370,31143514,3928,35.98,90.78,285246.19,0,14.25,18.43,0.08
3143,0,31147424,3910,35.81,285282.00,2,31172839,25415,31147424,3910,35.81,90.77,285282.00,1,14.28,18.43,0.11
3144,0,31151662,4238,38.82,285320.81,2,31174958,23296,31151662,4238,38.82,90.75,285320.81,1,12.76,18.43,0.07
3145,0,31156034,4372,40.04,285360.88,2,31177144,21110,31156034,4372,40.04,90.73,285360.88,0,13.39,18.43,0.07
3146,0,31160650,4616,42.28,285403.12,2,31179452,18802,31160650,4616,42.28,90.72,285403.12,1,13.43,18.43,0.11
3147,0,31165484,4834,44.28,285447.41,2,31181869,16385,31165484,4834,44.28,90.70,285447.41,0,12.12,18.43,0.08
3148,0,31171250,5766,52.81,285500.22,2,31184752,13502,31171250,5766,52.81,90.69,285500.22,1,12.42,18.43,0.11
3149,0,31181888,10638,97.43,285597.66,2,31190071,8183,31181888,10638,97.43,90.69,285597.66,0,11.43,18.43,0.09
3150,0,31204558,22670,207.64,285805.31,2,31204558,0,31204558,22670,207.64,90.73,285805.31,1,11.81,18.43,0.13
3151,0,31236342,31784,291.11,286096.41,2,31236342,0,31236342,31784,291.11,90.80,286096.41,0,13.02,18.43,0.11
3152,0,31267813,31471,288.24,286384.66,2,31267813,0,31267813,31471,288.25,90.86,286384.66,1,15.25,18.43,0.15
3153,0,31300098,32285,295.71,286680.34,2,31300098,0,31300098,32285,295.70,90.92,286680.34,1,15.91,18.43,0.11
3154,0,31331906,31808,291.33,286971.69,2,31331906,0,31331906,31808,291.33,90.99,286971.69,0,17.34,18.43,0.11
3155,0,31331906,0,0.00,286971.69,2,31342360,10454,31331906,0,0.00,90.96,286971.69,0,19.54,18.54,0.14
3156,0,31331906,0,0.00,286971.69,2,31348153,16247,31331906,0,0.00,90.93,286971.69,1,21.54,19.00,0.17
3157,0,31331906,0,0.00,286971.69,2,31352815,20909,31331906,0,0.00,90.90,286971.69,0,19.74,18.74,0.12
3158,0,31331906,0,0.00,286971.69,2,31356870,24964,31331906,0,0.00,90.87,286971.69,1,20.31,19.31,0.15
3159,0,31331906,0,0.00,286971.69,2,31360372,28466,31331906,0,0.00,90.84,286971.69,0,20.86,19.86,0.14
3160,0,31331906,0,0.00,286971.69,2,31363399,31493,31331906,0,0.00,90.81,286971.69,1,20.86,19.86,0.17
3161,0,31337928,6022,55.16,287026.84,2,31366410,28482,31337928,6022,55.16,90.80,287026.84,0,19.26,19.86,0.13
3162,0,31344168,6240,57.15,287084.00,2,31369530,25362,31344168,6240,57.15,90.79,287084.00,1,19.31,19.86,0.17
3163,0,31344168,0,0.00,287084.00,2,31372418,28250,31344168,0,0.00,90.76,287084.00,0,19.98,18.98,0.15
3164,0,31344168,0,0.00,287084.00,2,31375059,30891,31344168,0,0.00,90.73,287084.00,1,20.28,19.28,0.18
3165,0,31349126,4958,45.41,287129.41,2,31377538,28412,31349126,4958,45.41,90.72,287129.41,0,18.51,19.28,0.13
3166,0,31353958,4832,44.26,287173.66,2,31379954,25996,31353958,4832,44.26,90.71,287173.66,1,18.56,19.28,0.16
3167,0,31358724,4766,43.65,287217.31,2,31382337,23613,31358724,4766,43.65,90.69,287217.31,1,17.66,19.28,0.15
3168,0,31363444,4720,43.23,287260.56,2,31384697,21253,31363444,4720,43.23,90.68,287260.56,0,16.53,19.28,0.13
3169,0,31368282,4838,44.31,287304.88,2,31387116,18834,31368282,4838,44.31,90.66,287304.88,1,17.15,19.28,0.16
3170,0,31373198,4916,45.03,287349.88,2,31389574,16376,31373198,4916,45.03,90.65,287349.88,0,17.10,19.28,0.14
3171,0,31378876,5678,52.01,287401.91,2,31392413,13537,31378876,5678,52.01,90.63,287401.91,1,17.43,19.28,0.17
3172,0,31389620,10744,98.41,287500.28,2,31397785,8165,31389620,10744,98.41,90.64,287500.28,0,16.27,19.28,0.15
3173,0,31413406,23786,217.86,287718.16,2,31413406,0,31413406,23786,217.86,90.68,287718.16,0,16.37,19.28,0.18
3174,0,31445944,32538,298.02,288016.19,2,31445944,0,31445944,32538,298.02,90.74,288016.19,1,17.50,19.28,0.21
3175,0,31477950,32006,293.15,288309.31,2,31477950,0,31477950,32006,293.15,90.81,288309.31,0,16.70,19.28,0.19
3176,0,31509882,31932,292.47,288601.78,2,31509882,0,31509882,31932,292.47,90.87,288601.78,1,16.99,19.28,0.22
3177,0,31542078,32196,294.89,288896.69,2,31542078,0,31542078,32196,294.89,90.93,288896.69,0,16.35,19.28,0.16
3178,0,31573595,31517,288.68,289185.34,2,31573595,0,31573595,31517,288.67,91.00,289185.34,0,18.78,19.28,0.19
3179,0,31573595,0,0.00,289185.34,2,31584477,10882,31573595,0,0.00,90.97,289185.34,0,21.14,19.00,0.22
3180,0,31573595,0,0.00,289185.34,2,31590101,16506,31573595,0,0.00,90.94,289185.34,1,22.45,19.00,0.26
3181,0,31573595,0,0.00,289185.34,2,31594801,21206,31573595,0,0.00,90.91,289185.34,1,21.76,19.00,0.23
3182,0,31573595,0,0.00,289185.34,2,31598885,25290,31573595,0,0.00,90.88,289185.34,0,21.68,19.00,0.18
3183,0,31573595,0,0.00,289185.34,2,31602531,28936,31573595,0,0.00,90.85,289185.34,1,21.79,19.00,0.21
3184,0,31573595,0,0.00,289185.34,2,31605851,32256,31573595,0,0.00,90.82,289185.34,0,19.91,18.91,0.16
3185,0,31573595,0,0.00,289185.34,2,31608919,35324,31573595,0,0.00,90.80,289185.34,1,19.91,18.91,0.19
3186,0,31573595,0,0.00,289185.34,2,31611789,38194,31573595,0,0.00,90.77,289185.34,0,19.30,18.30,0.18
3187,0,31573595,0,0.00,289185.34,2,31614489,40894,31573595,0,0.00,90.74,289185.34,1,20.75,19.75,0.22
3188,0,31578561,4966,45.47,289230.81,2,31616972,38411,31578561,4966,45.48,90.72,289230.81,1,19.57,19.75,0.18
3189,0,31583337,4776,43.74,289274.56,2,31619360,36023,31583337,4776,43.74,90.71,289274.56,0,18.45,19.75,0.16
3190,0,31588357,5020,45.98,289320.53,2,31621870,33513,31588357,5020,45.98,90.70,289320.53,1,18.49,19.75,0.19
3191,0,31593379,5022,46.02,289366.56,2,31624381,31002,31593379,5022,46.00,90.68,289366.56,0,17.34,19.75,0.17
3192,0,31598385,5006,45.83,289412.38,2,31626884,28499,31598385,5006,45.85,90.67,289412.38,1,17.67,19.75,0.20
3193,0,31603281,4896,44.84,289457.22,2,31629332,26051,31603281,4896,44.84,90.65,289457.22,0,17.73,19.75,0.17
3194,0,31608125,4844,44.37,289501.59,2,31631754,23629,31608125,4844,44.37,90.64,289501.59,1,18.06,19.75,0.20
3195,0,31612905,4780,43.78,289545.38,2,31634144,21239,31612905,4780,43.78,90.62,289545.38,0,16.40,19.75,0.16
3196,0,31617773,4868,44.59,289589.97,2,31636578,18805,31617773,4868,44.59,90.61,289589.97,1,16.44,19.75,0.19
3197,0,31623013,5240,47.99,289637.97,2,31639198,16185,31623013,5240,47.99,90.60,289637.97,0,15.34,19.75,0.17
3198,0,31629159,6146,56.31,289694.25,2,31642271,13112,31629159,6146,56.29,90.59,289694.25,1,15.39,19.75,0.20
3199,0,31642153,12994,118.99,289813.25,2,31648768,6615,31642153,12994,119.01,90.59,289813.25,0,13.72,19.75,0.15
3200,0,31668610,26457,242.33,290055.59,2,31668610,0,31668610,26457,242.32,90.64,290055.59,1,14.73,19.75,0.19
3201,0,31701144,32534,297.98,290353.56,2,31701144,0,31701144,32534,297.98,90.71,290353.56,0,13.99,19.75,0.17
3202,0,31733897,32753,299.98,290653.56,2,31733897,0,31733897,32753,299.99,90.77,290653.56,1,14.55,19.75,0.20
3203,0,31766496,32599,298.59,290952.12,2,31766496,0,31766496,32599,298.58,90.84,290952.12,0,14.67,19.75,0.17
3204,0,31799068,32572,298.33,291250.47,2,31799068,0,31799068,32572,298.33,90.90,291250.47,1,17.25,19.75,0.20
3205,0,31831129,32061,293.64,291544.09,2,31831129,0,31831129,32061,293.65,90.97,291544.09,0,18.97,19.75,0.17
3206,0,31831129,0,0.00,291544.09,2,31841580,10451,31831129,0,0.00,90.94,291544.09,1,21.27,19.00,0.20
3207,0,31831129,0,0.00,291544.09,2,31847315,16186,31831129,0,0.00,90.91,291544.09,0,20.30,19.30,0.17
3208,0,31831129,0,0.00,291544.09,2,31851680,20551,31831129,0,0.00,90.88,291544.09,1,22.09,19.00,0.21
3209,0,31831129,0,0.00,291544.09,2,31855478,24349,31831129,0,0.00,90.85,291544.09,0,21.09,19.00,0.18
3210,0,31831129,0,0.00,291544.09,2,31858843,27714,31831129,0,0.00,90.82,291544.09,1,21.09,19.00,0.21
3211,0,31831129,0,0.00,291544.09,2,31861856,30727,31831129,0,0.00,90.80,291544.09,0,19.68,18.68,0.18
3212,0,31831129,0,0.00,291544.09,2,31864667,33538,31831129,0,0.00,90.77,291544.09,1,19.97,18.97,0.21
3213,0,31831129,0,0.00,291544.09,2,31867312,36183,31831129,0,0.00,90.74,291544.09,0,20.12,19.12,0.18
3214,0,31831129,0,0.00,291544.09,2,31869742,38613,31831129,0,0.00,90.71,291544.09,1,20.41,19.41,0.22
3215,0,31835677,4548,41.66,291585.75,2,31872016,36339,31835677,4548,41.66,90.70,291585.75,0,18.69,19.41,0.17
3216,0,31840423,4746,43.49,291629.25,2,31874389,33966,31840423,4746,43.47,90.68,291629.25,1,18.73,19.41,0.20
3217,0,31845273,4850,44.40,291673.66,2,31876814,31541,31845273,4850,44.42,90.67,291673.66,0,17.58,19.41,0.18
3218,0,31850327,5054,46.31,291719.97,2,31879341,29014,31850327,5054,46.29,90.65,291719.97,1,17.62,19.41,0.21
3219,0,31855267,4940,45.25,291765.22,2,31881811,26544,31855267,4940,45.25,90.64,291765.22,0,18.14,19.41,0.19
3220,0,31860233,4966,45.47,291810.69,2,31884294,24061,31860233,4966,45.48,90.62,291810.69,1,18.51,19.41,0.22
3221,0,31865183,4950,45.36,291856.03,2,31886769,21586,31865183,4950,45.34,90.61,291856.03,1,17.45,19.41,0.20
3222,0,31870099,4916,45.03,291901.06,2,31889227,19128,31870099,4916,45.03,90.60,291901.06,0,16.28,19.41,0.18
3223,0,31875285,5186,47.48,291948.53,2,31891820,16535,31875285,5186,47.50,90.58,291948.53,0,16.32,19.41,0.21
3224,0,31881251,5966,54.66,292003.19,2,31894803,13552,31881251,5966,54.64,90.57,292003.19,1,16.37,19.41,0.24
3225,0,31893091,11840,108.44,292111.62,2,31900723,7632,31893091,11840,108.44,90.58,292111.62,0,14.93,19.41,0.20
3226,0,31918804,25713,235.50,292347.12,2,31918804,0,31918804,25713,235.51,90.62,292347.12,1,15.13,19.41,0.24
3227,0,31951011,32207,295.00,292642.12,2,31951011,0,31951011,32207,294.99,90.69,292642.12,0,13.87,19.41,0.20
3228,0,31983409,32398,296.72,292938.84,2,31983409,0,31983409,32398,296.74,90.75,292938.84,1,14.97,19.41,0.23
3229,0,32016168,32759,300.05,293238.91,2,32016168,0,32016168,32759,300.04,90.81,293238.91,0,16.18,19.41,0.22
3230,0,32048807,32639,298.95,293537.84,2,32048807,0,32048807,32639,298.94,90.88,293537.84,1,17.74,19.41,0.25
3231,0,32081626,32819,300.58,293838.44,2,32081626,0,32081626,32819,300.59,90.94,293838.44,0,17.07,19.41,0.21
3232,0,32114130,32504,297.71,294136.16,2,32114130,0,32114130,32504,297.71,91.01,294136.16,1,17.36,19.41,0.24
3233,0,32146936,32806,300.47,294436.62,2,32146936,0,32146936,32806,300.47,91.07,294436.62,0,17.60,19.41,0.22
3234,0,32179930,32994,302.19,294738.81,2,32179930,0,32179930,32994,302.19,91.14,294738.81,1,17.89,19.41,0.26
3235,0,32179930,0,0.00,294738.81,2,32190560,10630,32179930,0,0.00,91.11,294738.81,0,24.37,19.00,0.22
3236,0,32179930,0,0.00,294738.81,2,32196144,16214,32179930,0,0.00,91.08,294738.81,1,26.97,19.00,0.25
3237,0,32179930,0,0.00,294738.81,2,32200423,20493,32179930,0,0.00,91.05,294738.81,0,25.74,19.00,0.23
3238,0,32179930,0,0.00,294738.81,2,32204163,24233,32179930,0,0.00,91.02,294738.81,1,25.97,19.00,0.26
3239,0,32179930,0,0.00,294738.81,2,32207367,27437,32179930,0,0.00,91.00,294738.81,0,24.83,19.00,0.24
3240,0,32179930,0,0.00,294738.81,2,32210307,30377,32179930,0,0.00,90.97,294738.81,1,24.83,19.00,0.27
3241,0,32179930,0,0.00,294738.81,2,32213207,33277,32179930,0,0.00,90.94,294738.81,0,23.63,19.00,0.25
3242,0,32179930,0,0.00,294738.81,2,32216002,36072,32179930,0,0.00,90.91,294738.81,1,23.63,19.00,0.28
3243,0,32179930,0,0.00,294738.81,2,32218641,38711,32179930,0,0.00,90.88,294738.81,0,22.49,19.00,0.26
3244,0,32179930,0,0.00,294738.81,2,32221141,41211,32179930,0,0.00,90.86,294738.81,1,22.49,19.00,0.29
3245,0,32179930,0,0.00,294738.81,2,32223524,43594,32179930,0,0.00,90.83,294738.81,0,21.41,19.00,0.28
3246,0,32179930,0,0.00,294738.81,2,32225631,45701,32179930,0,0.00,90.80,294738.81,1,21.41,19.00,0.31
3247,0,32179930,0,0.00,294738.81,2,32227667,47737,32179930,0,0.00,90.77,294738.81,0,20.29,19.29,0.29
3248,0,32179930,0,0.00,294738.81,2,32229774,49844,32179930,0,0.00,90.74,294738.81,1,20.47,19.47,0.32
3249,0,32179930,0,0.00,294738.81,2,32231808,51878,32179930,0,0.00,90.72,294738.81,0,19.60,18.60,0.30
3250,0,32179930,0,0.00,294738.81,2,32233791,53861,32179930,0,0.00,90.69,294738.81,1,19.91,18.91,0.33
3251,0,32179930,0,0.00,294738.81,2,32235706,55776,32179930,0,0.00,90.66,294738.81,0,18.91,17.91,0.31
3252,0,32179930,0,0.00,294738.81,2,32237568,57638,32179930,0,0.00,90.63,294738.81,1,19.22,18.22,0.34
3253,0,32183600,3670,33.61,294772.44,2,32239403,55803,32183600,3670,33.61,90.62,294772.44,0,17.99,18.22,0.31
3254,0,32183600,0,0.00,294772.44,2,32241209,57609,32183600,0,0.00,90.59,294772.44,1,18.26,17.26,0.34
3255,0,32183600,0,0.00,294772.44,2,32242953,59353,32183600,0,0.00,90.56,294772.44,0,17.50,16.50,0.33
3256,0,32183600,0,0.00,294772.44,2,32244646,61046,32183600,0,0.00,90.53,294772.44,1,17.74,16.74,0.36
3257,0,32186936,3336,30.55,294802.97,2,32246314,59378,32186936,3336,30.55,90.51,294802.97,0,16.66,16.74,0.33
3258,0,32186936,0,0.00,294802.97,2,32247962,61026,32186936,0,0.00,90.49,294802.97,0,16.88,15.88,0.36
3259,0,32186936,0,0.00,294802.97,2,32249564,62628,32186936,0,0.00,90.46,294802.97,1,17.07,16.07,0.39
3260,0,32186936,0,0.00,294802.97,2,32251130,64194,32186936,0,0.00,90.43,294802.97,0,16.20,15.20,0.38
3261,0,32186936,0,0.00,294802.97,2,32252665,65729,32186936,0,0.00,90.40,294802.97,1,16.20,15.20,0.41
3262,0,32189922,2986,27.35,294830.34,2,32254158,64236,32189922,2986,27.35,90.38,294830.34,0,15.09,15.20,0.38
3263,0,32192734,2812,25.76,294856.09,2,32255564,62830,32192734,2812,25.76,90.36,294856.09,1,15.12,15.20,0.42
3264,0,32195486,2752,25.21,294881.28,2,32256940,61454,32195486,2752,25.21,90.34,294881.28,1,13.92,15.20,0.39
3265,0,32198284,2798,25.63,294906.91,2,32258339,60055,32198284,2798,25.63,90.32,294906.91,0,13.35,15.20,0.39
3266,0,32201044,2760,25.28,294932.19,2,32259719,58675,32201044,2760,25.28,90.30,294932.19,1,13.57,15.20,0.42
3267,0,32203794,2750,25.19,294957.38,2,32261094,57300,32203794,2750,25.19,90.28,294957.38,0,12.64,15.20,0.40
3268,0,32206546,2752,25.21,294982.59,2,32262470,55924,32206546,2752,25.21,90.26,294982.59,1,12.67,15.20,0.43
3269,0,32209348,2802,25.66,295008.25,2,32263871,54523,32209348,2802,25.66,90.24,295008.25,0,11.65,15.20,0.42
3270,0,32212154,2806,25.70,295033.97,2,32265274,53120,32212154,2806,25.70,90.22,295033.97,1,11.68,15.20,0.45
3271,0,32215066,2912,26.67,295060.62,2,32266730,51664,32215066,2912,26.67,90.21,295060.62,0,10.31,15.20,0.42
3272,0,32218008,2942,26.95,295087.56,2,32268201,50193,32218008,2942,26.95,90.19,295087.56,1,10.63,15.20,0.45
3273,0,32220908,2900,26.56,295114.12,2,32269651,48743,32220908,2900,26.56,90.17,295114.12,0,9.67,15.20,0.44
3274,0,32223836,2928,26.82,295140.97,2,32271115,47279,32223836,2928,26.82,90.15,295140.97,0,9.70,15.20,0.47
3275,0,32226752,2916,26.71,295167.66,2,32272573,45821,32226752,2916,26.71,90.13,295167.66,1,9.72,15.20,0.50
3276,0,32229618,2866,26.25,295193.91,2,32274006,44388,32229618,2866,26.25,90.11,295193.91,1,9.59,15.20,0.47
3277,0,32232508,2890,26.47,295220.38,2,32275451,42943,32232508,2890,26.47,90.09,295220.38,0,8.50,15.20,0.45
3278,0,32235392,2884,26.41,295246.78,2,32276893,41501,32235392,2884,26.41,90.07,295246.78,0,8.53,15.20,0.48
3279,0,32238282,2890,26.47,295273.28,2,32278338,40056,32238282,2890,26.47,90.05,295273.28,1,8.55,15.20,0.51
3280,0,32241190,2908,26.63,295299.91,2,32279792,38602,32241190,2908,26.63,90.03,295299.91,0,7.42,15.20,0.49
3281,0,32244158,2968,27.18,295327.09,2,32281276,37118,32244158,2968,27.18,90.01,295327.09,1,7.45,15.20,0.52
3282,0,32247120,2962,27.13,295354.22,2,32282757,35637,32247120,2962,27.13,89.99,295354.22,0,6.38,15.20,0.51
3283,0,32250100,2980,27.29,295381.50,2,32284247,34147,32250100,2980,27.29,89.97,295381.50,1,6.41,15.20,0.54
3284,0,32253114,3014,27.61,295409.12,2,32285754,32640,32253114,3014,27.61,89.95,295409.12,0,5.03,15.20,0.51
3285,0,32256186,3072,28.14,295437.25,2,32287290,31104,32256186,3072,28.14,89.94,295437.25,1,5.06,15.20,0.54
3286,0,32259162,2976,27.26,295464.50,2,32288778,29616,32259162,2976,27.26,89.92,295464.50,1,4.48,15.20,0.54
3287,0,32262258,3096,28.36,295492.88,2,32290326,28068,32262258,3096,28.36,89.90,295492.88,0,3.38,15.20,0.52
3288,0,32265584,3326,30.46,295523.31,2,32291989,26405,32265584,3326,30.46,89.88,295523.31,1,3.41,15.20,0.55
3289,0,32269074,3490,31.97,295555.28,2,32293734,24660,32269074,3490,31.97,89.86,295555.28,0,2.55,15.20,0.54
3290,0,32272656,3582,32.81,295588.09,2,32295525,22869,32272656,3582,32.81,89.84,295588.09,1,2.58,15.20,0.57
3291,0,32276426,3770,34.53,295622.62,2,32297410,20984,32276426,3770,34.53,89.83,295622.62,1,1.51,15.20,0.56
3292,0,32280440,4014,36.76,295659.41,2,32299417,18977,32280440,4014,36.76,89.81,295659.41,0,0.66,15.20,0.55
3293,0,32285162,4722,43.25,295702.66,2,32301778,16616,32285162,4722,43.25,89.80,295702.66,1,0.69,15.20,0.58
3294,0,32291644,6482,59.37,295762.00,2,32305019,13375,32291644,6482,59.37,89.79,295762.00,0,0.69,15.20,0.56
3295,0,32303258,11614,106.37,295868.38,2,32310826,7568,32303258,11614,106.37,89.79,295868.38,1,0.69,15.20,0.59
3296,0,32327996,24738,226.58,296094.97,2,32327996,0,32327996,24738,226.58,89.83,296094.97,0,0.69,15.20,0.57
3297,0,32362041,34045,311.81,296406.78,2,32362041,0,32362041,34045,311.82,89.90,296406.78,0,0.69,15.20,0.60
3298,0,32395953,33912,310.60,296717.38,2,32395953,0,32395953,33912,310.60,89.97,296717.38,1,3.22,15.20,0.63
3299,0,32430535,34582,316.76,297034.12,2,32430535,0,32430535,34582,316.74,90.04,297034.12,0,4.41,15.20,0.63
3300,0,32464856,34321,314.34,297348.47,2,32464856,0,32464856,34321,314.35,90.11,297348.47,1,8.01,15.20,0.66
3301,0,32498001,33145,303.57,297652.03,2,32498001,0,32498001,33145,303.58,90.17,297652.03,0,12.95,15.20,0.62
3302,0,32531351,33350,305.47,297957.53,2,32531351,0,32531351,33350,305.46,90.24,297957.53,1,14.80,15.20,0.65
3303,0,32564456,33105,303.20,298260.72,2,32564456,0,32564456,33105,303.21,90.30,298260.72,0,13.73,15.20,0.62
3304,0,32597551,33095,303.13,298563.84,2,32597551,0,32597551,33095,303.12,90.36,298563.84,1,14.02,15.20,0.65
3305,0,32630227,32676,299.28,298863.12,2,32630227,0,32630227,32676,299.28,90.43,298863.12,0,12.96,15.20,0.62
3306,0,32663010,32783,300.25,299163.38,2,32663010,0,32663010,32783,300.26,90.49,299163.38,1,13.34,15.20,0.65
3307,0,32695663,32653,299.08,299462.47,2,32695663,0,32695663,32653,299.07,90.55,299462.47,0,13.88,15.20,0.61
3308,0,32695663,0,0.00,299462.47,2,32706000,10337,32695663,0,0.00,90.53,299462.47,1,16.55,15.55,0.64
3309,0,32715443,19780,181.17,299643.62,2,32715890,447,32715443,19780,181.17,90.55,299643.62,0,15.37,15.55,0.60
3310,0,32715443,0,0.00,299643.62,2,32726034,10591,32715443,0,0.00,90.53,299643.62,1,15.98,14.98,0.63
3311,0,32715443,0,0.00,299643.62,2,32731268,15825,32715443,0,0.00,90.50,299643.62,0,16.99,15.99,0.60
3312,0,32715443,0,0.00,299643.62,2,32734952,19509,32715443,0,0.00,90.47,299643.62,1,16.99,15.99,0.63
3313,0,32722479,7036,64.44,299708.09,2,32738470,15991,32722479,7036,64.44,90.46,299708.09,0,15.09,15.99,0.56
3314,0,32722479,0,0.00,299708.09,2,32742062,19583,32722479,0,0.00,90.44,299708.09,1,17.02,16.02,0.59
3315,0,32729261,6782,62.10,299770.19,2,32745453,16192,32729261,6782,62.12,90.43,299770.19,0,15.65,16.02,0.56
3316,0,32737549,8288,75.91,299846.09,2,32749597,12048,32737549,8288,75.91,90.42,299846.09,1,15.71,16.02,0.59
3317,0,32754231,16682,152.81,299998.91,2,32757938,3707,32754231,16682,152.79,90.44,299998.91,0,13.96,16.02,0.55
3318,0,32754231,0,0.00,299998.91,2,32766543,12312,32754231,0,0.00,90.42,299998.91,1,16.36,15.36,0.58
3319,0,32768875,14644,134.13,300133.03,2,32773865,4990,32768875,14644,134.13,90.43,300133.03,0,15.30,15.36,0.54
3320,0,32768875,0,0.00,300133.03,2,32781343,12468,32768875,0,0.00,90.40,300133.03,1,16.61,15.61,0.56
3321,0,32784387,15512,142.08,300275.09,2,32789099,4712,32784387,15512,142.08,90.42,300275.09,0,14.98,15.61,0.53
3322,0,32784387,0,0.00,300275.09,2,32796822,12435,32784387,0,0.00,90.39,300275.09,1,17.22,16.22,0.56
3323,0,32798725,14338,131.30,300406.41,2,32803991,5266,32798725,14338,131.32,90.40,300406.41,0,15.99,16.22,0.53
3324,0,32798725,0,0.00,300406.41,2,32811617,12892,32798725,0,0.00,90.37,300406.41,1,17.94,16.94,0.56
3325,0,32813635,14910,136.58,300542.97,2,32819072,5437,32813635,14910,136.56,90.39,300542.97,0,16.60,16.94,0.53
3326,0,32813635,0,0.00,300542.97,2,32826598,12963,32813635,0,0.00,90.36,300542.97,1,18.73,17.73,0.56
3327,0,32828039,14404,131.93,300674.91,2,32833800,5761,32828039,14404,131.93,90.37,300674.91,1,17.01,17.73,0.52
3328,0,32854558,26519,242.88,300917.78,2,32854558,0,32854558,26519,242.89,90.42,300917.78,0,17.55,17.73,0.49
3329,0,32854558,0,0.00,300917.78,2,32865156,10598,32854558,0,0.00,90.39,300917.78,0,18.08,17.08,0.52
3330,0,32854558,0,0.00,300917.78,2,32870653,16095,32854558,0,0.00,90.37,300917.78,1,20.40,19.40,0.55
3331,0,32865046,10488,96.06,301013.84,2,32875897,10851,32865046,10488,96.06,90.37,301013.84,0,18.35,19.40,0.49
3332,0,32884568,19522,178.80,301192.66,2,32885658,1090,32884568,19522,178.80,90.39,301192.66,1,18.45,19.40,0.52
3333,0,32916467,31899,292.17,301484.84,2,32916467,0,32916467,31899,292.17,90.45,301484.84,0,18.32,19.40,0.50
3334,0,32916467,0,0.00,301484.84,2,32927402,10935,32916467,0,0.00,90.43,301484.84,1,21.14,19.00,0.53
3335,0,32916467,0,0.00,301484.84,2,32932895,16428,32916467,0,0.00,90.40,301484.84,0,21.34,19.00,0.48
3336,0,32916467,0,0.00,301484.84,2,32937301,20834,32916467,0,0.00,90.37,301484.84,1,21.63,19.00,0.50
3337,0,32916467,0,0.00,301484.84,2,32941310,24843,32916467,0,0.00,90.35,301484.84,0,21.79,19.00,0.47
3338,0,32916467,0,0.00,301484.84,2,32944860,28393,32916467,0,0.00,90.32,301484.84,1,21.79,19.00,0.50
3339,0,32916467,0,0.00,301484.84,2,32948083,31616,32916467,0,0.00,90.29,301484.84,0,20.15,19.15,0.46
3340,0,32916467,0,0.00,301484.84,2,32951064,34597,32916467,0,0.00,90.26,301484.84,1,20.15,19.15,0.49
3341,0,32922145,5678,51.99,301536.81,2,32953903,31758,32922145,5678,52.01,90.25,301536.81,0,18.90,19.15,0.45
3342,0,32922145,0,0.00,301536.81,2,32956610,34465,32922145,0,0.00,90.23,301536.81,1,19.33,18.33,0.48
3343,0,32927297,5152,47.19,301584.00,2,32959186,31889,32927297,5152,47.19,90.21,301584.00,0,17.90,18.33,0.45
3344,0,32932059,4762,43.63,301627.62,2,32961567,29508,32932059,4762,43.62,90.20,301627.62,1,18.11,18.33,0.48
3345,0,32936915,4856,44.48,301672.12,2,32963995,27080,32936915,4856,44.48,90.19,301672.12,0,16.12,18.33,0.42
3346,0,32941963,5048,46.24,301718.34,2,32966519,24556,32941963,5048,46.24,90.17,301718.34,1,16.17,18.33,0.45
3347,0,32947013,5050,46.24,301764.59,2,32969044,22031,32947013,5050,46.25,90.16,301764.59,0,14.82,18.33,0.42
3348,0,32952051,5038,46.16,301810.75,2,32971563,19512,32952051,5038,46.14,90.15,301810.75,1,14.87,18.33,0.45
3349,0,32957165,5114,46.82,301857.56,2,32974120,16955,32957165,5114,46.84,90.13,301857.56,0,12.62,18.33,0.38
3350,0,32962951,5786,53.01,301910.59,2,32977013,14062,32962951,5786,52.99,90.12,301910.59,1,12.67,18.33,0.41
3351,0,32973141,10190,93.31,302003.91,2,32982108,8967,32973141,10190,93.33,90.12,302003.91,0,11.36,18.33,0.39
3352,0,32997054,23913,219.03,302222.94,2,32997054,0,32997054,23913,219.02,90.16,302222.94,1,12.54,18.33,0.42
3353,0,33028845,31791,291.17,302514.09,2,33028845,0,33028845,31791,291.18,90.22,302514.09,0,10.49,18.33,0.35
3354,0,33060542,31697,290.32,302804.41,2,33060542,0,33060542,31697,290.32,90.28,302804.41,1,12.98,18.33,0.38
3355,0,33091835,31293,286.62,303091.03,2,33091835,0,33091835,31293,286.62,90.34,303091.03,0,12.24,18.33,0.37
3356,0,33123613,31778,291.04,303382.09,2,33123613,0,33123613,31778,291.06,90.40,303382.09,1,14.38,18.33,0.40
3357,0,33155871,32258,295.47,303677.56,2,33155871,0,33155871,32258,295.45,90.46,303677.56,0,12.53,18.33,0.33
3358,0,33187670,31799,291.24,303968.78,2,33187670,0,33187670,31799,291.25,90.52,303968.78,0,14.76,18.33,0.36
3359,0,33219898,32228,295.18,304263.97,2,33219898,0,33219898,32228,295.18,90.58,304263.97,1,17.06,18.33,0.39
3360,0,33251603,31705,290.40,304554.38,2,33251603,0,33251603,31705,290.39,90.64,304554.38,0,16.71,18.33,0.38
3361,0,33251603,0,0.00,304554.38,2,33262163,10560,33251603,0,0.00,90.61,304554.38,1,18.65,17.65,0.41
3362,0,33271085,19482,178.42,304732.78,2,33271904,819,33271085,19482,178.44,90.64,304732.78,0,17.39,17.65,0.37
3363,0,33271085,0,0.00,304732.78,2,33281631,10546,33271085,0,0.00,90.61,304732.78,1,19.26,18.26,0.40
3364,0,33290715,19630,179.81,304912.59,2,33291446,731,33290715,19630,179.79,90.64,304912.59,0,17.46,18.26,0.35
3365,0,33322409,31694,290.27,305202.88,2,33322409,0,33322409,31694,290.29,90.70,305202.88,1,17.76,18.26,0.38
3366,0,33354111,31702,290.38,305493.25,2,33354111,0,33354111,31702,290.36,90.76,305493.25,0,17.34,18.26,0.36
3367,0,33354111,0,0.00,305493.25,2,33364308,10197,33354111,0,0.00,90.73,305493.25,1,19.33,18.33,0.39
3368,0,33354111,0,0.00,305493.25,2,33369833,15722,33354111,0,0.00,90.70,305493.25,0,18.66,17.66,0.35
3369,0,33354111,0,0.00,305493.25,2,33374092,19981,33354111,0,0.00,90.68,305493.25,1,18.66,17.66,0.38
3370,0,33362037,7926,72.58,305565.81,2,33378055,16018,33362037,7926,72.59,90.67,305565.81,1,17.54,17.66,0.35
3371,0,33370471,8434,77.27,305643.09,2,33382272,11801,33370471,8434,77.25,90.67,305643.09,0,16.35,17.66,0.33
3372,0,33385421,14950,136.91,305780.00,2,33389747,4326,33385421,14950,136.93,90.68,305780.00,1,16.42,17.66,0.36
3373,0,33415635,30214,276.75,306056.75,2,33415635,0,33415635,30214,276.73,90.74,306056.75,0,15.60,17.66,0.33
3374,0,33446719,31084,284.70,306341.47,2,33446719,0,33446719,31084,284.70,90.79,306341.47,1,16.50,17.66,0.36
3375,0,33446719,0,0.00,306341.47,2,33457337,10618,33446719,0,0.00,90.77,306341.47,0,18.16,17.16,0.33
3376,0,33446719,0,0.00,306341.47,2,33463386,16667,33446719,0,0.00,90.74,306341.47,1,19.25,18.25,0.36
3377,0,33457045,10326,94.56,306436.00,2,33468549,11504,33457045,10326,94.58,90.74,306436.00,0,17.77,18.25,0.33
3378,0,33473271,16226,148.63,306584.66,2,33476662,3391,33473271,16226,148.62,90.76,306584.66,1,17.86,18.25,0.35
3379,0,33503593,30322,277.70,306862.34,2,33503593,0,33503593,30322,277.72,90.81,306862.34,0,16.55,18.25,0.32
3380,0,33535468,31875,291.96,307154.31,2,33535468,0,33535468,31875,291.95,90.87,307154.31,1,16.82,18.25,0.35
3381,0,33535468,0,0.00,307154.31,2,33546000,10532,33535468,0,0.00,90.85,307154.31,1,22.18,19.00,0.32
3382,0,33535468,0,0.00,307154.31,2,33551835,16367,33535468,0,0.00,90.82,307154.31,0,22.80,19.00,0.29
3383,0,33535468,0,0.00,307154.31,2,33556254,20786,33535468,0,0.00,90.79,307154.31,0,22.80,19.00,0.32
3384,0,33535468,0,0.00,307154.31,2,33560246,24778,33535468,0,0.00,90.77,307154.31,1,22.80,19.00,0.35
3385,0,33535468,0,0.00,307154.31,2,33563877,28409,33535468,0,0.00,90.74,307154.31,1,20.82,19.82,0.29
3386,0,33535468,0,0.00,307154.31,2,33567106,31638,33535468,0,0.00,90.71,307154.31,0,20.90,19.90,0.27
3387,0,33535468,0,0.00,307154.31,2,33569929,34461,33535468,0,0.00,90.69,307154.31,0,22.78,19.00,0.30
3388,0,33535468,0,0.00,307154.31,2,33572697,37229,33535468,0,0.00,90.66,307154.31,1,23.25,19.00,0.33
3389,0,33535468,0,0.00,307154.31,2,33575415,39947,33535468,0,0.00,90.63,307154.31,0,21.23,19.00,0.27
3390,0,33535468,0,0.00,307154.31,2,33577979,42511,33535468,0,0.00,90.61,307154.31,1,21.23,19.00,0.30
3391,0,33535468,0,0.00,307154.31,2,33580409,44941,33535468,0,0.00,90.58,307154.31,0,19.11,18.11,0.24
3392,0,33535468,0,0.00,307154.31,2,33582729,47261,33535468,0,0.00,90.55,307154.31,1,19.11,18.11,0.27
3393,0,33539954,4486,41.09,307195.41,2,33584972,45018,33539954,4486,41.09,90.54,307195.41,0,17.85,18.11,0.23
3394,0,33544452,4498,41.20,307236.59,2,33587221,42769,33544452,4498,41.20,90.52,307236.59,1,17.89,18.11,0.26
3395,0,33548906,4454,40.79,307277.38,2,33589448,40542,33548906,4454,40.79,90.51,307277.38,0,16.47,18.11,0.21
3396,0,33553174,4268,39.09,307316.47,2,33591582,38408,33553174,4268,39.09,90.49,307316.47,1,17.13,18.11,0.24
3397,0,33557564,4390,40.21,307356.69,2,33593777,36213,33557564,4390,40.21,90.48,307356.69,0,15.76,18.11,0.20
3398,0,33561832,4268,39.09,307395.78,2,33595911,34079,33561832,4268,39.09,90.46,307395.78,0,15.80,18.11,0.23
3399,0,33566118,4286,39.27,307435.06,2,33598054,31936,33566118,4286,39.26,90.45,307435.06,1,15.84,18.11,0.26
3400,0,33570150,4032,36.93,307471.97,2,33600070,29920,33570150,4032,36.93,90.43,307471.97,0,14.56,18.11,0.23
3401,0,33574116,3966,36.31,307508.28,2,33602053,27937,33574116,3966,36.32,90.42,307508.28,1,15.60,18.11,0.26
3402,0,33578014,3898,35.72,307544.00,2,33604002,25988,33578014,3898,35.70,90.40,307544.00,0,14.21,18.11,0.22
3403,0,33582100,4086,37.41,307581.41,2,33606045,23945,33582100,4086,37.42,90.39,307581.41,1,14.25,18.11,0.25
3404,0,33586384,4284,39.24,307620.66,2,33608187,21803,33586384,4284,39.24,90.37,307620.66,1,12.82,18.11,0.22
3405,0,33590856,4472,40.96,307661.62,2,33610423,19567,33590856,4472,40.96,90.36,307661.62,0,11.79,18.11,0.19
3406,0,33595694,4838,44.33,307705.94,2,33612842,17148,33595694,4838,44.31,90.34,307705.94,1,11.83,18.11,0.22
3407,0,33600930,5236,47.92,307753.88,2,33615460,14530,33600930,5236,47.96,90.33,307753.88,0,10.84,18.11,0.19
3408,0,33610618,9688,88.73,307842.59,2,33620304,9686,33610618,9688,88.73,90.33,307842.59,1,11.90,18.11,0.22
3409,0,33632923,22305,204.32,308046.91,2,33632923,0,33632923,22305,204.29,90.36,308046.91,0,11.10,18.11,0.19
3410,0,33665544,32621,298.77,308345.69,2,33665544,0,33665544,32621,298.78,90.42,308345.69,1,11.30,18.11,0.22
3411,0,33698437,32893,301.26,308646.94,2,33698437,0,33698437,32893,301.27,90.49,308646.94,0,10.47,18.11,0.21
3412,0,33730319,31882,292.03,308938.97,2,33730319,0,33730319,31882,292.01,90.54,308938.97,1,12.77,18.11,0.24
3413,0,33762712,32393,296.68,309235.66,2,33762712,0,33762712,32393,296.69,90.61,309235.66,0,13.87,18.11,0.22
3414,0,33795349,32637,298.92,309534.56,2,33795349,0,33795349,32637,298.93,90.67,309534.56,1,16.17,18.11,0.25
3415,0,33828362,33013,302.36,309836.94,2,33828362,0,33828362,33013,302.37,90.73,309836.94,0,15.17,18.11,0.22
3416,0,33861212,32850,300.89,310137.81,2,33861212,0,33861212,32850,300.88,90.79,310137.81,1,17.48,18.11,0.25
3417,0,33861212,0,0.00,310137.81,2,33871759,10547,33861212,0,0.00,90.76,310137.81,0,19.48,18.48,0.23
3418,0,33861212,0,0.00,310137.81,2,33877830,16618,33861212,0,0.00,90.74,310137.81,0,20.55,19.55,0.26
3419,0,33861212,0,0.00,310137.81,2,33882554,21342,33861212,0,0.00,90.71,310137.81,1,21.12,19.00,0.29
3420,0,33861212,0,0.00,310137.81,2,33886615,25403,33861212,0,0.00,90.68,310137.81,0,19.97,18.97,0.25
3421,0,33861212,0,0.00,310137.81,2,33889972,28760,33861212,0,0.00,90.66,310137.81,1,19.97,18.97,0.28
3422,0,33867674,6462,59.17,310197.00,2,33893203,25529,33867674,6462,59.19,90.65,310197.00,1,18.91,18.97,0.26
3423,0,33874094,6420,58.84,310255.84,2,33896413,22319,33874094,6420,58.80,90.64,310255.84,0,17.66,18.97,0.24
3424,0,33880698,6604,60.45,310316.28,2,33899715,19017,33880698,6604,60.49,90.63,310316.28,1,17.72,18.97,0.27
3425,0,33887170,6472,59.28,310375.56,2,33902951,15781,33887170,6472,59.28,90.62,310375.56,0,16.69,18.97,0.25
3426,0,33893762,6592,60.38,310435.94,2,33906247,12485,33893762,6592,60.38,90.61,310435.94,1,16.74,18.97,0.28
3427,0,33905874,12112,110.93,310546.88,2,33912303,6429,33905874,12112,110.93,90.62,310546.88,0,15.51,18.97,0.26
3428,0,33933569,27695,253.67,310800.53,2,33933569,0,33933569,27695,253.66,90.67,310800.53,1,15.62,18.97,0.29
3429,0,33965805,32236,295.25,311095.78,2,33965805,0,33965805,32236,295.25,90.72,311095.78,0,14.59,18.97,0.25
3430,0,33998497,32692,299.43,311395.22,2,33998497,0,33998497,32692,299.43,90.79,311395.22,1,16.07,18.97,0.27
3431,0,34031095,32598,298.59,311693.81,2,34031095,0,34031095,32598,298.57,90.85,311693.81,0,17.24,18.97,0.26
3432,0,34031095,0,0.00,311693.81,2,34041926,10831,34031095,0,0.00,90.82,311693.81,1,19.62,18.62,0.28
3433,0,34031095,0,0.00,311693.81,2,34047929,16834,34031095,0,0.00,90.79,311693.81,0,19.11,18.11,0.23
3434,0,34031095,0,0.00,311693.81,2,34052155,21060,34031095,0,0.00,90.77,311693.81,1,19.68,18.68,0.26
3435,0,34031095,0,0.00,311693.81,2,34056006,24911,34031095,0,0.00,90.74,311693.81,0,19.76,18.76,0.24
3436,0,34031095,0,0.00,311693.81,2,34059567,28472,34031095,0,0.00,90.71,311693.81,1,19.76,18.76,0.27
3437,0,34037767,6672,61.11,311754.91,2,34062903,25136,34037767,6672,61.11,90.71,311754.91,0,18.26,18.76,0.22
3438,0,34037767,0,0.00,311754.91,2,34066023,28256,34037767,0,0.00,90.68,311754.91,0,18.90,17.90,0.25
3439,0,34037767,0,0.00,311754.91,2,34068778,31011,34037767,0,0.00,90.65,311754.91,1,19.91,18.91,0.28
3440,0,34043051,5284,48.40,311803.31,2,34071420,28369,34043051,5284,48.40,90.64,311803.31,0,18.51,18.91,0.25
3441,0,34048301,5250,48.07,311851.38,2,34074045,25744,34048301,5250,48.09,90.63,311851.38,1,18.81,18.91,0.28
3442,0,34053563,5262,48.21,311899.59,2,34076676,23113,34053563,5262,48.20,90.62,311899.59,0,17.39,18.91,0.25
3443,0,34058799,5236,47.96,311947.56,2,34079294,20495,34058799,5236,47.96,90.60,311947.56,1,17.44,18.91,0.28
3444,0,34063773,4974,45.54,311993.09,2,34081781,18008,34063773,4974,45.56,90.59,311993.09,1,15.99,18.91,0.25
3445,0,34069365,5592,51.22,312044.31,2,34084577,15212,34069365,5592,51.22,90.58,312044.31,0,15.87,18.91,0.24
3446,0,34077473,8108,74.26,312118.56,2,34088631,11158,34077473,8108,74.26,90.57,312118.56,1,16.64,18.91,0.27
3447,0,34097017,19544,179.01,312297.56,2,34098403,1386,34097017,19544,179.01,90.60,312297.56,0,16.37,18.91,0.26
3448,0,34129758,32741,299.91,312597.47,2,34129758,0,34129758,32741,299.88,90.66,312597.47,1,18.26,18.91,0.29
3449,0,34129758,0,0.00,312597.47,2,34140398,10640,34129758,0,0.00,90.63,312597.47,0,19.32,18.32,0.26
3450,0,34129758,0,0.00,312597.47,2,34146192,16434,34129758,0,0.00,90.61,312597.47,1,20.55,19.55,0.29
3451,0,34129758,0,0.00,312597.47,2,34150612,20854,34129758,0,0.00,90.58,312597.47,0,20.25,19.25,0.28
3452,0,34129758,0,0.00,312597.47,2,34154651,24893,34129758,0,0.00,90.56,312597.47,1,20.25,19.25,0.30
3453,0,34137354,7596,69.54,312667.03,2,34158449,21095,34137354,7596,69.57,90.55,312667.03,0,19.16,19.25,0.29
3454,0,34137354,0,0.00,312667.03,2,34161937,24583,34137354,0,0.00,90.52,312667.03,1,20.22,19.22,0.32
3455,0,34143538,6184,56.64,312723.66,2,34165029,21491,34143538,6184,56.64,90.51,312723.66,0,19.00,19.22,0.29
3456,0,34143538,0,0.00,312723.66,2,34167950,24412,34143538,0,0.00,90.49,312723.66,1,19.26,18.26,0.32
3457,0,34143538,0,0.00,312723.66,2,34170547,27009,34143538,0,0.00,90.46,312723.66,0,18.27,17.27,0.31
3458,0,34143538,0,0.00,312723.66,2,34173066,29528,34143538,0,0.00,90.43,312723.66,1,18.27,17.27,0.33
3459,0,34148492,4954,45.39,312769.06,2,34175543,27051,34148492,4954,45.37,90.42,312769.06,0,16.94,17.27,0.31
3460,0,34153162,4670,42.75,312811.81,2,34177878,24716,34153162,4670,42.77,90.41,312811.81,1,16.98,17.27,0.34
3461,0,34157956,4794,43.93,312855.72,2,34180275,22319,34157956,4794,43.91,90.39,312855.72,1,15.87,17.27,0.32
3462,0,34163040,5084,46.56,312902.28,2,34182817,19777,34163040,5084,46.56,90.38,312902.28,0,14.78,17.27,0.30
3463,0,34168584,5544,50.78,312953.06,2,34185589,17005,34168584,5544,50.78,90.37,312953.06,0,14.83,17.27,0.33
3464,0,34174726,6142,56.27,313009.34,2,34188660,13934,34174726,6142,56.26,90.36,313009.34,1,14.88,17.27,0.36
3465,0,34185202,10476,95.91,313105.25,2,34193898,8696,34185202,10476,95.95,90.36,313105.25,1,13.33,17.27,0.32
3466,0,34207562,22360,204.80,313310.06,2,34207562,0,34207562,22360,204.80,90.40,313310.06,0,12.39,17.27,0.31
3467,0,34240095,32533,298.00,313608.06,2,34240095,0,34240095,32533,297.97,90.46,313608.06,1,15.21,17.27,0.34
3468,0,34272615,32520,297.85,313905.91,2,34272615,0,34272615,32520,297.85,90.51,313905.91,0,16.05,17.27,0.31
3469,0,34272615,0,0.00,313905.91,2,34283086,10471,34272615,0,0.00,90.49,313905.91,1,18.37,17.37,0.33
3470,0,34272615,0,0.00,313905.91,2,34288895,16280,34272615,0,0.00,90.46,313905.91,0,17.40,16.40,0.32
3471,0,34272615,0,0.00,313905.91,2,34293396,20781,34272615,0,0.00,90.44,313905.91,0,19.38,18.38,0.35
3472,0,34272615,0,0.00,313905.91,2,34297283,24668,34272615,0,0.00,90.41,313905.91,1,19.56,18.56,0.38
3473,0,34279833,7218,66.09,313972.00,2,34300892,21059,34279833,7218,66.11,90.40,313972.00,0,18.39,18.56,0.33
3474,0,34286863,7030,64.41,314036.41,2,34304407,17544,34286863,7030,64.39,90.40,314036.41,1,18.46,18.56,0.36
3475,0,34293701,6838,62.61,314099.03,2,34307826,14125,34293701,6838,62.63,90.39,314099.03,0,17.47,18.56,0.32
3476,0,34301191,7490,68.62,314167.66,2,34311571,10380,34301191,7490,68.60,90.38,314167.66,1,17.53,18.56,0.35
3477,0,34318777,17586,161.05,314328.69,2,34320364,1587,34318777,17586,161.07,90.40,314328.69,0,15.47,18.56,0.29
3478,0,34350733,31956,292.69,314621.38,2,34350733,0,34350733,31956,292.69,90.46,314621.38,1,15.64,18.56,0.32
3479,0,34382174,31441,288.00,314909.38,2,34382174,0,34382174,31441,287.97,90.52,314909.38,0,14.78,18.56,0.27
3480,0,34414366,32192,294.85,315204.22,2,34414366,0,34414366,32192,294.85,90.58,315204.22,1,16.35,18.56,0.30
3481,0,34446429,32063,293.64,315497.88,2,34446429,0,34446429,32063,293.67,90.63,315497.88,0,16.54,18.56,0.24
3482,0,34446429,0,0.00,315497.88,2,34456969,10540,34446429,0,0.00,90.61,315497.88,0,18.95,17.95,0.27
3483,0,34446429,0,0.00,315497.88,2,34462580,16151,34446429,0,0.00,90.58,315497.88,1,19.29,18.29,0.30
3484,0,34455941,9512,87.12,315585.00,2,34467336,11395,34455941,9512,87.12,90.58,315585.00,0,17.51,18.29,0.25
3485,0,34472745,16804,153.91,315738.91,2,34475738,2993,34472745,16804,153.91,90.60,315738.91,1,17.65,18.29,0.28
3486,0,34504133,31388,287.49,316026.38,2,34504133,0,34504133,31388,287.49,90.66,316026.38,0,16.29,18.29,0.24
3487,0,34535811,31678,290.16,316316.53,2,34535811,0,34535811,31678,290.14,90.71,316316.53,1,17.16,18.29,0.26
3488,0,34567512,31701,290.34,316606.88,2,34567512,0,34567512,31701,290.35,90.77,316606.88,1,17.45,18.29,0.22
3489,0,34599313,31801,291.26,316898.16,2,34599313,0,34599313,31801,291.27,90.83,316898.16,0,16.55,18.29,0.18
3490,0,34631003,31690,290.27,317188.41,2,34631003,0,34631003,31690,290.25,90.88,317188.41,1,17.66,18.29,0.21
3491,0,34663047,32044,293.49,317481.91,2,34663047,0,34663047,32044,293.49,90.94,317481.91,0,17.75,18.29,0.17
3492,0,34663047,0,0.00,317481.91,2,34673711,10664,34663047,0,0.00,90.92,317481.91,1,21.41,19.00,0.20
3493,0,34663047,0,0.00,317481.91,2,34679615,16568,34663047,0,0.00,90.89,317481.91,0,19.93,18.93,0.16
3494,0,34663047,0,0.00,317481.91,2,34684277,21230,34663047,0,0.00,90.86,317481.91,1,20.52,19.52,0.19
3495,0,34663047,0,0.00,317481.91,2,34688204,25157,34663047,0,0.00,90.84,317481.91,0,19.55,18.55,0.15
3496,0,34663047,0,0.00,317481.91,2,34691534,28487,34663047,0,0.00,90.81,317481.91,1,19.88,18.88,0.18
3497,0,34669735,6688,61.26,317543.16,2,34694878,25143,34669735,6688,61.26,90.80,317543.16,0,18.50,18.88,0.15
3498,0,34669735,0,0.00,317543.16,2,34698116,28381,34669735,0,0.00,90.78,317543.16,1,18.95,17.95,0.18
3499,0,34675729,5994,54.88,317598.06,2,34701113,25384,34675729,5994,54.90,90.77,317598.06,0,17.33,17.95,0.14
3500,0,34681609,5880,53.86,317651.91,2,34704053,22444,34681609,5880,53.86,90.76,317651.91,1,17.38,17.95,0.17
3501,0,34687411,5802,53.16,317705.06,2,34706954,19543,34687411,5802,53.14,90.75,317705.06,0,15.81,17.95,0.13
3502,0,34693185,5774,52.87,317757.94,2,34709841,16656,34693185,5774,52.88,90.74,317757.94,1,15.86,17.95,0.16
3503,0,34699231,6046,55.39,317813.31,2,34712864,13633,34699231,6046,55.38,90.73,317813.31,0,14.39,17.95,0.12
3504,0,34709915,10684,97.86,317911.19,2,34718206,8291,34709915,10684,97.86,90.73,317911.19,1,14.45,17.95,0.15
3505,0,34733515,23600,216.15,318127.34,2,34733515,0,34733515,23600,216.15,90.76,318127.34,0,12.66,17.95,0.11
3506,0,34766028,32513,297.78,318425.12,2,34766028,0,34766028,32513,297.79,90.82,318425.12,1,13.59,17.95,0.13
3507,0,34766028,0,0.00,318425.12,2,34776885,10857,34766028,0,0.00,90.80,318425.12,0,18.43,17.43,0.10
3508,0,34766028,0,0.00,318425.12,2,34783052,17024,34766028,0,0.00,90.77,318425.12,1,18.69,17.69,0.13
3509,0,34775764,9736,89.17,318514.28,2,34787920,12156,34775764,9736,89.17,90.77,318514.28,0,16.28,17.69,0.06
3510,0,34792466,16702,152.96,318667.25,2,34796271,3805,34792466,16702,152.98,90.79,318667.25,1,16.36,17.69,0.09
3511,0,34824670,32204,295.00,318962.25,2,34824670,0,34824670,32204,294.96,90.85,318962.25,0,15.03,17.69,0.06
3512,0,34824670,0,0.00,318962.25,2,34835128,10458,34824670,0,0.00,90.82,318962.25,1,17.90,16.90,0.08
3513,0,34824670,0,0.00,318962.25,2,34841195,16525,34824670,0,0.00,90.79,318962.25,0,17.75,16.75,0.03
3514,0,34824670,0,0.00,318962.25,2,34845944,21274,34824670,0,0.00,90.77,318962.25,1,18.00,17.00,0.06
3515,0,34832834,8164,74.74,319036.97,2,34850026,17192,34832834,8164,74.77,90.76,319036.97,0,16.73,17.00,0.01
3516,0,34832834,0,0.00,319036.97,2,34853837,21003,34832834,0,0.00,90.74,319036.97,1,17.93,16.93,0.04
3517,0,34839824,6990,64.04,319101.03,2,34857332,17508,34839824,6990,64.02,90.73,319101.03,0,16.30,16.93,0.04
3518,0,34846732,6908,63.27,319164.28,2,34860786,14054,34846732,6908,63.27,90.72,319164.28,0,16.36,16.93,0.03
3519,0,34846732,0,0.00,319164.28,2,34864046,17314,34846732,0,0.00,90.70,319164.28,1,17.00,16.00,0.06
3520,0,34853136,6404,58.65,319222.94,2,34867248,14112,34853136,6404,58.65,90.69,319222.94,0,15.33,16.00,0.01
3521,0,34853136,0,0.00,319222.94,2,34870461,17325,34853136,0,0.00,90.66,319222.94,1,16.25,15.25,0.03
3522,0,34859850,6714,61.48,319284.41,2,34873818,13968,34859850,6714,61.49,90.65,319284.41,1,13.34,15.25,0.03
3523,0,34872190,12340,113.06,319397.47,2,34879988,7798,34872190,12340,113.02,90.66,319397.47,0,13.40,15.25,0.03
3524,0,34895870,23680,216.89,319614.38,2,34895870,0,34895870,23680,216.89,90.70,319614.38,1,14.61,15.25,0.06
3525,0,34895870,0,0.00,319614.38,2,34906676,10806,34895870,0,0.00,90.67,319614.38,0,15.65,14.65,0.05
3526,0,34895870,0,0.00,319614.38,2,34912731,16861,34895870,0,0.00,90.65,319614.38,1,15.93,14.93,0.07
3527,0,34895870,0,0.00,319614.38,2,34917007,21137,34895870,0,0.00,90.62,319614.38,0,16.18,15.18,0.04
3528,0,34895870,0,0.00,319614.38,2,34921044,25174,34895870,0,0.00,90.59,319614.38,1,16.18,15.18,0.07
3529,0,34903350,7480,68.51,319682.88,2,34924784,21434,34903350,7480,68.51,90.59,319682.88,0,14.30,15.18,0.02
3530,0,34910646,7296,66.82,319749.69,2,34928432,17786,34910646,7296,66.82,90.58,319749.69,1,14.37,15.18,0.05
3531,0,34917742,7096,64.99,319814.69,2,34931980,14238,34917742,7096,64.99,90.57,319814.69,0,12.85,15.18,0.02
3532,0,34925350,7608,69.68,319884.38,2,34935784,10434,34925350,7608,69.68,90.57,319884.38,1,12.92,15.18,0.05
3533,0,34942750,17400,159.37,320043.75,2,34944484,1734,34942750,17400,159.37,90.59,320043.75,0,10.86,15.18,0.05
3534,0,34976103,33353,305.47,320349.22,2,34976103,0,34976103,33353,305.48,90.65,320349.22,1,11.01,15.18,0.03
3535,0,35008274,32171,294.63,320643.84,2,35008274,0,35008274,32171,294.66,90.71,320643.84,0,12.18,15.18,0.01
3536,0,35042959,34685,317.71,320961.56,2,35042959,0,35042959,34685,317.68,90.77,320961.56,1,14.47,15.18,0.04
3537,0,35043649,690,6.30,320967.88,2,35054783,11134,35043649,690,6.32,90.75,320967.88,0,15.85,14.85,0.04
3538,0,35043649,0,0.00,320967.88,2,35060814,17165,35043649,0,0.00,90.72,320967.88,0,15.86,14.86,0.03
3539,0,35043649,0,0.00,320967.88,2,35065494,21845,35043649,0,0.00,90.69,320967.88,1,15.86,14.86,0.06
3540,0,35052115,8466,77.56,321045.41,2,35069727,17612,35052115,8466,77.54,90.69,321045.41,0,14.37,14.86,0.02
3541,0,35052115,0,0.00,321045.41,2,35073578,21463,35052115,0,0.00,90.67,321045.41,1,15.41,14.41,0.05
3542,0,35059251,7136,65.36,321110.78,2,35077146,17895,35059251,7136,65.36,90.66,321110.78,0,13.52,14.41,0.00
3543,0,35066329,7078,64.81,321175.59,2,35080685,14356,35066329,7078,64.83,90.65,321175.59,1,13.86,14.41,0.03
3544,0,35074777,8448,77.38,321252.97,2,35084909,10132,35074777,8448,77.38,90.65,321252.97,1,11.85,14.41,0.03
3545,0,35095954,21177,193.95,321446.91,2,35095954,0,35095954,21177,193.96,90.68,321446.91,0,11.93,14.41,0.03
3546,0,35129269,33315,305.14,321752.06,2,35129269,0,35129269,33315,305.14,90.74,321752.06,1,12.65,14.41,0.06
3547,0,35163174,33905,310.57,322062.62,2,35163174,0,35163174,33905,310.54,90.80,322062.62,0,11.01,14.41,0.01
3548,0,35196344,33170,303.79,322366.41,2,35196344,0,35196344,33170,303.81,90.86,322366.41,1,13.32,14.41,0.04
3549,0,35229589,33245,304.48,322670.91,2,35229589,0,35229589,33245,304.49,90.92,322670.91,0,14.02,14.41,0.04
3550,0,35262743,33154,303.68,322974.59,2,35262743,0,35262743,33154,303.66,90.98,322974.59,1,14.32,14.41,0.03
3551,0,35295773,33030,302.51,323277.09,2,35295773,0,35295773,33030,302.52,91.04,323277.09,0,14.38,14.41,0.03
3552,0,35295773,0,0.00,323277.09,2,35306364,10591,35295773,0,0.00,91.01,323277.09,1,14.68,13.68,0.03
3553,0,35295773,0,0.00,323277.09,2,35312116,16343,35295773,0,0.00,90.99,323277.09,0,14.28,13.28,0.03
3554,0,35295773,0,0.00,323277.09,2,35316501,20728,35295773,0,0.00,90.96,323277.09,1,14.28,13.28,0.03
3555,0,35303797,8024,73.49,323350.59,2,35320513,16716,35303797,8024,73.49,90.96,323350.59,0,11.45,13.28,0.03
3556,0,35312511,8714,79.83,323430.41,2,35324870,12359,35312511,8714,79.81,90.95,323430.41,1,11.52,13.28,0.03
3557,0,35325251,12740,116.69,323547.09,2,35331240,5989,35325251,12740,116.69,90.96,323547.09,0,10.03,13.28,0.03
3558,0,35354688,29437,269.61,323816.72,2,35354688,0,35354688,29437,269.62,91.01,323816.72,0,10.14,13.28,0.03
3559,0,35354688,0,0.00,323816.72,2,35365280,10592,35354688,0,0.00,90.99,323816.72,1,15.23,14.23,0.06
3560,0,35354688,0,0.00,323816.72,2,35370940,16252,35354688,0,0.00,90.96,323816.72,0,14.58,13.58,0.06
3561,0,35354688,0,0.00,323816.72,2,35375374,20686,35354688,0,0.00,90.93,323816.72,1,14.58,13.58,0.03
3562,0,35362724,8036,73.60,323890.31,2,35379392,16668,35362724,8036,73.60,90.93,323890.31,0,12.57,13.58,0.03
3563,0,35371258,8534,78.15,323968.44,2,35383659,12401,35371258,8534,78.16,90.93,323968.44,1,12.64,13.58,0.03
3564,0,35385966,14708,134.75,324103.19,2,35391013,5047,35385966,14708,134.71,90.94,324103.19,0,12.03,13.58,0.03
3565,0,35416140,30174,276.35,324379.56,2,35416140,0,35416140,30174,276.37,90.99,324379.56,1,12.16,13.58,0.03
3566,0,35445824,29684,271.88,324651.44,2,35447143,1319,35445824,29684,271.88,91.04,324651.44,0,13.59,12.59,0.03
3567,0,35445824,0,0.00,324651.44,2,35456869,11045,35445824,0,0.00,91.02,324651.44,1,13.85,12.85,0.03
3568,0,35453634,7810,71.51,324722.94,2,35464752,11118,35453634,7810,71.53,91.01,324722.94,0,14.33,13.33,0.03
3569,0,35453634,0,0.00,324722.94,2,35470054,16420,35453634,0,0.00,90.98,324722.94,1,14.40,13.40,0.03
3570,0,35463386,9752,89.32,324812.25,2,35474930,11544,35463386,9752,89.32,90.98,324812.25,1,11.22,13.40,0.03
3571,0,35481146,17760,162.67,324974.94,2,35483810,2664,35481146,17760,162.67,91.00,324974.94,0,11.31,13.40,0.03
3572,0,35481146,0,0.00,324974.94,2,35492419,11273,35481146,0,0.00,90.98,324974.94,1,13.47,12.47,0.06
3573,0,35498800,17654,161.71,325136.62,2,35501246,2446,35498800,17654,161.69,91.00,325136.62,0,12.16,12.47,0.02
3574,0,35498800,0,0.00,325136.62,2,35510472,11672,35498800,0,0.00,90.97,325136.62,1,14.04,13.04,0.05
3575,0,35498800,0,0.00,325136.62,2,35515813,17013,35498800,0,0.00,90.95,325136.62,0,14.20,13.20,0.01
3576,0,35498800,0,0.00,325136.62,2,35519026,20226,35498800,0,0.00,90.92,325136.62,1,14.48,13.48,0.04
3577,0,35504592,5792,53.05,325189.69,2,35521922,17330,35504592,5792,53.05,90.91,325189.69,0,12.77,13.48,0.00
3578,0,35512220,7628,69.87,325259.56,2,35525736,13516,35512220,7628,69.87,90.91,325259.56,1,12.83,13.48,0.03
3579,0,35525068,12848,117.68,325377.22,2,35532160,7092,35525068,12848,117.68,90.91,325377.22,0,12.89,13.48,0.00
3580,0,35525068,0,0.00,325377.22,2,35538861,13793,35525068,0,0.00,90.89,325377.22,1,13.57,12.57,0.03
3581,0,35525068,0,0.00,325377.22,2,35543122,18054,35525068,0,0.00,90.86,325377.22,0,12.61,11.61,0.00
3582,0,35525068,0,0.00,325377.22,2,35546067,20999,35525068,0,0.00,90.84,325377.22,1,13.88,12.88,0.03
3583,0,35530722,5654,51.77,325429.00,2,35548894,18172,35530722,5654,51.79,90.83,325429.00,0,12.83,12.88,0.01
3584,0,35538664,7942,72.76,325501.75,2,35552865,14201,35538664,7942,72.74,90.82,325501.75,1,12.88,12.88,0.03
3585,0,35550112,11448,104.85,325606.59,2,35558589,8477,35550112,11448,104.85,90.82,325606.59,1,10.11,12.88,0.03
3586,0,35573131,23019,210.84,325817.44,2,35573131,0,35573131,23019,210.83,90.86,325817.44,0,10.21,12.88,0.03
3587,0,35605723,32592,298.51,326115.97,2,35605723,0,35605723,32592,298.51,90.92,326115.97,0,11.17,12.88,0.06
3588,0,35638440,32717,299.65,326415.62,2,35638440,0,35638440,32717,299.66,90.97,326415.62,1,12.43,12.88,0.08
3589,0,35671277,32837,300.75,326716.38,2,35671277,0,35671277,32837,300.76,91.03,326716.38,0,12.87,12.88,0.04
3590,0,35671277,0,0.00,326716.38,2,35682001,10724,35671277,0,0.00,91.01,326716.38,1,13.90,12.90,0.07
3591,0,35691105,19828,181.61,326897.97,2,35691915,810,35691105,19828,181.61,91.03,326897.97,0,12.38,12.90,0.02
3592,0,35691105,0,0.00,326897.97,2,35702326,11221,35691105,0,0.00,91.01,326897.97,1,13.31,12.31,0.04
3593,0,35691105,0,0.00,326897.97,2,35707916,16811,35691105,0,0.00,90.98,326897.97,0,13.54,12.54,0.00
3594,0,35691105,0,0.00,326897.97,2,35711359,20254,35691105,0,0.00,90.96,326897.97,1,13.54,12.54,0.03
3595,0,35697445,6340,58.07,326956.03,2,35714529,17084,35697445,6340,58.07,90.95,326956.03,0,12.27,12.54,0.03
3596,0,35706299,8854,81.11,327037.16,2,35718956,12657,35706299,8854,81.09,90.94,327037.16,1,12.33,12.54,0.03
3597,0,35722427,16128,147.72,327184.88,2,35727020,4593,35722427,16128,147.72,90.96,327184.88,0,12.11,12.54,0.03
3598,0,35752881,30454,278.91,327463.78,2,35752881,0,35752881,30454,278.93,91.01,327463.78,1,12.25,12.54,0.03
3599,0,35775961,23080,211.39,327675.16,2,35779957,3996,35775961,23080,211.39,91.05,327675.16,0,12.64,11.64,0.03
3600,0,35775961,0,0.00,327675.16,2,35788550,12589,35775961,0,0.00,91.02,327675.16,1,12.84,11.84,0.03
3601,0,35792699,16738,153.32,327828.50,2,35796919,4220,35792699,16738,153.30,91.04,327828.50,0,11.01,11.84,0.03
3602,0,35823944,31245,286.17,328114.66,2,35823944,0,35823944,31245,286.18,91.09,328114.66,1,11.16,11.84,0.03
3603,0,35856839,32895,301.30,328415.97,2,35856839,0,35856839,32895,301.29,91.15,328415.97,0,11.78,11.84,0.03
3604,0,35856839,0,0.00,328415.97,2,35867578,10739,35856839,0,0.00,91.13,328415.97,1,12.08,11.08,0.03
3605,0,35856839,0,0.00,328415.97,2,35873476,16637,35856839,0,0.00,91.10,328415.97,0,11.78,10.78,0.03
3606,0,35856839,0,0.00,328415.97,2,35877877,21038,35856839,0,0.00,91.07,328415.97,1,11.78,10.78,0.03
3607,0,35865205,8366,76.61,328492.56,2,35882060,16855,35865205,8366,76.62,91.07,328492.56,0,9.83,10.78,0.03
3608,0,35873763,8558,78.40,328570.97,2,35886339,12576,35873763,8558,78.38,91.07,328570.97,1,9.91,10.78,0.03
3609,0,35886311,12548,114.93,328685.91,2,35892613,6302,35886311,12548,114.93,91.07,328685.91,0,8.67,10.78,0.00
3610,0,35886311,0,0.00,328685.91,2,35900319,14008,35886311,0,0.00,91.05,328685.91,1,11.33,10.33,0.03
3611,0,35897341,11030,101.01,328786.91,2,35907020,9679,35897341,11030,101.02,91.05,328786.91,0,11.15,10.15,0.03
3612,0,35897341,0,0.00,328786.91,2,35913011,15670,35897341,0,0.00,91.03,328786.91,1,11.25,10.25,0.03
3613,0,35899274,1933,17.70,328804.59,2,35917724,18450,35899274,1933,17.70,91.01,328804.59,0,10.73,9.73,0.03
3614,0,35899274,0,0.00,328804.59,2,35920919,21645,35899274,0,0.00,90.98,328804.59,1,10.75,9.75,0.03
3615,0,35901104,1830,16.78,328821.38,2,35923634,22530,35901104,1830,16.76,90.96,328821.38,0,10.15,9.15,0.03
3616,0,35901104,0,0.00,328821.38,2,35925952,24848,35901104,0,0.00,90.94,328821.38,1,10.16,9.16,0.03
3617,0,35905658,4554,41.69,328863.06,2,35928229,22571,35905658,4554,41.71,90.92,328863.06,0,8.52,9.16,0.03
3618,0,35910664,5006,45.87,328908.94,2,35930732,20068,35910664,5006,45.85,90.91,328908.94,1,8.56,9.16,0.03
3619,0,35916580,5916,54.19,328963.12,2,35933690,17110,35916580,5916,54.19,90.90,328963.12,0,7.03,9.16,0.03
3620,0,35924252,7672,70.27,329033.38,2,35937526,13274,35924252,7672,70.27,90.89,329033.38,1,7.09,9.16,0.03
3621,0,35937070,12818,117.42,329150.81,2,35943935,6865,35937070,12818,117.40,90.90,329150.81,0,6.70,9.16,0.00
3622,0,35965019,27949,255.98,329406.78,2,35965019,0,35965019,27949,255.99,90.95,329406.78,1,8.10,9.16,0.03
3623,0,36000287,35268,323.02,329729.81,2,36000287,0,36000287,35268,323.02,91.01,329729.81,0,7.66,9.16,0.02
3624,0,36000287,0,0.00,329729.81,2,36011123,10836,36000287,0,0.00,90.99,329729.81,1,9.22,8.22,0.05
3625,0,36021979,21692,198.68,329928.50,2,36021979,0,36021979,21692,198.68,91.01,329928.50,0,7.97,8.22,0.02
3626,0,36021979,0,0.00,329928.50,2,36032877,10898,36021979,0,0.00,90.99,329928.50,1,8.98,8.00,0.04
3627,0,36042501,20522,187.94,330116.44,2,36043138,637,36042501,20522,187.96,91.02,330116.44,0,8.10,9.10,0.02
3628,0,36042501,0,0.00,330116.44,2,36053945,11444,36042501,0,0.00,90.99,330116.44,1,9.23,8.23,0.05
3629,0,36042501,0,0.00,330116.44,2,36059183,16682,36042501,0,0.00,90.97,330116.44,0,9.13,8.13,0.00
3630,0,36042501,0,0.00,330116.44,2,36062814,20313,36042501,0,0.00,90.94,330116.44,1,9.13,8.13,0.03
3631,0,36042501,0,0.00,330116.44,2,36065905,23404,36042501,0,0.00,90.92,330116.44,0,8.47,8.00,0.01
3632,0,36048883,6382,58.47,330174.91,2,36069096,20213,36048883,6382,58.45,90.91,330174.91,1,8.47,9.47,0.04
3633,0,36055913,7030,64.37,330239.28,2,36072611,16698,36055913,7030,64.39,90.90,330239.28,0,7.93,9.47,0.02
3634,0,36063655,7742,70.93,330310.22,2,36076482,12827,36063655,7742,70.91,90.89,330310.22,1,8.94,9.47,0.04
3635,0,36076179,12524,114.71,330424.91,2,36082744,6565,36076179,12524,114.71,90.90,330424.91,0,7.50,9.47,0.01
3636,0,36106124,29945,274.26,330699.19,2,36106124,0,36106124,29945,274.27,90.95,330699.19,1,7.75,9.47,0.03
3637,0,36140781,34657,317.42,331016.59,2,36140781,0,36140781,34657,317.43,91.01,331016.59,0,8.77,9.47,0.01
3638,0,36140781,0,0.00,331016.59,2,36151753,10972,36140781,0,0.00,90.99,331016.59,0,10.71,9.71,0.04
3639,0,36140781,0,0.00,331016.59,2,36157486,16705,36140781,0,0.00,90.96,331016.59,0,10.94,9.94,0.06
3640,0,36140781,0,0.00,331016.59,2,36161752,20971,36140781,0,0.00,90.94,331016.59,1,11.32,10.32,0.09
3641,0,36148737,7956,72.87,331089.47,2,36165730,16993,36148737,7956,72.87,90.93,331089.47,0,9.73,10.32,0.04
3642,0,36156759,8022,73.49,331162.94,2,36169741,12982,36156759,8022,73.47,90.93,331162.94,1,9.80,10.32,0.06
3643,0,36167689,10930,100.09,331263.03,2,36175206,7517,36167689,10930,100.11,90.93,331263.03,1,8.76,10.32,0.04
3644,0,36196789,29100,266.53,331529.56,2,36196789,0,36196789,29100,266.53,90.98,331529.56,0,7.95,10.32,0.01
3645,0,36230389,33600,307.75,331837.31,2,36230389,0,36230389,33600,307.75,91.04,331837.31,1,8.97,10.32,0.04
3646,0,36264243,33854,310.09,332147.41,2,36264243,0,36264243,33854,310.07,91.10,332147.41,0,8.93,10.32,0.01
3647,0,36264243,0,0.00,332147.41,2,36275073,10830,36264243,0,0.00,91.07,332147.41,1,10.49,9.49,0.04
3648,0,36264243,0,0.00,332147.41,2,36281396,17153,36264243,0,0.00,91.05,332147.41,0,9.53,8.53,0.02
3649,0,36264243,0,0.00,332147.41,2,36286214,21971,36264243,0,0.00,91.02,332147.41,1,9.53,8.53,0.05
3650,0,36264243,0,0.00,332147.41,2,36290113,25870,36264243,0,0.00,91.00,332147.41,0,9.07,8.07,0.03
3651,0,36264243,0,0.00,332147.41,2,36293556,29313,36264243,0,0.00,90.97,332147.41,1,9.07,8.07,0.06
3652,0,36264243,0,0.00,332147.41,2,36296945,32702,36264243,0,0.00,90.95,332147.41,0,8.44,8.00,0.04
3653,0,36270705,6462,59.17,332206.56,2,36300176,29471,36270705,6462,59.19,90.94,332206.56,1,8.44,9.44,0.06
3654,0,36277029,6324,57.92,332264.50,2,36303338,26309,36277029,6324,57.92,90.93,332264.50,0,8.56,9.44,0.05
3655,0,36283207,6178,56.60,332321.09,2,36306427,23220,36283207,6178,56.58,90.92,332321.09,1,8.62,9.44,0.08
3656,0,36289225,6018,55.10,332376.19,2,36309436,20211,36289225,6018,55.12,90.91,332376.19,1,9.17,9.44,0.06
3657,0,36295135,5910,54.15,332430.34,2,36312391,17256,36295135,5910,54.13,90.90,332430.34,0,8.98,9.44,0.06
3658,0,36301185,6050,55.39,332485.75,2,36315416,14231,36301185,6050,55.41,90.89,332485.75,0,9.16,9.44,0.08
3659,0,36301185,0,0.00,332485.75,2,36318428,17243,36301185,0,0.00,90.87,332485.75,1,9.46,8.46,0.11
3660,0,36301185,0,0.00,332485.75,2,36320971,19786,36301185,0,0.00,90.84,332485.75,1,8.79,8.00,0.11
3661,0,36305865,4680,42.86,332528.59,2,36323311,17446,36305865,4680,42.86,90.83,332528.59,1,8.11,9.11,0.11
3662,0,36311757,5892,53.97,332582.56,2,36326257,14500,36311757,5892,53.97,90.82,332582.56,0,7.45,9.11,0.11
3663,0,36324353,12596,115.37,332697.94,2,36332555,8202,36324353,12596,115.37,90.83,332697.94,1,7.51,9.11,0.14
3664,0,36351873,27520,252.06,332950.00,2,36351873,0,36351873,27520,252.06,90.87,332950.00,0,6.62,9.11,0.13
3665,0,36386771,34898,319.65,333269.66,2,36386771,0,36386771,34898,319.63,90.93,333269.66,1,8.15,9.11,0.15
3666,0,36421703,34932,319.95,333589.59,2,36421703,0,36421703,34932,319.95,91.00,333589.59,0,8.68,9.11,0.15
3667,0,36421703,0,0.00,333589.59,2,36432925,11222,36421703,0,0.00,90.97,333589.59,1,9.51,8.51,0.17
3668,0,36421703,0,0.00,333589.59,2,36439062,17359,36421703,0,0.00,90.95,333589.59,0,10.97,9.97,0.14
3669,0,36421703,0,0.00,333589.59,2,36443825,22122,36421703,0,0.00,90.92,333589.59,0,11.20,10.20,0.17
3670,0,36421703,0,0.00,333589.59,2,36447916,26213,36421703,0,0.00,90.90,333589.59,1,11.20,10.20,0.20
3671,0,36428653,6950,63.64,333653.22,2,36451391,22738,36428653,6950,63.66,90.89,333653.22,0,9.48,10.20,0.16
3672,0,36436023,7370,67.52,333720.75,2,36455076,19053,36436023,7370,67.50,90.88,333720.75,1,9.54,10.20,0.19
3673,0,36443279,7256,66.46,333787.22,2,36458704,15425,36443279,7256,66.46,90.88,333787.22,0,8.22,10.20,0.16
3674,0,36450527,7248,66.39,333853.59,2,36462328,11801,36450527,7248,66.39,90.87,333853.59,1,8.28,10.20,0.19
3675,0,36466439,15912,145.74,333999.34,2,36470284,3845,36466439,15912,145.74,90.88,333999.34,0,6.30,10.20,0.14
3676,0,36499445,33006,302.29,334301.62,2,36499445,0,36499445,33006,302.30,90.94,334301.62,1,7.23,10.20,0.16
3677,0,36532389,32944,301.74,334603.38,2,36532389,0,36532389,32944,301.74,91.00,334603.38,0,8.29,10.20,0.15
3678,0,36532389,0,0.00,334603.38,2,36543629,11240,36532389,0,0.00,90.97,334603.38,1,11.36,10.36,0.17
3679,0,36532389,0,0.00,334603.38,2,36549109,16720,36532389,0,0.00,90.95,334603.38,0,11.37,10.37,0.13
3680,0,36532389,0,0.00,334603.38,2,36553797,21408,36532389,0,0.00,90.92,334603.38,1,11.66,10.66,0.16
3681,0,36540895,8506,77.93,334681.28,2,36558050,17155,36540895,8506,77.91,90.92,334681.28,0,10.14,10.66,0.13
3682,0,36549253,8358,76.53,334757.81,2,36562229,12976,36549253,8358,76.55,90.92,334757.81,1,10.21,10.66,0.16
3683,0,36560463,11210,102.69,334860.50,2,36567834,7371,36560463,11210,102.67,90.92,334860.50,0,8.95,10.66,0.13
3684,0,36588690,28227,258.51,335119.03,2,36588690,0,36588690,28227,258.53,90.97,335119.03,1,9.05,10.66,0.16
3685,0,36622381,33691,308.59,335427.59,2,36622381,0,36622381,33691,308.58,91.03,335427.59,0,7.85,10.66,0.13
3686,0,36655310,32929,301.63,335729.22,2,36655310,0,36655310,32929,301.60,91.08,335729.22,1,10.14,10.66,0.16
3687,0,36655310,0,0.00,335729.22,2,36666023,10713,36655310,0,0.00,91.06,335729.22,0,10.78,9.78,0.13
3688,0,36655310,0,0.00,335729.22,2,36671692,16382,36655310,0,0.00,91.03,335729.22,1,11.13,10.13,0.16
3689,0,36655310,0,0.00,335729.22,2,36675847,20537,36655310,0,0.00,91.01,335729.22,0,10.93,9.93,0.13
3690,0,36655310,0,0.00,335729.22,2,36679870,24560,36655310,0,0.00,90.98,335729.22,1,11.63,10.63,0.16
3691,0,36662836,7526,68.91,335798.16,2,36683633,20797,36662836,7526,68.93,90.98,335798.16,0,10.61,10.63,0.13
3692,0,36662836,0,0.00,335798.16,2,36687168,24332,36662836,0,0.00,90.95,335798.16,1,11.43,10.43,0.16
3693,0,36662836,0,0.00,335798.16,2,36690321,27485,36662836,0,0.00,90.93,335798.16,0,10.94,9.94,0.13
3694,0,36662836,0,0.00,335798.16,2,36693207,30371,36662836,0,0.00,90.90,335798.16,1,10.94,9.94,0.16
3695,0,36668198,5362,49.13,335847.28,2,36695888,27690,36668198,5362,49.11,90.89,335847.28,0,9.55,9.94,0.13
3696,0,36673546,5348,48.95,335896.22,2,36698562,25016,36673546,5348,48.98,90.88,335896.22,1,9.60,9.94,0.16
3697,0,36678768,5222,47.85,335944.06,2,36701173,22405,36678768,5222,47.83,90.87,335944.06,0,8.53,9.94,0.13
3698,0,36678768,0,0.00,335944.06,2,36703723,24955,36678768,0,0.00,90.84,335944.06,0,9.99,8.99,0.16
3699,0,36678768,0,0.00,335944.06,2,36705893,27125,36678768,0,0.00,90.82,335944.06,1,10.27,9.27,0.19
3700,0,36683066,4298,39.35,335983.41,2,36708042,24976,36683066,4298,39.37,90.81,335983.41,0,8.54,9.27,0.15
3701,0,36687716,4650,42.61,336026.03,2,36710367,22651,36687716,4650,42.59,90.79,336026.03,1,8.57,9.27,0.18
3702,0,36692574,4858,44.51,336070.53,2,36712796,20222,36692574,4858,44.49,90.78,336070.53,0,7.45,9.27,0.16
3703,0,36697684,5110,46.78,336117.31,2,36715351,17667,36697684,5110,46.80,90.77,336117.31,1,7.49,9.27,0.19
3704,0,36704114,6430,58.87,336176.19,2,36718566,14452,36704114,6430,58.89,90.76,336176.19,0,5.84,9.27,0.15
3705,0,36716044,11930,109.29,336285.47,2,36724531,8487,36716044,11930,109.27,90.77,336285.47,1,6.10,9.27,0.17
3706,0,36742640,26596,243.60,336529.06,2,36742640,0,36742640,26596,243.60,90.81,336529.06,1,6.36,9.27,0.17
3707,0,36777006,34366,314.78,336843.84,2,36777006,0,36777006,34366,314.76,90.87,336843.84,0,5.57,9.27,0.15
3708,0,36812154,35148,321.89,337165.75,2,36812154,0,36812154,35148,321.92,90.93,337165.75,1,5.88,9.27,0.18
3709,0,36847370,35216,322.55,337488.28,2,36847370,0,36847370,35216,322.55,90.99,337488.28,0,7.86,9.27,0.16
3710,0,36847370,0,0.00,337488.28,2,36858076,10706,36847370,0,0.00,90.97,337488.28,1,10.70,9.70,0.18
3711,0,36847370,0,0.00,337488.28,2,36863779,16409,36847370,0,0.00,90.94,337488.28,0,10.77,9.77,0.17
3712,0,36847370,0,0.00,337488.28,2,36868245,20875,36847370,0,0.00,90.92,337488.28,1,11.02,10.02,0.19
3713,0,36855768,8398,76.94,337565.22,2,36872444,16676,36855768,8398,76.92,90.91,337565.22,0,9.76,10.02,0.17
3714,0,36864216,8448,77.38,337642.59,2,36876668,12452,36864216,8448,77.38,90.91,337642.59,1,9.84,10.02,0.20
3715,0,36876786,12570,115.11,337757.72,2,36882953,6167,36876786,12570,115.13,90.92,337757.72,0,8.80,10.02,0.16
3716,0,36907056,30270,277.26,338034.97,2,36907056,0,36907056,30270,277.25,90.97,338034.97,1,9.50,10.02,0.19
3717,0,36940843,33787,309.47,338344.44,2,36940843,0,36940843,33787,309.46,91.03,338344.44,0,9.01,10.02,0.17
3718,0,36974987,34144,312.73,338657.19,2,36974987,0,36974987,34144,312.73,91.09,338657.19,0,9.31,10.02,0.20
3719,0,36974987,0,0.00,338657.19,2,36985607,10620,36974987,0,0.00,91.06,338657.19,1,14.88,13.88,0.23
3720,0,36974987,0,0.00,338657.19,2,36991193,16206,36974987,0,0.00,91.04,338657.19,0,14.24,13.24,0.19
3721,0,36974987,0,0.00,338657.19,2,36995215,20228,36974987,0,0.00,91.01,338657.19,1,14.24,13.24,0.22
3722,0,36983101,8114,74.30,338731.47,2,36999272,16171,36983101,8114,74.32,91.01,338731.47,0,12.86,13.24,0.20
3723,0,36991879,8778,80.42,338811.88,2,37003661,11782,36991879,8778,80.40,91.01,338811.88,1,12.94,13.24,0.22
3724,0,37006807,14928,136.73,338948.62,2,37011125,4318,37006807,14928,136.73,91.02,338948.62,0,11.85,13.24,0.20
3725,0,37037872,31065,284.52,339233.12,2,37037872,0,37037872,31065,284.53,91.07,339233.12,1,12.41,13.24,0.23
3726,0,37069407,31535,288.84,339521.97,2,37069407,0,37069407,31535,288.83,91.12,339521.97,1,12.36,13.24,0.22
3727,0,37101765,32358,296.35,339818.31,2,37101765,0,37101765,32358,296.37,91.18,339818.31,0,12.99,13.24,0.20
3728,0,37101765,0,0.00,339818.31,2,37112400,10635,37101765,0,0.00,91.15,339818.31,1,13.47,12.47,0.22
3729,0,37101765,0,0.00,339818.31,2,37118228,16463,37101765,0,0.00,91.13,339818.31,0,13.48,12.48,0.21
3730,0,37101765,0,0.00,339818.31,2,37122546,20781,37101765,0,0.00,91.10,339818.31,1,13.48,12.48,0.23
3731,0,37101765,0,0.00,339818.31,2,37126376,24611,37101765,0,0.00,91.08,339818.31,0,12.89,11.89,0.22
3732,0,37101765,0,0.00,339818.31,2,37130058,28293,37101765,0,0.00,91.06,339818.31,1,12.89,11.89,0.24
3733,0,37101765,0,0.00,339818.31,2,37133417,31652,37101765,0,0.00,91.03,339818.31,0,12.47,11.47,0.22
3734,0,37101765,0,0.00,339818.31,2,37136532,34767,37101765,0,0.00,91.01,339818.31,1,12.47,11.47,0.25
3735,0,37107611,5846,53.56,339871.88,2,37139455,31844,37107611,5846,53.54,91.00,339871.88,0,11.21,11.47,0.22
3736,0,37107611,0,0.00,339871.88,2,37142290,34679,37107611,0,0.00,90.97,339871.88,1,13.49,12.49,0.25
3737,0,37107611,0,0.00,339871.88,2,37144910,37299,37107611,0,0.00,90.95,339871.88,0,13.41,12.41,0.23
3738,0,37107611,0,0.00,339871.88,2,37147397,39786,37107611,0,0.00,90.92,339871.88,1,13.41,12.41,0.26
3739,0,37112377,4766,43.63,339915.53,2,37149780,37403,37112377,4766,43.65,90.91,339915.53,0,11.87,12.41,0.23
3740,0,37116973,4596,42.10,339957.62,2,37152078,35105,37116973,4596,42.10,90.90,339957.62,1,11.92,12.41,0.25
3741,0,37121221,4248,38.91,339996.53,2,37154202,32981,37121221,4248,38.91,90.88,339996.53,0,12.16,12.41,0.23
3742,0,37125481,4260,39.02,340035.53,2,37156332,30851,37125481,4260,39.02,90.87,340035.53,1,12.20,12.41,0.26
3743,0,37130033,4552,41.69,340077.25,2,37158608,28575,37130033,4552,41.69,90.86,340077.25,0,11.15,12.41,0.25
3744,0,37134563,4530,41.51,340118.75,2,37160873,26310,37134563,4530,41.49,90.84,340118.75,1,11.48,12.41,0.27
3745,0,37139085,4522,41.40,340160.16,2,37163134,24049,37139085,4522,41.42,90.83,340160.16,0,10.24,12.41,0.25
3746,0,37143743,4658,42.68,340202.81,2,37165463,21720,37143743,4658,42.66,90.82,340202.81,1,10.56,12.41,0.28
3747,0,37148507,4764,43.63,340246.47,2,37167845,19338,37148507,4764,43.63,90.81,340246.47,0,8.99,12.41,0.24
3748,0,37153577,5070,46.42,340292.88,2,37170380,16803,37153577,5070,46.44,90.79,340292.88,1,9.04,12.41,0.27
3749,0,37159547,5970,54.70,340347.56,2,37173365,13818,37159547,5970,54.68,90.78,340347.56,0,8.08,12.41,0.24
3750,0,37172059,12512,114.60,340462.19,2,37179621,7562,37172059,12512,114.60,90.79,340462.19,1,8.63,12.41,0.27
3751,0,37199197,27138,248.54,340710.72,2,37199197,0,37199197,27138,248.56,90.83,340710.72,0,7.40,12.41,0.24
3752,0,37232362,33165,303.75,341014.47,2,37232362,0,37232362,33165,303.76,90.89,341014.47,1,8.94,12.41,0.26
3753,0,37265883,33521,307.05,341321.53,2,37265883,0,37265883,33521,307.02,90.95,341321.53,0,8.45,12.41,0.21
3754,0,37298403,32520,297.85,341619.38,2,37298403,0,37298403,32520,297.85,91.00,341619.38,1,11.26,12.41,0.24
3755,0,37298403,0,0.00,341619.38,2,37309086,10683,37298403,0,0.00,90.98,341619.38,0,12.85,11.85,0.22
3756,0,37298403,0,0.00,341619.38,2,37314806,16403,37298403,0,0.00,90.95,341619.38,0,12.90,11.90,0.24
3757,0,37298403,0,0.00,341619.38,2,37319286,20883,37298403,0,0.00,90.93,341619.38,1,12.90,11.90,0.27
3758,0,37306695,8292,75.95,341695.31,2,37323432,16737,37306695,8292,75.95,90.92,341695.31,0,11.11,11.90,0.23
3759,0,37314785,8090,74.08,341769.41,2,37327477,12692,37314785,8090,74.10,90.92,341769.41,1,11.27,11.90,0.25
3760,0,37327025,12240,112.11,341881.50,2,37333597,6572,37327025,12240,112.11,90.93,341881.50,0,9.88,11.90,0.22
3761,0,37354633,27608,252.86,342134.38,2,37354633,0,37354633,27608,252.86,90.97,342134.38,1,11.77,11.90,0.25
3762,0,37354633,0,0.00,342134.38,2,37365167,10534,37354633,0,0.00,90.94,342134.38,0,12.57,11.57,0.23
3763,0,37354633,0,0.00,342134.38,2,37371069,16436,37354633,0,0.00,90.92,342134.38,1,12.57,11.57,0.25
3764,0,37354633,0,0.00,342134.38,2,37375763,21130,37354633,0,0.00,90.90,342134.38,1,13.38,12.38,0.22
3765,0,37362443,7810,71.55,342205.91,2,37379668,17225,37362443,7810,71.53,90.89,342205.91,0,12.15,12.38,0.20
3766,0,37370213,7770,71.15,342277.06,2,37383553,13340,37370213,7770,71.17,90.89,342277.06,1,12.22,12.38,0.23
3767,0,37378927,8714,79.83,342356.91,2,37387910,8983,37378927,8714,79.81,90.88,342356.91,0,10.99,12.38,0.21
3768,0,37402347,23420,214.51,342571.41,2,37402347,0,37402347,23420,214.51,90.92,342571.41,1,11.35,12.38,0.23
3769,0,37434252,31905,292.21,342863.62,2,37434252,0,37434252,31905,292.22,90.97,342863.62,1,11.39,12.38,0.21
3770,0,37466394,32142,294.37,343158.00,2,37466394,0,37466394,32142,294.39,91.02,343158.00,0,11.23,12.38,0.20
3771,0,37498394,32000,293.09,343451.06,2,37498394,0,37498394,32000,293.09,91.08,343451.06,0,11.64,12.38,0.23
3772,0,37498394,0,0.00,343451.06,2,37508943,10549,37498394,0,0.00,91.05,343451.06,1,13.13,12.13,0.25
3773,0,37519906,21512,197.03,343648.09,2,37519906,0,37519906,21512,197.03,91.08,343648.09,0,11.56,12.13,0.22
3774,0,37519906,0,0.00,343648.09,2,37531137,11231,37519906,0,0.00,91.06,343648.09,1,14.35,13.35,0.24
3775,0,37519906,0,0.00,343648.09,2,37537022,17116,37519906,0,0.00,91.03,343648.09,0,14.83,13.83,0.22
3776,0,37519906,0,0.00,343648.09,2,37541381,21475,37519906,0,0.00,91.01,343648.09,1,14.83,13.83,0.25
3777,0,37528338,8432,77.23,343725.34,2,37545597,17259,37528338,8432,77.23,91.00,343725.34,0,13.20,13.83,0.21
3778,0,37528338,0,0.00,343725.34,2,37549476,21138,37528338,0,0.00,90.98,343725.34,0,15.00,14.00,0.24
3779,0,37528338,0,0.00,343725.34,2,37552786,24448,37528338,0,0.00,90.96,343725.34,1,15.00,14.00,0.27
3780,0,37534562,6224,57.01,343782.34,2,37555898,21336,37534562,6224,57.01,90.95,343782.34,0,13.57,14.00,0.24
3781,0,37540616,6054,55.47,343837.81,2,37558925,18309,37540616,6054,55.45,90.94,343837.81,1,13.63,14.00,0.27
3782,0,37546742,6126,56.13,343893.94,2,37561988,15246,37546742,6126,56.11,90.93,343893.94,0,13.23,14.00,0.24
3783,0,37546742,0,0.00,343893.94,2,37564945,18203,37546742,0,0.00,90.91,343893.94,1,14.15,13.15,0.27
3784,0,37552522,5780,52.90,343946.84,2,37567835,15313,37552522,5780,52.94,90.90,343946.84,1,12.69,13.15,0.24
3785,0,37559786,7264,66.53,344013.38,2,37571467,11681,37559786,7264,66.53,90.89,344013.38,1,12.22,13.15,0.24
3786,0,37575672,15886,145.52,344158.91,2,37579410,3738,37575672,15886,145.50,90.90,344158.91,0,11.60,13.15,0.22
3787,0,37606551,30879,282.83,344441.72,2,37606551,0,37606551,30879,282.82,90.95,344441.72,1,12.62,13.15,0.24
3788,0,37638410,31859,291.77,344733.50,2,37638410,0,37638410,31859,291.80,91.01,344733.50,0,12.77,13.15,0.22
3789,0,37638410,0,0.00,344733.50,2,37648740,10330,37638410,0,0.00,90.98,344733.50,1,14.06,13.06,0.24
3790,0,37638410,0,0.00,344733.50,2,37654558,16148,37638410,0,0.00,90.96,344733.50,0,13.25,12.25,0.21
3791,0,37638410,0,0.00,344733.50,2,37658904,20494,37638410,0,0.00,90.93,344733.50,1,13.25,12.25,0.24
3792,0,37646620,8210,75.21,344808.72,2,37663009,16389,37646620,8210,75.20,90.93,344808.72,0,11.56,12.25,0.20
3793,0,37654634,8014,73.38,344882.09,2,37667016,12382,37654634,8014,73.40,90.93,344882.09,1,11.64,12.25,0.23
3794,0,37666190,11556,105.88,344987.97,2,37672794,6604,37666190,11556,105.84,90.93,344987.97,0,10.45,12.25,0.20
3795,0,37693238,27048,247.74,345235.72,2,37693238,0,37693238,27048,247.74,90.97,345235.72,0,10.56,12.25,0.22
3796,0,37693238,0,0.00,345235.72,2,37703570,10332,37693238,0,0.00,90.95,345235.72,1,12.59,11.59,0.25
3797,0,37693238,0,0.00,345235.72,2,37709706,16468,37693238,0,0.00,90.92,345235.72,0,11.75,10.75,0.18
3798,0,37693238,0,0.00,345235.72,2,37714438,21200,37693238,0,0.00,90.90,345235.72,0,11.75,10.75,0.20
3799,0,37693238,0,0.00,345235.72,2,37718536,25298,37693238,0,0.00,90.88,345235.72,1,12.04,11.04,0.23
3800,0,37693238,0,0.00,345235.72,2,37722177,28939,37693238,0,0.00,90.85,345235.72,0,11.87,10.87,0.20
3801,0,37693238,0,0.00,345235.72,2,37725513,32275,37693238,0,0.00,90.83,345235.72,1,11.87,10.87,0.22
3802,0,37699392,6154,56.35,345292.06,2,37728590,29198,37699392,6154,56.37,90.82,345292.06,0,9.34,10.87,0.15
3803,0,37705214,5822,53.34,345345.41,2,37731501,26287,37705214,5822,53.32,90.81,345345.41,1,9.40,10.87,0.18
3804,0,37711372,6158,56.38,345401.78,2,37734580,23208,37711372,6158,56.40,90.80,345401.78,1,8.10,10.87,0.12
3805,0,37717458,6086,55.72,345457.50,2,37737623,20165,37717458,6086,55.74,90.79,345457.50,0,7.69,10.87,0.10
3806,0,37723412,5954,54.55,345512.06,2,37740600,17188,37723412,5954,54.53,90.78,345512.06,1,7.75,10.87,0.13
3807,0,37729296,5884,53.89,345565.94,2,37743542,14246,37729296,5884,53.89,90.77,345565.94,0,5.68,10.87,0.08
3808,0,37737346,8050,73.71,345639.66,2,37747567,10221,37737346,8050,73.73,90.77,345639.66,1,5.73,10.87,0.10
3809,0,37757980,20634,189.01,345828.66,2,37757980,0,37757980,20634,188.99,90.79,345828.66,0,5.77,10.87,0.06
3810,0,37791170,33190,303.97,346132.62,2,37791170,0,37791170,33190,303.99,90.85,346132.62,1,6.90,10.87,0.09
3811,0,37825157,33987,311.30,346443.94,2,37825157,0,37825157,33987,311.29,90.91,346443.94,0,6.85,10.87,0.05
3812,0,37859123,33966,311.12,346755.06,2,37859123,0,37859123,33966,311.10,90.96,346755.06,1,7.91,10.87,0.08
3813,0,37892793,33670,308.37,347063.41,2,37892793,0,37892793,33670,308.39,91.02,347063.41,0,7.17,10.87,0.05
3814,0,37926851,34058,311.96,347375.38,2,37926851,0,37926851,34058,311.94,91.08,347375.38,1,8.91,10.87,0.07
3815,0,37961074,34223,313.42,347688.81,2,37961074,0,37961074,34223,313.45,91.14,347688.81,0,8.20,10.87,0.03
3816,0,37994169,33095,303.13,347991.94,2,37994169,0,37994169,33095,303.12,91.19,347991.94,1,10.84,10.87,0.06
3817,0,38027894,33725,308.92,348300.84,2,38027894,0,38027894,33725,308.89,91.25,348300.84,0,10.05,10.87,0.04
3818,0,38027894,0,0.00,348300.84,2,38038491,10597,38027894,0,0.00,91.23,348300.84,0,13.19,12.19,0.07
3819,0,38027894,0,0.00,348300.84,2,38043878,15984,38027894,0,0.00,91.20,348300.84,1,13.19,12.19,0.10
3820,0,38027894,0,0.00,348300.84,2,38047945,20051,38027894,0,0.00,91.18,348300.84,1,13.54,12.54,0.06
3821,0,38035604,7710,70.60,348371.44,2,38051800,16196,38035604,7710,70.62,91.17,348371.44,0,11.98,12.54,0.03
3822,0,38043822,8218,75.29,348446.75,2,38055909,12087,38043822,8218,75.27,91.17,348446.75,1,12.05,12.54,0.06
3823,0,38057086,13264,121.49,348568.22,2,38062541,5455,38057086,13264,121.49,91.18,348568.22,0,10.67,12.54,0.03
3824,0,38086721,29635,271.40,348839.62,2,38086721,0,38086721,29635,271.43,91.22,348839.62,1,11.16,12.54,0.06
3825,0,38118640,31919,292.36,349131.97,2,38118640,0,38118640,31919,292.35,91.28,349131.97,0,10.45,12.54,0.03
3826,0,38151128,32488,297.56,349429.53,2,38151128,0,38151128,32488,297.56,91.33,349429.53,1,12.18,12.54,0.06
3827,0,38183555,32427,297.01,349726.56,2,38183555,0,38183555,32427,297.00,91.38,349726.56,1,11.36,12.54,0.01
3828,0,38216019,32464,297.34,350023.91,2,38216019,0,38216019,32464,297.34,91.44,350023.91,0,12.20,12.54,0.01
3829,0,38248342,32323,296.06,350319.97,2,38248342,0,38248342,32323,296.05,91.49,350319.97,0,12.49,12.54,0.03
3830,0,38248342,0,0.00,350319.97,2,38259027,10685,38248342,0,0.00,91.47,350319.97,1,14.87,13.87,0.05
3831,0,38248342,0,0.00,350319.97,2,38265058,16716,38248342,0,0.00,91.44,350319.97,0,15.08,14.08,0.00
3832,0,38248342,0,0.00,350319.97,2,38269703,21361,38248342,0,0.00,91.42,350319.97,1,15.20,14.20,0.03
3833,0,38256258,7916,72.47,350392.41,2,38273661,17403,38256258,7916,72.50,91.41,350392.41,0,12.98,14.20,0.03
3834,0,38263888,7630,69.90,350462.31,2,38277476,13588,38263888,7630,69.88,91.41,350462.31,1,13.05,14.20,0.03
3835,0,38274064,10176,93.20,350555.53,2,38282564,8500,38274064,10176,93.20,91.41,350555.53,0,11.66,14.20,0.03
3836,0,38300946,26882,246.20,350801.72,2,38300946,0,38300946,26882,246.21,91.45,350801.72,1,11.75,14.20,0.03
3837,0,38325861,24915,228.21,351029.94,2,38328999,3138,38325861,24915,228.20,91.49,351029.94,0,17.90,16.90,0.03
3838,0,38325861,0,0.00,351029.94,2,38337967,12106,38325861,0,0.00,91.46,351029.94,0,18.12,17.12,0.03
3839,0,38325861,0,0.00,351029.94,2,38343184,17323,38325861,0,0.00,91.44,351029.94,0,18.12,17.12,0.05
3840,0,38325861,0,0.00,351029.94,2,38347675,21814,38325861,0,0.00,91.41,351029.94,1,20.26,19.26,0.08
3841,0,38334237,8376,76.72,351106.66,2,38351863,17626,38334237,8376,76.72,91.41,351106.66,0,18.58,19.26,0.04
3842,0,38334237,0,0.00,351106.66,2,38355638,21401,38334237,0,0.00,91.39,351106.66,1,19.26,18.26,0.06
3843,0,38341041,6804,62.32,351168.97,2,38359040,17999,38341041,6804,62.32,91.38,351168.97,0,17.79,18.26,0.03
3844,0,38347847,6806,62.36,351231.31,2,38362443,14596,38347847,6806,62.34,91.37,351231.31,1,17.85,18.26,0.05
3845,0,38356115,8268,75.73,351307.06,2,38366577,10462,38356115,8268,75.73,91.37,351307.06,1,16.14,18.26,0.01
3846,0,38373733,17618,161.35,351468.41,2,38375386,1653,38373733,17618,161.36,91.39,351468.41,0,15.23,18.26,0.00
3847,0,38406184,32451,297.23,351765.62,2,38406184,0,38406184,32451,297.22,91.44,351765.62,1,15.46,18.26,0.03
3848,0,38438366,32182,294.78,352060.41,2,38438366,0,38438366,32182,294.76,91.49,352060.41,1,15.95,18.26,0.00
3849,0,38461504,23138,211.90,352272.31,2,38465344,3840,38461504,23138,211.92,91.52,352272.31,0,18.78,17.78,0.00
3850,0,38461504,0,0.00,352272.31,2,38473909,12405,38461504,0,0.00,91.50,352272.31,1,18.99,17.99,0.03
3851,0,38461504,0,0.00,352272.31,2,38479060,17556,38461504,0,0.00,91.48,352272.31,0,19.13,18.13,0.03
3852,0,38461504,0,0.00,352272.31,2,38483307,21803,38461504,0,0.00,91.45,352272.31,1,19.13,18.13,0.03
3853,0,38461504,0,0.00,352272.31,2,38486901,25397,38461504,0,0.00,91.43,352272.31,1,18.86,17.86,0.00
3854,0,38468750,7246,66.39,352338.69,2,38490524,21774,38468750,7246,66.37,91.42,352338.69,0,17.43,17.86,0.00
3855,0,38475840,7090,64.92,352403.62,2,38494069,18229,38475840,7090,64.94,91.41,352403.62,0,17.49,17.86,0.03
3856,0,38475840,0,0.00,352403.62,2,38497239,21399,38475840,0,0.00,91.39,352403.62,1,18.15,17.15,0.05
3857,0,38481584,5744,52.61,352456.22,2,38500111,18527,38481584,5744,52.61,91.38,352456.22,0,16.59,17.15,0.01
3858,0,38481584,0,0.00,352456.22,2,38502980,21396,38481584,0,0.00,91.36,352456.22,1,17.81,16.81,0.04
3859,0,38481584,0,0.00,352456.22,2,38505522,23938,38481584,0,0.00,91.33,352456.22,0,17.66,16.66,0.01
3860,0,38481584,0,0.00,352456.22,2,38507836,26252,38481584,0,0.00,91.31,352456.22,1,17.84,16.84,0.04
3861,0,38485984,4400,40.30,352496.53,2,38510036,24052,38485984,4400,40.30,91.30,352496.53,0,16.36,16.84,0.04
3862,0,38490448,4464,40.89,352537.41,2,38512268,21820,38490448,4464,40.89,91.28,352537.41,1,16.40,16.84,0.03
3863,0,38495172,4724,43.27,352580.69,2,38514630,19458,38495172,4724,43.27,91.27,352580.69,0,15.29,16.84,0.03
3864,0,38500766,5594,51.25,352631.94,2,38517427,16661,38500766,5594,51.24,91.26,352631.94,1,15.33,16.84,0.03
3865,0,38508274,7508,68.73,352700.66,2,38521181,12907,38508274,7508,68.77,91.26,352700.66,1,13.22,16.84,0.03
3866,0,38522318,14044,128.67,352829.31,2,38528203,5885,38522318,14044,128.63,91.26,352829.31,0,13.29,16.84,0.03
3867,0,38549354,27036,247.59,353076.91,2,38549354,0,38549354,27036,247.63,91.31,353076.91,0,13.41,16.84,0.05
3868,0,38581328,31974,292.87,353369.78,2,38581328,0,38581328,31974,292.85,91.36,353369.78,1,13.65,16.84,0.08
3869,0,38613567,32239,295.29,353665.06,2,38613567,0,38613567,32239,295.28,91.41,353665.06,0,13.84,16.84,0.02
3870,0,38645641,32074,293.75,353958.81,2,38645641,0,38645641,32074,293.77,91.46,353958.81,1,15.96,16.84,0.05
3871,0,38645641,0,0.00,353958.81,2,38656238,10597,38645641,0,0.00,91.44,353958.81,0,17.02,16.02,0.02
3872,0,38645641,0,0.00,353958.81,2,38661954,16313,38645641,0,0.00,91.41,353958.81,1,17.36,16.36,0.05
3873,0,38656233,10592,97.01,354055.84,2,38667250,11017,38656233,10592,97.01,91.42,354055.84,0,15.50,16.36,0.01
3874,0,38675331,19098,174.94,354230.78,2,38676799,1468,38675331,19098,174.92,91.44,354230.78,1,15.65,16.36,0.03
3875,0,38707922,32591,298.48,354529.25,2,38707922,0,38707922,32591,298.50,91.49,354529.25,0,15.91,16.36,0.03
3876,0,38740710,32788,300.34,354829.59,2,38740710,0,38740710,32788,300.31,91.55,354829.59,1,16.20,16.36,0.03
3877,0,38749776,9066,83.02,354912.62,2,38758001,8225,38749776,9066,83.04,91.54,354912.62,0,18.52,17.52,0.03
3878,0,38749776,0,0.00,354912.62,2,38764449,14673,38749776,0,0.00,91.52,354912.62,0,18.61,17.61,0.03
3879,0,38749776,0,0.00,354912.62,2,38768898,19122,38749776,0,0.00,91.50,354912.62,1,18.61,17.61,0.05
3880,0,38749776,0,0.00,354912.62,2,38772893,23117,38749776,0,0.00,91.47,354912.62,0,18.49,17.49,0.00
3881,0,38749776,0,0.00,354912.62,2,38776508,26732,38749776,0,0.00,91.45,354912.62,1,18.49,17.49,0.03
3882,0,38756662,6886,63.09,354975.69,2,38779951,23289,38756662,6886,63.07,91.44,354975.69,0,16.98,17.49,0.03
3883,0,38763524,6862,62.83,355038.53,2,38783382,19858,38763524,6862,62.85,91.43,355038.53,1,17.05,17.49,0.03
3884,0,38769826,6302,57.70,355096.25,2,38786533,16707,38769826,6302,57.72,91.43,355096.25,0,15.43,17.49,0.03
3885,0,38776262,6436,58.98,355155.22,2,38789751,13489,38776262,6436,58.95,91.42,355155.22,1,15.48,17.49,0.03
3886,0,38785428,9166,83.93,355239.16,2,38794334,8906,38785428,9166,83.95,91.42,355239.16,1,15.13,17.49,0.01
3887,0,38809065,23637,216.48,355455.62,2,38809065,0,38809065,23637,216.49,91.45,355455.62,0,14.14,17.49,0.01
3888,0,38842002,32937,301.66,355757.31,2,38842002,0,38842002,32937,301.67,91.50,355757.31,1,14.35,17.49,0.03
3889,0,38874749,32747,299.94,356057.25,2,38874749,0,38874749,32747,299.93,91.55,356057.25,0,15.60,17.49,0.03
3890,0,38907251,32502,297.71,356354.94,2,38907251,0,38907251,32502,297.69,91.61,356354.94,1,15.90,17.49,0.03
3891,0,38939804,32553,298.15,356653.09,2,38939804,0,38939804,32553,298.16,91.66,356653.09,0,15.86,17.49,0.00
3892,0,38939804,0,0.00,356653.09,2,38950259,10455,38939804,0,0.00,91.64,356653.09,1,18.86,17.86,0.03
3893,0,38939804,0,0.00,356653.09,2,38956051,16247,38939804,0,0.00,91.61,356653.09,0,18.51,17.51,0.00
3894,0,38939804,0,0.00,356653.09,2,38960318,20514,38939804,0,0.00,91.59,356653.09,1,20.33,19.33,0.03
3895,0,38947732,7928,72.61,356725.72,2,38964282,16550,38947732,7928,72.61,91.59,356725.72,0,18.54,19.33,0.03
3896,0,38956188,8456,77.45,356803.16,2,38968510,12322,38956188,8456,77.45,91.58,356803.16,1,18.61,19.33,0.03
3897,0,38968658,12470,114.20,356917.34,2,38974745,6087,38968658,12470,114.21,91.59,356917.34,0,19.08,19.33,0.00
3898,0,38996608,27950,256.01,357173.38,2,38996608,0,38996608,27950,256.00,91.63,357173.38,0,19.19,19.33,0.03
3899,0,38996608,0,0.00,357173.38,2,39007394,10786,38996608,0,0.00,91.61,357173.38,1,20.15,19.15,0.05
3900,0,39016088,19480,178.42,357351.78,2,39017134,1046,39016088,19480,178.42,91.63,357351.78,1,18.96,19.15,0.01
3901,0,39028279,12191,111.67,357463.47,2,39035723,7444,39028279,12191,111.66,91.63,357463.47,0,20.54,19.54,0.01
3902,0,39028279,0,0.00,357463.47,2,39042688,14409,39028279,0,0.00,91.61,357463.47,1,20.65,19.65,0.03
3903,0,39040983,12704,116.36,357579.81,2,39049040,8057,39040983,12704,116.36,91.62,357579.81,0,19.61,19.65,0.00
3904,0,39040983,0,0.00,357579.81,2,39055230,14247,39040983,0,0.00,91.59,357579.81,1,21.44,19.00,0.03
3905,0,39041007,24,0.22,357580.03,2,39058956,17949,39041007,24,0.22,91.57,357580.03,1,18.21,18.50,0.03
3906,0,39048121,7114,65.14,357645.19,2,39062513,14392,39048121,7114,65.16,91.56,357645.19,0,18.21,18.50,0.03
3907,0,39048121,0,0.00,357645.19,2,39066086,17965,39048121,0,0.00,91.54,357645.19,0,18.67,17.67,0.05
3908,0,39048121,0,0.00,357645.19,2,39068918,20797,39048121,0,0.00,91.52,357645.19,1,19.06,18.06,0.08
3909,0,39053749,5628,51.55,357696.72,2,39071732,17983,39053749,5628,51.55,91.51,357696.72,0,16.83,18.06,0.02
3910,0,39060481,6732,61.66,357758.38,2,39075098,14617,39060481,6732,61.66,91.50,357758.38,1,16.88,18.06,0.04
3911,0,39072583,12102,110.86,357869.25,2,39081149,8566,39072583,12102,110.84,91.50,357869.25,0,15.65,18.06,0.02
3912,0,39097469,24886,227.91,358097.16,2,39097469,0,39097469,24886,227.93,91.54,358097.16,1,15.83,18.06,0.05
3913,0,39130474,33005,302.29,358399.44,2,39130474,0,39130474,33005,302.30,91.59,358399.44,0,15.43,18.06,0.05
3914,0,39163178,32704,299.54,358698.97,2,39163178,0,39163178,32704,299.54,91.65,358698.97,1,15.73,18.06,0.03
3915,0,39195902,32724,299.76,358998.75,2,39195902,0,39195902,32724,299.72,91.70,358998.75,0,16.87,18.06,0.01
3916,0,39195902,0,0.00,358998.75,2,39206327,10425,39195902,0,0.00,91.67,358998.75,1,18.76,17.76,0.03
3917,0,39195902,0,0.00,358998.75,2,39212117,16215,39195902,0,0.00,91.65,358998.75,0,20.26,19.26,0.03
3918,0,39195902,0,0.00,358998.75,2,39216527,20625,39195902,0,0.00,91.63,358998.75,0,20.26,19.26,0.03
3919,0,39195902,0,0.00,358998.75,2,39220305,24403,39195902,0,0.00,91.60,358998.75,1,20.26,19.26,0.05
3920,0,39195902,0,0.00,358998.75,2,39223625,27723,39195902,0,0.00,91.58,358998.75,1,20.27,19.27,0.02
3921,0,39202758,6856,62.79,359061.53,2,39227053,24295,39202758,6856,62.79,91.57,359061.53,0,18.79,19.27,0.02
3922,0,39209512,6754,61.84,359123.38,2,39230430,20918,39209512,6754,61.86,91.57,359123.38,1,18.85,19.27,0.03
3923,0,39215886,6374,58.40,359181.78,2,39233617,17731,39215886,6374,58.38,91.56,359181.78,0,17.26,19.27,0.03
3924,0,39222164,6278,57.48,359239.25,2,39236756,14592,39222164,6278,57.50,91.55,359239.25,1,17.32,19.27,0.03
3925,0,39229538,7374,67.52,359306.78,2,39240443,10905,39229538,7374,67.54,91.54,359306.78,0,16.32,19.27,0.03
3926,0,39247764,18226,166.95,359473.72,2,39249556,1792,39247764,18226,166.93,91.56,359473.72,1,16.38,19.27,0.03
3927,0,39279774,32010,293.20,359766.94,2,39279774,0,39279774,32010,293.18,91.61,359766.94,0,16.41,19.27,0.03
3928,0,39311710,31936,292.50,360059.44,2,39311710,0,39311710,31936,292.50,91.66,360059.44,1,16.70,19.27,0.03
3929,0,39344073,32363,296.39,360355.81,2,39344073,0,39344073,32363,296.42,91.72,360355.81,0,18.12,19.27,0.03
3930,0,39376636,32563,298.26,360654.09,2,39376636,0,39376636,32563,298.25,91.77,360654.09,1,18.41,19.27,0.03
3931,0,39404288,27652,253.27,360907.34,2,39406494,2206,39404288,27652,253.27,91.81,360907.34,0,19.51,18.51,0.03
3932,0,39404288,0,0.00,360907.34,2,39415900,11612,39404288,0,0.00,91.79,360907.34,1,19.76,18.76,0.03
3933,0,39421924,17636,161.53,361068.88,2,39424718,2794,39421924,17636,161.53,91.80,361068.88,0,18.71,18.76,0.03
3934,0,39421924,0,0.00,361068.88,2,39433303,11379,39421924,0,0.00,91.78,361068.88,1,18.86,17.86,0.03
3935,0,39421924,0,0.00,361068.88,2,39438513,16589,39421924,0,0.00,91.76,361068.88,0,18.39,17.39,0.03
3936,0,39421924,0,0.00,361068.88,2,39442036,20112,39421924,0,0.00,91.73,361068.88,1,18.39,17.39,0.03
3937,0,39428474,6550,59.97,361128.84,2,39445311,16837,39428474,6550,59.99,91.73,361128.84,0,16.54,17.39,0.03
3938,0,39437408,8934,81.85,361210.69,2,39449778,12370,39437408,8934,81.83,91.72,361210.69,0,16.60,17.39,0.03
3939,0,39452692,15284,139.99,361350.69,2,39457420,4728,39452692,15284,139.99,91.74,361350.69,1,16.68,17.39,0.05
3940,0,39483009,30317,277.67,361628.34,2,39483009,0,39483009,30317,277.68,91.78,361628.34,0,15.07,17.39,0.01
3941,0,39483009,0,0.00,361628.34,2,39493526,10517,39483009,0,0.00,91.76,361628.34,1,20.39,19.39,0.04
3942,0,39503105,20096,184.06,361812.41,2,39503574,469,39503105,20096,184.06,91.78,361812.41,0,19.27,19.39,0.00
3943,0,39503105,0,0.00,361812.41,2,39514056,10951,39503105,0,0.00,91.76,361812.41,1,20.83,19.83,0.03
3944,0,39522625,19520,178.79,361991.19,2,39523816,1191,39522625,19520,178.79,91.78,361991.19,1,18.80,19.83,0.03
3945,0,39555032,32407,296.83,362288.03,2,39555032,0,39555032,32407,296.82,91.83,362288.03,0,18.97,19.83,0.03
3946,0,39555032,0,0.00,362288.03,2,39565420,10388,39555032,0,0.00,91.81,362288.03,1,20.07,19.07,0.05
3947,0,39555032,0,0.00,362288.03,2,39571119,16087,39555032,0,0.00,91.79,362288.03,0,19.52,18.52,0.01
3948,0,39555032,0,0.00,362288.03,2,39575629,20597,39555032,0,0.00,91.76,362288.03,1,19.63,18.63,0.04
3949,0,39563458,8426,77.16,362365.19,2,39579842,16384,39563458,8426,77.17,91.76,362365.19,0,18.11,18.63,0.01
3950,0,39571890,8432,77.23,362442.41,2,39584058,12168,39571890,8432,77.23,91.76,362442.41,1,18.18,18.63,0.04
3951,0,39584268,12378,113.39,362555.81,2,39590247,5979,39584268,12378,113.37,91.76,362555.81,0,16.31,18.63,0.04
3952,0,39613595,29327,268.62,362824.41,2,39613595,0,39613595,29327,268.61,91.81,362824.41,1,16.42,18.63,0.03
3953,0,39645696,32101,294.01,363118.44,2,39645696,0,39645696,32101,294.02,91.86,363118.44,0,18.29,18.63,0.03
3954,0,39677932,32236,295.25,363413.69,2,39677932,0,39677932,32236,295.25,91.91,363413.69,1,18.58,18.63,0.03
3955,0,39677932,0,0.00,363413.69,2,39688530,10598,39677932,0,0.00,91.89,363413.69,0,23.26,19.00,0.03
3956,0,39677932,0,0.00,363413.69,2,39694524,16592,39677932,0,0.00,91.86,363413.69,1,23.26,19.00,0.03
3957,0,39677932,0,0.00,363413.69,2,39699188,21256,39677932,0,0.00,91.84,363413.69,0,21.99,19.00,0.00
3958,0,39677932,0,0.00,363413.69,2,39703212,25280,39677932,0,0.00,91.82,363413.69,0,21.99,19.00,0.03
3959,0,39677932,0,0.00,363413.69,2,39706824,28892,39677932,0,0.00,91.79,363413.69,1,22.15,19.00,0.05
3960,0,39677932,0,0.00,363413.69,2,39710147,32215,39677932,0,0.00,91.77,363413.69,0,21.46,19.00,0.01
3961,0,39677932,0,0.00,363413.69,2,39713071,35139,39677932,0,0.00,91.75,363413.69,1,21.50,19.00,0.03
3962,0,39679186,1254,11.47,363425.16,2,39715660,36474,39679186,1254,11.49,91.73,363425.16,1,18.47,18.80,0.03
3963,0,39684652,5466,50.08,363475.22,2,39718393,33741,39684652,5466,50.06,91.72,363475.22,0,18.49,18.80,0.03
3964,0,39690212,5560,50.92,363526.16,2,39721173,30961,39690212,5560,50.92,91.71,363526.16,1,18.53,18.80,0.05
3965,0,39695682,5470,50.08,363576.22,2,39723908,28226,39695682,5470,50.10,91.70,363576.22,0,17.66,18.80,0.03
3966,0,39701072,5390,49.39,363625.62,2,39726603,25531,39701072,5390,49.37,91.69,363625.62,1,18.24,18.80,0.06
3967,0,39706388,5316,48.69,363674.31,2,39729261,22873,39706388,5316,48.69,91.67,363674.31,0,16.65,18.80,0.03
3968,0,39711630,5242,48.03,363722.34,2,39731882,20252,39711630,5242,48.01,91.66,363722.34,1,16.70,18.80,0.05
3969,0,39716920,5290,48.43,363770.78,2,39734527,17607,39716920,5290,48.45,91.65,363770.78,0,15.01,18.80,0.02
3970,0,39722650,5730,52.46,363823.22,2,39737392,14742,39722650,5730,52.48,91.64,363823.22,1,15.06,18.80,0.04
3971,0,39730396,7746,70.96,363894.19,2,39741265,10869,39730396,7746,70.95,91.64,363894.19,0,14.35,18.80,0.02
3972,0,39748190,17794,163.00,364057.19,2,39750162,1972,39748190,17794,162.98,91.66,364057.19,1,15.12,18.80,0.05
3973,0,39780117,31927,292.39,364349.59,2,39780117,0,39780117,31927,292.42,91.71,364349.59,0,15.38,18.80,0.05
3974,0,39812698,32581,298.40,364648.00,2,39812698,0,39812698,32581,298.41,91.76,364648.00,1,15.66,18.80,0.03
3975,0,39845668,32970,301.99,364950.00,2,39845668,0,39845668,32970,301.98,91.81,364950.00,0,15.81,18.80,0.01
3976,0,39877966,32298,295.84,365245.81,2,39877966,0,39877966,32298,295.82,91.86,365245.81,1,16.98,18.80,0.03
3977,0,39910502,32536,298.00,365543.81,2,39910502,0,39910502,32536,298.00,91.91,365543.81,0,17.67,18.80,0.03
3978,0,39942666,32164,294.56,365838.38,2,39942666,0,39942666,32164,294.59,91.97,365838.38,0,17.96,18.80,0.03
3979,0,39942666,0,0.00,365838.38,2,39953145,10479,39942666,0,0.00,91.94,365838.38,1,19.28,18.28,0.05
3980,0,39964986,22320,204.43,366042.81,2,39964986,0,39964986,22320,204.43,91.97,366042.81,0,17.77,18.28,0.01
3981,0,39964986,0,0.00,366042.81,2,39975502,10516,39964986,0,0.00,91.95,366042.81,1,20.18,19.18,0.03
3982,0,39964986,0,0.00,366042.81,2,39981374,16388,39964986,0,0.00,91.92,366042.81,0,20.41,19.41,0.03
3983,0,39964986,0,0.00,366042.81,2,39985899,20913,39964986,0,0.00,91.90,366042.81,1,20.41,19.41,0.03
3984,0,39966472,1486,13.63,366056.44,2,39989979,23507,39966472,1486,13.61,91.88,366056.44,1,19.42,19.57,0.03
3985,0,39974090,7618,69.76,366126.19,2,39993788,19698,39974090,7618,69.77,91.88,366126.19,0,19.44,19.57,0.03
3986,0,39981472,7382,67.63,366193.81,2,39997479,16007,39981472,7382,67.61,91.87,366193.81,1,19.51,19.57,0.05
3987,0,39988626,7154,65.51,366259.34,2,40001056,12430,39988626,7154,65.52,91.86,366259.34,0,17.93,19.57,0.02
3988,0,39999198,10572,96.87,366356.19,2,40006342,7144,39999198,10572,96.83,91.86,366356.19,1,18.00,19.57,0.04
3989,0,40025069,25871,236.93,366593.12,2,40025069,0,40025069,25871,236.95,91.90,366593.12,0,17.31,19.57,0.01
3990,0,40056904,31835,291.59,366884.72,2,40056904,0,40056904,31835,291.58,91.95,366884.72,1,17.71,19.57,0.04
3991,0,40089150,32246,295.36,367180.06,2,40089150,0,40089150,32246,295.34,92.00,367180.06,0,16.76,19.57,0.04
3992,0,40121824,32674,299.25,367479.31,2,40121824,0,40121824,32674,299.26,92.05,367479.31,1,17.05,19.57,0.03
3993,0,40154004,32180,294.74,367774.06,2,40154004,0,40154004,32180,294.74,92.10,367774.06,0,18.46,19.57,0.01
3994,0,40154004,0,0.00,367774.06,2,40164577,10573,40154004,0,0.00,92.08,367774.06,1,21.03,19.00,0.03
3995,0,40154004,0,0.00,367774.06,2,40170070,16066,40154004,0,0.00,92.06,367774.06,0,20.42,19.42,0.03
3996,0,40154004,0,0.00,367774.06,2,40174655,20651,40154004,0,0.00,92.04,367774.06,1,20.42,19.42,0.03
3997,0,40162608,8604,78.80,367852.88,2,40178957,16349,40162608,8604,78.80,92.03,367852.88,0,19.10,19.42,0.00
3998,0,40162608,0,0.00,367852.88,2,40182831,20223,40162608,0,0.00,92.01,367852.88,1,19.82,18.82,0.03
3999,0,40163381,773,7.07,367859.94,2,40186173,22792,40163381,773,7.08,91.99,367859.94,0,19.19,18.19,0.03
4000,0,40163381,0,0.00,367859.94,2,40189233,25852,40163381,0,0.00,91.96,367859.94,1,19.20,18.20,0.03
4001,0,40169067,5686,52.10,367912.03,2,40192076,23009,40169067,5686,52.08,91.96,367912.03,0,17.77,18.20,0.03
4002,0,40174399,5332,48.84,367960.88,2,40194742,20343,40174399,5332,48.84,91.94,367960.88,1,17.82,18.20,0.02
4003,0,40179951,5552,50.85,368011.72,2,40197518,17567,40179951,5552,50.85,91.93,368011.72,0,16.84,18.20,0.02
4004,0,40186449,6498,59.50,368071.22,2,40200767,14318,40186449,6498,59.52,91.93,368071.22,1,16.89,18.20,0.02
4005,0,40196413,9964,91.26,368162.47,2,40205749,9336,40196413,9964,91.26,91.93,368162.47,0,16.89,18.20,0.02
4006,0,40220762,24349,223.01,368385.50,2,40220762,0,40220762,24349,223.01,91.96,368385.50,1,16.98,18.20,0.02
4007,0,40252804,32042,293.49,368678.97,2,40252804,0,40252804,32042,293.48,92.01,368678.97,0,18.18,18.20,0.02
4008,0,40252804,0,0.00,368678.97,2,40263305,10501,40252804,0,0.00,91.99,368678.97,1,18.46,17.46,0.02
4009,0,40261828,9024,82.65,368761.62,2,40271755,9927,40261828,9024,82.65,91.98,368761.62,0,18.30,17.30,0.02
4010,0,40261828,0,0.00,368761.62,2,40277314,15486,40261828,0,0.00,91.96,368761.62,1,18.38,17.38,0.02
4011,0,40272580,10752,98.48,368860.12,2,40282690,10110,40272580,10752,98.48,91.96,368860.12,0,17.12,17.38,0.01
4012,0,40292190,19610,179.63,369039.75,2,40292495,305,40292190,19610,179.61,91.98,369039.75,1,17.22,17.38,0.03
4013,0,40324751,32561,298.22,369337.97,2,40324751,0,40324751,32561,298.23,92.04,369337.97,0,16.70,17.38,0.03
4014,0,40356647,31896,292.14,369630.09,2,40356647,0,40356647,31896,292.14,92.09,369630.09,1,16.99,17.38,0.02
4015,0,40388405,31758,290.86,369920.94,2,40388405,0,40388405,31758,290.87,92.13,369920.94,0,17.05,17.38,0.01
4016,0,40388405,0,0.00,369920.94,2,40398820,10415,40388405,0,0.00,92.11,369920.94,1,17.95,16.95,0.03
4017,0,40399376,10971,100.49,370021.44,2,40407618,8242,40399376,10971,100.48,92.11,370021.44,0,17.08,16.08,0.03
4018,0,40399376,0,0.00,370021.44,2,40413852,14476,40399376,0,0.00,92.09,370021.44,1,17.18,16.18,0.02
4019,0,40399376,0,0.00,370021.44,2,40417589,18213,40399376,0,0.00,92.07,370021.44,0,16.43,15.43,0.02
4020,0,40399376,0,0.00,370021.44,2,40420677,21301,40399376,0,0.00,92.05,370021.44,1,16.43,15.43,0.02
4021,0,40399376,0,0.00,370021.44,2,40423669,24293,40399376,0,0.00,92.02,370021.44,0,19.69,18.69,0.02
4022,0,40399376,0,0.00,370021.44,2,40426489,27113,40399376,0,0.00,92.00,370021.44,1,19.69,18.69,0.02
4023,0,40404824,5448,49.90,370071.34,2,40429213,24389,40404824,5448,49.90,91.99,370071.34,0,18.11,18.69,0.02
4024,0,40410844,6020,55.14,370126.47,2,40432223,21379,40410844,6020,55.14,91.98,370126.47,1,18.16,18.69,0.02
4025,0,40417192,6348,58.14,370184.62,2,40435397,18205,40417192,6348,58.14,91.97,370184.62,0,16.62,18.69,0.02
4026,0,40423738,6546,59.94,370244.56,2,40438670,14932,40423738,6546,59.96,91.96,370244.56,1,16.67,18.69,0.02
4027,0,40431568,7830,71.73,370316.28,2,40442585,11017,40431568,7830,71.72,91.96,370316.28,0,16.77,18.69,0.01
4028,0,40448762,17194,157.46,370473.75,2,40451182,2420,40448762,17194,157.48,91.97,370473.75,1,16.84,18.69,0.04
4029,0,40480066,31304,286.72,370760.47,2,40480066,0,40480066,31304,286.72,92.02,370760.47,0,15.19,18.69,0.04
4030,0,40511849,31783,291.11,371051.59,2,40511849,0,40511849,31783,291.10,92.07,371051.59,1,15.47,18.69,0.02
4031,0,40544236,32387,296.64,371348.22,2,40544236,0,40544236,32387,296.64,92.12,371348.22,0,15.51,18.69,0.01
4032,0,40575904,31668,290.05,371638.28,2,40575904,0,40575904,31668,290.05,92.17,371638.28,1,17.42,18.69,0.03
4033,0,40608091,32187,294.81,371933.09,2,40608091,0,40608091,32187,294.80,92.22,371933.09,0,16.54,18.69,0.03
4034,0,40640145,32054,293.57,372226.66,2,40640145,0,40640145,32054,293.59,92.27,372226.66,1,16.83,18.69,0.02
4035,0,40658937,18792,172.12,372398.78,2,40664302,5365,40658937,18792,172.12,92.29,372398.78,0,18.87,17.87,0.02
4036,0,40658937,0,0.00,372398.78,2,40672714,13777,40658937,0,0.00,92.27,372398.78,1,19.04,18.04,0.02
4037,0,40658937,0,0.00,372398.78,2,40677606,18669,40658937,0,0.00,92.25,372398.78,0,18.18,17.18,0.02
4038,0,40658937,0,0.00,372398.78,2,40682059,23122,40658937,0,0.00,92.22,372398.78,0,18.18,17.18,0.02
4039,0,40658937,0,0.00,372398.78,2,40685960,27023,40658937,0,0.00,92.20,372398.78,1,18.18,17.18,0.05
4040,0,40661081,2144,19.64,372418.41,2,40689532,28451,40661081,2144,19.64,92.18,372418.41,1,18.18,18.56,0.05
4041,0,40667833,6752,61.84,372480.25,2,40692908,25075,40667833,6752,61.84,92.18,372480.25,0,18.20,18.56,0.02
4042,0,40674427,6594,60.41,372540.66,2,40696205,21778,40674427,6594,60.40,92.17,372540.66,1,18.50,18.56,0.05
4043,0,40680897,6470,59.24,372599.91,2,40699440,18543,40680897,6470,59.26,92.16,372599.91,0,16.92,18.56,0.01
4044,0,40687133,6236,57.12,372657.03,2,40702558,15425,40687133,6236,57.12,92.15,372657.03,1,17.13,18.56,0.04
4045,0,40693421,6288,57.59,372714.62,2,40705702,12281,40693421,6288,57.59,92.14,372714.62,0,16.75,18.56,0.00
4046,0,40706029,12608,115.48,372830.09,2,40712006,5977,40706029,12608,115.48,92.15,372830.09,1,16.81,18.56,0.03
4047,0,40735740,29711,272.13,373102.22,2,40735740,0,40735740,29711,272.13,92.19,373102.22,0,16.66,18.56,0.03
4048,0,40767575,31835,291.59,373393.81,2,40767575,0,40767575,31835,291.58,92.24,373393.81,1,16.93,18.56,0.02
4049,0,40799904,32329,296.10,373689.91,2,40799904,0,40799904,32329,296.10,92.29,373689.91,0,15.69,18.56,0.02
4050,0,40832386,32482,297.49,373987.41,2,40832386,0,40832386,32482,297.51,92.34,373987.41,1,15.98,18.56,0.02
4051,0,40864695,32309,295.95,374283.34,2,40864695,0,40864695,32309,295.92,92.39,374283.34,0,17.47,18.56,0.02
4052,0,40897115,32420,296.94,374580.28,2,40897115,0,40897115,32420,296.94,92.44,374580.28,1,17.76,18.56,0.02
4053,0,40905355,8240,75.47,374655.75,2,40913871,8516,40905355,8240,75.47,92.44,374655.75,0,19.90,18.90,0.02
4054,0,40905355,0,0.00,374655.75,2,40920285,14930,40905355,0,0.00,92.42,374655.75,1,19.97,18.97,0.02
4055,0,40911178,5823,53.31,374709.06,2,40925421,14243,40911178,5823,53.33,92.41,374709.06,0,20.62,19.62,0.02
4056,0,40911178,0,0.00,374709.06,2,40929328,18150,40911178,0,0.00,92.38,374709.06,1,20.68,19.68,0.02
4057,0,40918502,7324,67.12,374776.19,2,40932990,14488,40918502,7324,67.08,92.38,374776.19,0,19.28,19.68,0.00
4058,0,40929838,11336,103.83,374880.00,2,40938658,8820,40929838,11336,103.83,92.38,374880.00,0,19.34,19.68,0.03
4059,0,40929838,0,0.00,374880.00,2,40944819,14981,40929838,0,0.00,92.36,374880.00,1,20.76,19.76,0.05
4060,0,40929838,0,0.00,374880.00,2,40948472,18634,40929838,0,0.00,92.33,374880.00,0,20.72,19.72,0.02
4061,0,40929838,0,0.00,374880.00,2,40951236,21398,40929838,0,0.00,92.31,374880.00,1,20.72,19.72,0.05
4062,0,40935296,5458,49.97,374929.97,2,40953965,18669,40935296,5458,49.99,92.30,374929.97,0,19.13,19.72,0.02
4063,0,40942430,7134,65.36,374995.34,2,40957532,15102,40942430,7134,65.34,92.30,374995.34,1,19.46,19.72,0.04
4064,0,40942430,0,0.00,374995.34,2,40961018,18588,40942430,0,0.00,92.27,374995.34,1,19.88,18.88,0.02
4065,0,40948834,6404,58.62,375053.97,2,40964220,15386,40948834,6404,58.65,92.26,375053.97,0,18.84,18.88,0.00
4066,0,40948834,0,0.00,375053.97,2,40967765,18931,40948834,0,0.00,92.24,375053.97,1,19.32,18.32,0.03
4067,0,40954458,5624,51.51,375105.47,2,40971269,16811,40954458,5624,51.51,92.23,375105.47,0,18.72,17.72,0.03
4068,0,40954458,0,0.00,375105.47,2,40974550,20092,40954458,0,0.00,92.21,375105.47,1,18.77,17.77,0.02
4069,0,40954458,0,0.00,375105.47,2,40977106,22648,40954458,0,0.00,92.19,375105.47,0,17.80,16.80,0.00
4070,0,40954458,0,0.00,375105.47,2,40979254,24796,40954458,0,0.00,92.16,375105.47,1,17.80,16.80,0.03
4071,0,40958688,4230,38.76,375144.22,2,40981369,22681,40958688,4230,38.74,92.15,375144.22,0,16.22,16.80,0.03
4072,0,40963430,4742,43.45,375187.69,2,40983740,20310,40963430,4742,43.43,92.14,375187.69,1,16.26,16.80,0.02
4073,0,40969194,5764,52.76,375240.44,2,40986622,17428,40969194,5764,52.79,92.13,375240.44,1,13.12,16.80,0.02
4074,0,40976984,7790,71.37,375311.81,2,40990517,13533,40976984,7790,71.35,92.12,375311.81,0,13.17,16.80,0.02
4075,0,40988864,11880,108.81,375420.62,2,40996457,7593,40988864,11880,108.81,92.13,375420.62,0,13.38,16.80,0.05
4076,0,41013170,24306,222.60,375643.22,2,41013170,0,41013170,24306,222.62,92.16,375643.22,1,13.55,16.80,0.07
4077,0,41045892,32722,299.72,375942.94,2,41045892,0,41045892,32722,299.70,92.21,375942.94,0,12.00,16.80,0.02
4078,0,41077898,32006,293.13,376236.06,2,41077898,0,41077898,32006,293.15,92.26,376236.06,0,13.86,16.80,0.04
4079,0,41110575,32677,299.32,376535.38,2,41110575,0,41110575,32677,299.29,92.31,376535.38,1,15.07,16.80,0.07
4080,0,41143257,32682,299.32,376834.72,2,41143257,0,41143257,32682,299.34,92.36,376834.72,0,14.77,16.80,0.05
4081,0,41175743,32486,297.56,377132.28,2,41175743,0,41175743,32486,297.54,92.41,377132.28,1,15.96,16.80,0.08
4082,0,41208418,32675,299.25,377431.50,2,41208418,0,41208418,32675,299.27,92.46,377431.50,0,15.14,16.80,0.02
4083,0,41208418,0,0.00,377431.50,2,41219219,10801,41208418,0,0.00,92.44,377431.50,1,20.21,19.21,0.05
4084,0,41208418,0,0.00,377431.50,2,41225180,16762,41208418,0,0.00,92.42,377431.50,1,21.72,19.00,0.01
4085,0,41208418,0,0.00,377431.50,2,41229823,21405,41208418,0,0.00,92.39,377431.50,0,20.66,19.66,0.01
4086,0,41208418,0,0.00,377431.50,2,41233856,25438,41208418,0,0.00,92.37,377431.50,0,20.66,19.66,0.02
4087,0,41208418,0,0.00,377431.50,2,41237454,29036,41208418,0,0.00,92.35,377431.50,1,20.66,19.66,0.05
4088,0,41215184,6766,61.99,377493.50,2,41240837,25653,41215184,6766,61.97,92.34,377493.50,1,18.83,19.66,0.01
4089,0,41221854,6670,61.11,377554.62,2,41244172,22318,41221854,6670,61.09,92.33,377554.62,0,17.41,19.66,0.01
4090,0,41228396,6542,59.90,377614.50,2,41247443,19047,41228396,6542,59.92,92.33,377614.50,1,17.47,19.66,0.02
4091,0,41234318,5922,54.26,377668.78,2,41250404,16086,41234318,5922,54.24,92.32,377668.78,0,17.29,19.66,0.00
4092,0,41240832,6514,59.64,377728.41,2,41253661,12829,41240832,6514,59.66,92.31,377728.41,1,17.63,19.66,0.03
4093,0,41252962,12130,111.08,377839.50,2,41259726,6764,41252962,12130,111.10,92.31,377839.50,0,16.71,19.66,0.03
4094,0,41281650,28688,262.76,378102.25,2,41281650,0,41281650,28688,262.76,92.36,378102.25,1,16.82,19.66,0.02
4095,0,41313311,31661,290.01,378392.28,2,41313311,0,41313311,31661,289.99,92.40,378392.28,0,17.60,19.66,0.02
4096,0,41347814,34503,316.03,378708.28,2,41347814,0,41347814,34503,316.02,92.46,378708.28,1,17.88,19.66,0.02
4097,0,41380252,32438,297.08,379005.38,2,41380252,0,41380252,32438,297.10,92.51,379005.38,0,17.49,19.66,0.02
4098,0,41412716,32464,297.34,379302.72,2,41412716,0,41412716,32464,297.34,92.56,379302.72,0,17.78,19.66,0.02
4099,0,41412716,0,0.00,379302.72,2,41423414,10698,41412716,0,0.00,92.54,379302.72,1,21.20,19.00,0.05
4100,0,41412716,0,0.00,379302.72,2,41429403,16687,41412716,0,0.00,92.51,379302.72,0,21.31,19.00,0.01
4101,0,41412716,0,0.00,379302.72,2,41433934,21218,41412716,0,0.00,92.49,379302.72,1,21.31,19.00,0.03
4102,0,41412716,0,0.00,379302.72,2,41437799,25083,41412716,0,0.00,92.47,379302.72,0,21.93,19.00,0.02
4103,0,41412716,0,0.00,379302.72,2,41441100,28384,41412716,0,0.00,92.45,379302.72,1,22.22,19.00,0.04
4104,0,41412716,0,0.00,379302.72,2,41444202,31486,41412716,0,0.00,92.42,379302.72,1,20.48,19.48,0.01
4105,0,41412716,0,0.00,379302.72,2,41447221,34505,41412716,0,0.00,92.40,379302.72,0,19.58,18.58,0.00
4106,0,41412716,0,0.00,379302.72,2,41450070,37354,41412716,0,0.00,92.38,379302.72,1,19.87,18.87,0.03
4107,0,41412716,0,0.00,379302.72,2,41452758,40042,41412716,0,0.00,92.36,379302.72,0,20.02,19.02,0.03
4108,0,41412716,0,0.00,379302.72,2,41455309,42593,41412716,0,0.00,92.33,379302.72,0,20.02,19.02,0.02
4109,0,41417680,4964,45.47,379348.19,2,41457791,40111,41417680,4964,45.47,92.32,379348.19,1,18.00,19.02,0.02
4110,0,41422538,4858,44.48,379392.66,2,41460220,37682,41422538,4858,44.49,92.31,379392.66,1,18.04,19.02,0.02
4111,0,41427352,4814,44.11,379436.78,2,41462627,35275,41427352,4814,44.09,92.30,379436.78,0,17.00,19.02,0.01
4112,0,41432114,4762,43.60,379480.38,2,41465008,32894,41432114,4762,43.62,92.29,379480.38,1,17.05,19.02,0.04
4113,0,41436842,4728,43.30,379523.66,2,41467372,30530,41436842,4728,43.30,92.27,379523.66,0,16.23,19.02,0.00
4114,0,41441536,4694,43.01,379566.69,2,41469719,28183,41441536,4694,42.99,92.26,379566.69,1,17.42,19.02,0.03
4115,0,41446088,4552,41.69,379608.38,2,41471995,25907,41446088,4552,41.69,92.25,379608.38,0,16.12,19.02,0.01
4116,0,41450424,4336,39.71,379648.09,2,41474163,23739,41450424,4336,39.71,92.24,379648.09,1,16.16,19.02,0.03
4117,0,41454814,4390,40.23,379688.31,2,41476358,21544,41454814,4390,40.21,92.22,379688.31,0,14.37,19.02,0.03
4118,0,41459502,4688,42.94,379731.25,2,41478702,19200,41459502,4688,42.94,92.21,379731.25,1,14.41,19.02,0.02
4119,0,41464520,5018,45.94,379777.19,2,41481211,16691,41464520,5018,45.96,92.20,379777.19,0,13.30,19.02,0.01
4120,0,41470758,6238,57.15,379834.34,2,41484330,13572,41470758,6238,57.13,92.19,379834.34,1,14.21,19.02,0.03
4121,0,41482550,11792,108.00,379942.34,2,41490226,7676,41482550,11792,108.00,92.20,379942.34,1,12.59,19.02,0.03
4122,0,41509709,27159,248.72,380191.06,2,41509709,0,41509709,27159,248.75,92.23,380191.06,0,12.70,19.02,0.02
4123,0,41543036,33327,305.25,380496.31,2,41543036,0,41543036,33327,305.24,92.29,380496.31,0,15.02,19.02,0.05
4124,0,41575906,32870,301.04,380797.38,2,41575906,0,41575906,32870,301.06,92.34,380797.38,1,15.78,19.02,0.07
4125,0,41609476,33570,307.49,381104.84,2,41609476,0,41609476,33570,307.47,92.39,381104.84,0,15.23,19.02,0.05
4126,0,41642492,33016,302.40,381407.25,2,41642492,0,41642492,33016,302.40,92.44,381407.25,1,17.32,19.02,0.07
4127,0,41675418,32926,301.55,381708.81,2,41675418,0,41675418,32926,301.57,92.49,381708.81,0,16.61,19.02,0.06
4128,0,41708549,33131,303.46,382012.28,2,41708549,0,41708549,33131,303.45,92.54,382012.28,1,16.91,19.02,0.08
4129,0,41741269,32720,299.69,382311.94,2,41741269,0,41741269,32720,299.69,92.59,382311.94,0,16.68,19.02,0.03
4130,0,41741269,0,0.00,382311.94,2,41751941,10672,41741269,0,0.00,92.57,382311.94,1,22.19,19.00,0.05
4131,0,41741269,0,0.00,382311.94,2,41757843,16574,41741269,0,0.00,92.55,382311.94,0,23.13,19.00,0.04
4132,0,41741269,0,0.00,382311.94,2,41762271,21002,41741269,0,0.00,92.52,382311.94,1,23.13,19.00,0.07
4133,0,41741269,0,0.00,382311.94,2,41766293,25024,41741269,0,0.00,92.50,382311.94,0,22.62,19.00,0.03
4134,0,41741269,0,0.00,382311.94,2,41769984,28715,41741269,0,0.00,92.48,382311.94,1,22.62,19.00,0.06
4135,0,41741269,0,0.00,382311.94,2,41773342,32073,41741269,0,0.00,92.46,382311.94,0,21.37,19.00,0.03
4136,0,41741269,0,0.00,382311.94,2,41776459,35190,41741269,0,0.00,92.44,382311.94,1,21.37,19.00,0.06
4137,0,41741269,0,0.00,382311.94,2,41779364,38095,41741269,0,0.00,92.41,382311.94,0,20.05,19.05,0.04
4138,0,41741269,0,0.00,382311.94,2,41782100,40831,41741269,0,0.00,92.39,382311.94,0,20.05,19.05,0.06
4139,0,41741269,0,0.00,382311.94,2,41784681,43412,41741269,0,0.00,92.37,382311.94,1,20.05,19.05,0.09
4140,0,41746249,4980,45.61,382357.56,2,41787171,40922,41746249,4980,45.61,92.36,382357.56,0,18.54,19.05,0.06
4141,0,41751163,4914,45.03,382402.59,2,41789628,38465,41751163,4914,45.01,92.35,382402.59,1,18.58,19.05,0.08
4142,0,41755749,4586,41.99,382444.56,2,41791921,36172,41755749,4586,42.00,92.33,382444.56,0,17.19,19.05,0.06
4143,0,41760247,4498,41.22,382485.78,2,41794170,33923,41760247,4498,41.20,92.32,382485.78,1,17.23,19.05,0.08
4144,0,41764899,4652,42.61,382528.41,2,41796496,31597,41764899,4652,42.61,92.31,382528.41,1,15.91,19.05,0.06
4145,0,41769603,4704,43.08,382571.50,2,41798848,29245,41769603,4704,43.08,92.30,382571.50,0,14.91,19.05,0.05
4146,0,41774079,4476,41.00,382612.47,2,41801086,27007,41774079,4476,41.00,92.28,382612.47,1,14.95,19.05,0.07
4147,0,41778649,4570,41.84,382654.31,2,41803371,24722,41778649,4570,41.86,92.27,382654.31,0,13.68,19.05,0.05
4148,0,41783135,4486,41.11,382695.44,2,41805614,22479,41783135,4486,41.09,92.26,382695.44,1,14.25,19.05,0.07
4149,0,41787761,4626,42.35,382737.78,2,41807927,20166,41787761,4626,42.37,92.25,382737.78,0,13.09,19.05,0.06
4150,0,41792655,4894,44.84,382782.62,2,41810374,17719,41792655,4894,44.82,92.24,382782.62,1,13.31,19.05,0.08
4151,0,41798105,5450,49.90,382832.53,2,41813099,14994,41798105,5450,49.92,92.23,382832.53,0,12.27,19.05,0.07
4152,0,41805917,7812,71.55,382904.06,2,41817005,11088,41805917,7812,71.55,92.22,382904.06,1,12.46,19.05,0.09
4153,0,41824631,18714,171.42,383075.50,2,41826362,1731,41824631,18714,171.40,92.24,383075.50,0,11.09,19.05,0.06
4154,0,41857704,33073,302.91,383378.41,2,41857704,0,41857704,33073,302.92,92.29,383378.41,1,13.15,19.05,0.09
4155,0,41891006,33302,305.03,383683.44,2,41891006,0,41891006,33302,305.02,92.34,383683.44,0,12.12,19.05,0.07
4156,0,41924007,33001,302.25,383985.69,2,41924007,0,41924007,33001,302.26,92.39,383985.69,1,16.30,19.05,0.09
4157,0,41956502,32495,297.63,384283.31,2,41956502,0,41956502,32495,297.62,92.44,384283.31,0,17.38,19.05,0.08
4158,0,41956502,0,0.00,384283.31,2,41967029,10527,41956502,0,0.00,92.42,384283.31,0,19.19,18.19,0.10
4159,0,41956502,0,0.00,384283.31,2,41973149,16647,41956502,0,0.00,92.40,384283.31,0,21.51,19.00,0.13
4160,0,41956502,0,0.00,384283.31,2,41977863,21361,41956502,0,0.00,92.38,384283.31,1,21.51,19.00,0.15
4161,0,41956502,0,0.00,384283.31,2,41981886,25384,41956502,0,0.00,92.35,384283.31,1,20.15,19.15,0.10
4162,0,41956502,0,0.00,384283.31,2,41985280,28778,41956502,0,0.00,92.33,384283.31,0,20.43,19.43,0.09
4163,0,41956502,0,0.00,384283.31,2,41988307,31805,41956502,0,0.00,92.31,384283.31,0,20.68,19.68,0.12
4164,0,41956502,0,0.00,384283.31,2,41991305,34803,41956502,0,0.00,92.29,384283.31,1,21.00,20.00,0.14
4165,0,41962342,5840,53.49,384336.81,2,41994225,31883,41962342,5840,53.49,92.28,384336.81,1,19.58,20.00,0.11
4166,0,41968104,5762,52.76,384389.56,2,41997106,29002,41968104,5762,52.77,92.27,384389.56,0,18.87,20.00,0.10
4167,0,41973708,5604,51.33,384440.91,2,41999908,26200,41973708,5604,51.33,92.26,384440.91,1,19.74,20.00,0.12
4168,0,41979252,5544,50.78,384491.66,2,42002680,23428,41979252,5544,50.78,92.25,384491.66,0,18.98,20.00,0.12
4169,0,41984648,5396,49.42,384541.09,2,42005378,20730,41984648,5396,49.42,92.24,384541.09,1,19.03,20.00,0.14
4170,0,41990014,5366,49.17,384590.25,2,42008061,18047,41990014,5366,49.15,92.23,384590.25,1,18.09,20.00,0.12
4171,0,41995520,5506,50.41,384640.66,2,42010814,15294,41995520,5506,50.43,92.22,384640.66,0,17.29,20.00,0.12
4172,0,42001902,6382,58.47,384699.12,2,42014005,12103,42001902,6382,58.45,92.21,384699.12,1,18.35,20.00,0.14
4173,0,42013092,11190,102.47,384801.62,2,42019600,6508,42013092,11190,102.49,92.21,384801.62,0,17.99,20.00,0.13
4174,0,42035354,22262,203.88,385005.50,2,42035354,0,42035354,22262,203.90,92.24,385005.50,1,18.09,20.00,0.15
4175,0,42063301,27947,255.98,385261.47,2,42063301,0,42063301,27947,255.97,92.28,385261.47,0,18.04,20.00,0.14
4176,0,42090685,27384,250.81,385512.28,2,42090685,0,42090685,27384,250.81,92.32,385512.28,1,19.38,20.00,0.16
4177,0,42118459,27774,254.40,385766.69,2,42118459,0,42118459,27774,254.38,92.35,385766.69,0,18.79,20.00,0.16
4178,0,42146481,28022,256.64,386023.31,2,42146481,0,42146481,28022,256.66,92.39,386023.31,0,19.14,20.00,0.18
4179,0,42146481,0,0.00,386023.31,2,42156714,10233,42146481,0,0.00,92.37,386023.31,1,21.01,19.00,0.21
4180,0,42146481,0,0.00,386023.31,2,42162839,16358,42146481,0,0.00,92.35,386023.31,0,20.39,19.39,0.19
4181,0,42146481,0,0.00,386023.31,2,42167439,20958,42146481,0,0.00,92.33,386023.31,1,21.03,19.00,0.22
4182,0,42146481,0,0.00,386023.31,2,42171375,24894,42146481,0,0.00,92.31,386023.31,1,21.46,19.00,0.21
4183,0,42146481,0,0.00,386023.31,2,42174817,28336,42146481,0,0.00,92.28,386023.31,0,20.49,19.49,0.20
4184,0,42146481,0,0.00,386023.31,2,42177753,31272,42146481,0,0.00,92.26,386023.31,1,20.49,19.49,0.22
4185,0,42146481,0,0.00,386023.31,2,42180492,34011,42146481,0,0.00,92.24,386023.31,0,19.64,18.64,0.22
4186,0,42146481,0,0.00,386023.31,2,42183248,36767,42146481,0,0.00,92.22,386023.31,1,20.28,19.28,0.24
4187,0,42151733,5252,48.10,386071.44,2,42185874,34141,42151733,5252,48.10,92.21,386071.44,1,18.94,19.28,0.22
4188,0,42157033,5300,48.54,386119.97,2,42188524,31491,42157033,5300,48.54,92.20,386119.97,0,19.10,19.28,0.21
4189,0,42157033,0,0.00,386119.97,2,42191046,34013,42157033,0,0.00,92.17,386119.97,0,19.48,18.48,0.24
4190,0,42157033,0,0.00,386119.97,2,42193404,36371,42157033,0,0.00,92.15,386119.97,1,19.48,18.48,0.26
4191,0,42161563,4530,41.51,386161.47,2,42195669,34106,42161563,4530,41.49,92.14,386161.47,0,17.73,18.48,0.23
4192,0,42166129,4566,41.80,386203.28,2,42197952,31823,42166129,4566,41.82,92.13,386203.28,1,17.77,18.48,0.25
4193,0,42170693,4564,41.80,386245.09,2,42200234,29541,42170693,4564,41.80,92.12,386245.09,0,17.54,18.48,0.24
4194,0,42175229,4536,41.55,386286.62,2,42202502,27273,42175229,4536,41.55,92.10,386286.62,1,17.88,18.48,0.27
4195,0,42179743,4514,41.36,386328.00,2,42204759,25016,42179743,4514,41.34,92.09,386328.00,0,16.71,18.48,0.23
4196,0,42184249,4506,41.25,386369.25,2,42207012,22763,42184249,4506,41.27,92.08,386369.25,1,17.05,18.48,0.26
4197,0,42188585,4336,39.71,386408.97,2,42209180,20595,42188585,4336,39.71,92.07,386408.97,0,16.29,18.48,0.25
4198,0,42193019,4434,40.63,386449.59,2,42211397,18378,42193019,4434,40.61,92.06,386449.59,0,16.45,18.48,0.28
4199,0,42198207,5188,47.52,386497.09,2,42213991,15784,42198207,5188,47.52,92.05,386497.09,1,17.51,18.48,0.30
4200,0,42205703,7496,68.66,386565.75,2,42217739,12036,42205703,7496,68.66,92.04,386565.75,0,16.22,18.48,0.28
4201,0,42221893,16190,148.27,386714.03,2,42225834,3941,42221893,16190,148.29,92.05,386714.03,1,16.29,18.48,0.30
4202,0,42252370,30477,279.13,386993.16,2,42252370,0,42252370,30477,279.14,92.10,386993.16,0,15.98,18.48,0.29
4203,0,42284085,31715,290.49,387283.66,2,42284085,0,42284085,31715,290.48,92.14,387283.66,1,18.48,18.48,0.32
4204,0,42284085,0,0.00,387283.66,2,42294896,10811,42284085,0,0.00,92.12,387283.66,1,19.08,18.08,0.31
4205,0,42284085,0,0.00,387283.66,2,42301049,16964,42284085,0,0.00,92.10,387283.66,0,18.43,17.43,0.31
4206,0,42284085,0,0.00,387283.66,2,42305614,21529,42284085,0,0.00,92.08,387283.66,1,18.43,17.43,0.33
4207,0,42284085,0,0.00,387283.66,2,42309384,25299,42284085,0,0.00,92.06,387283.66,0,18.07,17.07,0.32
4208,0,42284085,0,0.00,387283.66,2,42313034,28949,42284085,0,0.00,92.04,387283.66,1,18.07,17.07,0.35
4209,0,42284085,0,0.00,387283.66,2,42316351,32266,42284085,0,0.00,92.01,387283.66,0,17.08,16.08,0.34
4210,0,42284085,0,0.00,387283.66,2,42319433,35348,42284085,0,0.00,91.99,387283.66,1,17.08,16.08,0.36
4211,0,42284085,0,0.00,387283.66,2,42322235,38150,42284085,0,0.00,91.97,387283.66,1,16.31,15.31,0.34
4212,0,42284085,0,0.00,387283.66,2,42324891,40806,42284085,0,0.00,91.95,387283.66,0,16.82,15.82,0.33
4213,0,42284085,0,0.00,387283.66,2,42327387,43302,42284085,0,0.00,91.93,387283.66,0,16.82,15.82,0.36
4214,0,42284085,0,0.00,387283.66,2,42329693,45608,42284085,0,0.00,91.90,387283.66,1,16.82,15.82,0.38
4215,0,42288571,4486,41.11,387324.75,2,42331936,43365,42288571,4486,41.09,91.89,387324.75,0,15.18,15.82,0.35
4216,0,42293105,4534,41.51,387366.28,2,42334203,41098,42293105,4534,41.53,91.88,387366.28,1,15.22,15.82,0.37
4217,0,42297449,4344,39.79,387406.06,2,42336375,38926,42297449,4344,39.79,91.87,387406.06,0,14.38,15.82,0.37
4218,0,42301611,4162,38.14,387444.19,2,42338456,36845,42301611,4162,38.12,91.85,387444.19,1,15.57,15.82,0.39
4219,0,42305831,4220,38.65,387482.84,2,42340566,34735,42305831,4220,38.65,91.84,387482.84,0,15.05,15.82,0.37
4220,0,42310217,4386,40.15,387523.00,2,42342759,32542,42310217,4386,40.17,91.83,387523.00,1,15.08,15.82,0.39
4221,0,42314667,4450,40.78,387563.78,2,42344984,30317,42314667,4450,40.76,91.82,387563.78,1,14.40,15.82,0.39
4222,0,42319157,4490,41.11,387604.88,2,42347229,28072,42319157,4490,41.12,91.81,387604.88,0,13.31,15.82,0.37
4223,0,42323589,4432,40.59,387645.47,2,42349445,25856,42323589,4432,40.59,91.79,387645.47,0,13.69,15.82,0.39
4224,0,42327985,4396,40.26,387685.75,2,42351643,23658,42327985,4396,40.26,91.78,387685.75,1,14.17,15.82,0.42
4225,0,42332433,4448,40.74,387726.47,2,42353867,21434,42332433,4448,40.74,91.77,387726.47,0,13.16,15.82,0.39
4226,0,42337151,4718,43.23,387769.72,2,42356226,19075,42337151,4718,43.21,91.76,387769.72,1,13.72,15.82,0.42
4227,0,42341985,4834,44.26,387813.97,2,42358643,16658,42341985,4834,44.28,91.75,387813.97,0,12.64,15.82,0.40
4228,0,42347749,5764,52.79,387866.75,2,42361525,13776,42347749,5764,52.79,91.74,387866.75,1,12.79,15.82,0.42
4229,0,42358597,10848,99.36,387966.12,2,42366949,8352,42358597,10848,99.36,91.74,387966.12,0,11.64,15.82,0.41
4230,0,42381291,22694,207.87,388174.00,2,42381291,0,42381291,22694,207.86,91.77,388174.00,1,11.96,15.82,0.43
4231,0,42414334,33043,302.65,388476.66,2,42414334,0,42414334,33043,302.64,91.82,388476.66,0,13.11,15.82,0.41
4232,0,42446636,32302,295.84,388772.47,2,42446636,0,42446636,32302,295.86,91.86,388772.47,1,14.65,15.82,0.43
4233,0,42478750,32114,294.15,389066.62,2,42478750,0,42478750,32114,294.13,91.91,389066.62,0,13.67,15.82,0.41
4234,0,42511376,32626,298.81,389365.44,2,42511376,0,42511376,32626,298.82,91.96,389365.44,1,14.12,15.82,0.44
4235,0,42543957,32581,298.40,389663.84,2,42543957,0,42543957,32581,298.41,92.01,389663.84,0,14.95,15.82,0.42
4236,0,42543957,0,0.00,389663.84,2,42554570,10613,42543957,0,0.00,91.99,389663.84,1,17.10,16.10,0.44
4237,0,42563997,20040,183.55,389847.41,2,42564590,593,42563997,20040,183.55,92.01,389847.41,0,15.80,16.10,0.42
4238,0,42563997,0,0.00,389847.41,2,42574535,10538,42563997,0,0.00,91.99,389847.41,0,18.48,17.48,0.44
4239,0,42563997,0,0.00,389847.41,2,42579782,15785,42563997,0,0.00,91.97,389847.41,1,19.64,18.64,0.47
4240,0,42563997,0,0.00,389847.41,2,42583314,19317,42563997,0,0.00,91.95,389847.41,0,18.93,17.93,0.45
4241,0,42563997,0,0.00,389847.41,2,42586341,22344,42563997,0,0.00,91.92,389847.41,1,18.93,17.93,0.47
4242,0,42570159,6162,56.46,389903.84,2,42589422,19263,42570159,6162,56.44,91.92,389903.84,0,17.67,17.93,0.46
4243,0,42576969,6810,62.36,389966.19,2,42592827,15858,42576969,6810,62.37,91.91,389966.19,1,17.73,17.93,0.48
4244,0,42584833,7864,72.03,390038.22,2,42596759,11926,42584833,7864,72.03,91.90,390038.22,0,16.90,17.93,0.47
4245,0,42601119,16286,149.18,390187.41,2,42604902,3783,42601119,16286,149.16,91.92,390187.41,1,16.97,17.93,0.49
4246,0,42632774,31655,289.94,390477.34,2,42632774,0,42632774,31655,289.93,91.96,390477.34,0,16.33,17.93,0.49
4247,0,42664204,31430,287.85,390765.22,2,42664204,0,42664204,31430,287.87,92.01,390765.22,1,17.39,17.93,0.51
4248,0,42696278,32074,293.79,391059.00,2,42696278,0,42696278,32074,293.77,92.06,391059.00,1,17.51,17.93,0.50
4249,0,42696278,0,0.00,391059.00,2,42706566,10288,42696278,0,0.00,92.04,391059.00,0,18.77,17.77,0.49
4250,0,42696278,0,0.00,391059.00,2,42712350,16072,42696278,0,0.00,92.01,391059.00,1,18.97,17.97,0.51
4251,0,42696278,0,0.00,391059.00,2,42716936,20658,42696278,0,0.00,91.99,391059.00,0,19.80,18.80,0.50
4252,0,42696278,0,0.00,391059.00,2,42720807,24529,42696278,0,0.00,91.97,391059.00,1,19.88,18.88,0.53
4253,0,42703218,6940,63.53,391122.53,2,42724277,21059,42703218,6940,63.56,91.96,391122.53,0,18.85,18.88,0.52
4254,0,42703218,0,0.00,391122.53,2,42727672,24454,42703218,0,0.00,91.94,391122.53,1,18.91,17.91,0.54
4255,0,42703218,0,0.00,391122.53,2,42730790,27572,42703218,0,0.00,91.92,391122.53,0,18.73,17.73,0.53
4256,0,42703218,0,0.00,391122.53,2,42733647,30429,42703218,0,0.00,91.90,391122.53,1,19.58,18.58,0.56
4257,0,42703218,0,0.00,391122.53,2,42736299,33081,42703218,0,0.00,91.88,391122.53,0,18.64,17.64,0.55
4258,0,42703218,0,0.00,391122.53,2,42738815,35597,42703218,0,0.00,91.86,391122.53,1,18.64,17.64,0.57
4259,0,42703218,0,0.00,391122.53,2,42741211,37993,42703218,0,0.00,91.83,391122.53,0,17.65,16.65,0.56
4260,0,42703218,0,0.00,391122.53,2,42743504,40286,42703218,0,0.00,91.81,391122.53,1,17.65,16.65,0.59
4261,0,42703218,0,0.00,391122.53,2,42745706,42488,42703218,0,0.00,91.79,391122.53,1,17.57,16.57,0.58
4262,0,42703218,0,0.00,391122.53,2,42747833,44615,42703218,0,0.00,91.77,391122.53,0,18.03,17.03,0.57
4263,0,42703218,0,0.00,391122.53,2,42749883,46665,42703218,0,0.00,91.75,391122.53,0,18.03,17.03,0.59
4264,0,42703218,0,0.00,391122.53,2,42751844,48626,42703218,0,0.00,91.73,391122.53,1,18.03,17.03,0.61
4265,0,42706818,3600,32.97,391155.50,2,42753644,46826,42706818,3600,32.97,91.71,391155.50,0,16.68,17.03,0.59
4266,0,42710236,3418,31.32,391186.81,2,42755353,45117,42710236,3418,31.31,91.70,391186.81,1,16.71,17.03,0.62
4267,0,42713974,3738,34.25,391221.06,2,42757222,43248,42713974,3738,34.24,91.69,391221.06,0,15.55,17.03,0.60
4268,0,42717798,3824,35.02,391256.09,2,42759134,41336,42717798,3824,35.02,91.67,391256.09,1,15.59,17.03,0.62
4269,0,42721624,3826,35.02,391291.12,2,42761047,39423,42721624,3826,35.04,91.66,391291.12,0,14.96,17.03,0.61
4270,0,42725424,3800,34.80,391325.94,2,42762947,37523,42725424,3800,34.80,91.65,391325.94,1,16.15,17.03,0.63
4271,0,42729386,3962,36.27,391362.19,2,42764928,35542,42729386,3962,36.29,91.63,391362.19,1,14.45,17.03,0.60
4272,0,42733388,4002,36.67,391398.88,2,42766929,33541,42733388,4002,36.65,91.62,391398.88,0,13.75,17.03,0.60
4273,0,42737390,4002,36.67,391435.53,2,42768930,31540,42737390,4002,36.65,91.61,391435.53,1,13.79,17.03,0.62
4274,0,42741356,3966,36.31,391471.84,2,42770913,29557,42741356,3966,36.32,91.59,391471.84,0,12.54,17.03,0.60
4275,0,42745302,3946,36.16,391508.00,2,42772886,27584,42745302,3946,36.14,91.58,391508.00,1,12.58,17.03,0.62
4276,0,42749222,3920,35.90,391543.91,2,42774846,25624,42749222,3920,35.90,91.57,391543.91,0,11.66,17.03,0.62
4277,0,42753136,3914,35.83,391579.75,2,42776803,23667,42753136,3914,35.85,91.55,391579.75,0,12.26,17.03,0.64
4278,0,42757208,4072,37.30,391617.03,2,42778839,21631,42757208,4072,37.30,91.54,391617.03,1,13.43,17.03,0.66
4279,0,42761516,4308,39.46,391656.50,2,42780993,19477,42761516,4308,39.46,91.53,391656.50,0,11.61,17.03,0.63
4280,0,42766234,4718,43.19,391699.69,2,42783352,17118,42766234,4718,43.21,91.52,391699.69,1,11.65,17.03,0.65
4281,0,42771314,5080,46.53,391746.22,2,42785892,14578,42771314,5080,46.53,91.51,391746.22,0,10.22,17.03,0.62
4282,0,42780228,8914,81.66,391827.88,2,42790349,10121,42780228,8914,81.64,91.51,391827.88,1,10.26,17.03,0.65
4283,0,42798740,18512,169.55,391997.44,2,42799605,865,42798740,18512,169.55,91.52,391997.44,0,9.73,17.03,0.62
4284,0,42829776,31036,284.26,392281.69,2,42829776,0,42829776,31036,284.26,91.57,392281.69,1,10.81,17.03,0.65
4285,0,42860349,30573,280.01,392561.72,2,42860349,0,42860349,30573,280.02,91.61,392561.72,0,11.34,17.03,0.62
4286,0,42893280,32931,301.63,392863.34,2,42893280,0,42893280,32931,301.62,91.66,392863.34,1,12.81,17.03,0.65
4287,0,42924390,31110,284.96,393148.28,2,42924390,0,42924390,31110,284.94,91.71,393148.28,0,11.94,17.03,0.60
4288,0,42955355,30965,283.60,393431.91,2,42955355,0,42955355,30965,283.61,91.75,393431.91,1,13.11,17.03,0.62
4289,0,42988081,32726,299.72,393731.62,2,42988081,0,42988081,32726,299.74,91.80,393731.62,0,11.87,17.03,0.59
4290,0,43019078,30997,283.93,394015.53,2,43019078,0,43019078,30997,283.90,91.85,394015.53,0,15.60,17.03,0.61
4291,0,43019078,0,0.00,394015.53,2,43029520,10442,43019078,0,0.00,91.82,394015.53,1,18.56,17.56,0.64
4292,0,43040980,21902,200.58,394216.12,2,43040980,0,43040980,21902,200.60,91.85,394216.12,0,16.75,17.56,0.59
4293,0,43073104,32124,294.23,394510.34,2,43073104,0,43073104,32124,294.23,91.90,394510.34,1,16.95,17.56,0.61
4294,0,43105039,31935,292.50,394802.88,2,43105039,0,43105039,31935,292.50,91.94,394802.88,0,16.19,17.56,0.57
4295,0,43136984,31945,292.58,395095.44,2,43136984,0,43136984,31945,292.59,91.99,395095.44,1,16.52,17.56,0.60
4296,0,43169066,32082,293.82,395389.25,2,43169066,0,43169066,32082,293.84,92.04,395389.25,0,16.19,17.56,0.57
4297,0,43169066,0,0.00,395389.25,2,43179468,10402,43169066,0,0.00,92.02,395389.25,1,18.07,17.07,0.59
4298,0,43169066,0,0.00,395389.25,2,43185253,16187,43169066,0,0.00,91.99,395389.25,0,17.88,16.88,0.56
4299,0,43169066,0,0.00,395389.25,2,43189731,20665,43169066,0,0.00,91.97,395389.25,0,18.32,17.32,0.58
4300,0,43169066,0,0.00,395389.25,2,43193777,24711,43169066,0,0.00,91.95,395389.25,1,18.32,17.32,0.61
4301,0,43169066,0,0.00,395389.25,2,43197432,28366,43169066,0,0.00,91.93,395389.25,0,18.21,17.21,0.58
4302,0,43169066,0,0.00,395389.25,2,43200604,31538,43169066,0,0.00,91.91,395389.25,1,18.40,17.40,0.61
4303,0,43174966,5900,54.08,395443.34,2,43203554,28588,43174966,5900,54.04,91.90,395443.34,0,17.00,17.40,0.58
4304,0,43180938,5972,54.66,395498.00,2,43206540,25602,43180938,5972,54.70,91.89,395498.00,1,17.06,17.40,0.61
4305,0,43186940,6002,54.99,395553.00,2,43209541,22601,43186940,6002,54.97,91.88,395553.00,0,15.74,17.40,0.59
4306,0,43192856,5916,54.19,395607.19,2,43212499,19643,43192856,5916,54.19,91.87,395607.19,1,16.37,17.40,0.61
4307,0,43198664,5808,53.20,395660.38,2,43215403,16739,43198664,5808,53.20,91.86,395660.38,1,16.21,17.40,0.60
4308,0,43204648,5984,54.81,395715.19,2,43218395,13747,43204648,5984,54.81,91.86,395715.19,0,15.23,17.40,0.59
4309,0,43213260,8612,78.88,395794.06,2,43222701,9441,43213260,8612,78.88,91.85,395794.06,1,15.29,17.40,0.61
4310,0,43234740,21480,196.74,395990.78,2,43234740,0,43234740,21480,196.74,91.88,395990.78,1,13.96,17.40,0.59
4311,0,43265288,30548,279.79,396270.59,2,43265288,0,43265288,30548,279.79,91.92,396270.59,0,15.84,17.40,0.58
4312,0,43265288,0,0.00,396270.59,2,43275689,10401,43265288,0,0.00,91.90,396270.59,0,18.75,17.75,0.61
4313,0,43265288,0,0.00,396270.59,2,43281486,16198,43265288,0,0.00,91.88,396270.59,1,18.75,17.75,0.63
4314,0,43265288,0,0.00,396270.59,2,43286128,20840,43265288,0,0.00,91.86,396270.59,1,19.05,18.05,0.62
4315,0,43265288,0,0.00,396270.59,2,43290128,24840,43265288,0,0.00,91.84,396270.59,0,18.81,17.81,0.60
4316,0,43265288,0,0.00,396270.59,2,43293737,28449,43265288,0,0.00,91.81,396270.59,1,19.86,18.86,0.63
4317,0,43265288,0,0.00,396270.59,2,43296873,31585,43265288,0,0.00,91.79,396270.59,0,19.56,18.56,0.62
4318,0,43265288,0,0.00,396270.59,2,43299663,34375,43265288,0,0.00,91.77,396270.59,0,19.56,18.56,0.64
4319,0,43265288,0,0.00,396270.59,2,43302391,37103,43265288,0,0.00,91.75,396270.59,1,19.66,18.66,0.66
4320,0,43270802,5514,50.48,396321.06,2,43305148,34346,43270802,5514,50.50,91.74,396321.06,0,18.52,18.66,0.65
4321,0,43276232,5430,49.75,396370.81,2,43307863,31631,43276232,5430,49.73,91.73,396370.81,1,18.57,18.66,0.67
4322,0,43276232,0,0.00,396370.81,2,43310447,34215,43276232,0,0.00,91.71,396370.81,1,19.08,18.08,0.66
4323,0,43281102,4870,44.62,396415.44,2,43312882,31780,43281102,4870,44.60,91.70,396415.44,0,17.96,18.08,0.64
4324,0,43281102,0,0.00,396415.44,2,43315228,34126,43281102,0,0.00,91.68,396415.44,1,18.26,17.26,0.67
4325,0,43281102,0,0.00,396415.44,2,43317424,36322,43281102,0,0.00,91.66,396415.44,1,17.48,16.48,0.66
4326,0,43281102,0,0.00,396415.44,2,43319484,38382,43281102,0,0.00,91.64,396415.44,0,16.58,15.58,0.66
4327,0,43281102,0,0.00,396415.44,2,43321469,40367,43281102,0,0.00,91.61,396415.44,1,16.58,15.58,0.68
4328,0,43281102,0,0.00,396415.44,2,43323393,42291,43281102,0,0.00,91.59,396415.44,0,15.98,14.98,0.68
4329,0,43281102,0,0.00,396415.44,2,43325259,44157,43281102,0,0.00,91.57,396415.44,1,15.98,14.98,0.71
4330,0,43284724,3622,33.16,396448.59,2,43327070,42346,43284724,3622,33.17,91.56,396448.59,0,14.72,14.98,0.69
4331,0,43288100,3376,30.92,396479.53,2,43328758,40658,43288100,3376,30.92,91.54,396479.53,1,14.76,14.98,0.71
4332,0,43291476,3376,30.92,396510.44,2,43330446,38970,43291476,3376,30.92,91.53,396510.44,0,13.59,14.98,0.70
4333,0,43294796,3320,30.41,396540.84,2,43332106,37310,43294796,3320,30.41,91.52,396540.84,0,13.62,14.98,0.72
4334,0,43298248,3452,31.62,396572.47,2,43333832,35584,43298248,3452,31.62,91.50,396572.47,1,13.94,14.98,0.74
4335,0,43301702,3454,31.65,396604.12,2,43335559,33857,43301702,3454,31.64,91.49,396604.12,1,13.02,14.98,0.70
4336,0,43305278,3576,32.75,396636.88,2,43337347,32069,43305278,3576,32.75,91.48,396636.88,0,11.89,14.98,0.67
4337,0,43308900,3622,33.16,396670.03,2,43339158,30258,43308900,3622,33.17,91.46,396670.03,0,11.93,14.98,0.70
4338,0,43312636,3736,34.22,396704.25,2,43341026,28390,43312636,3736,34.22,91.45,396704.25,0,12.25,14.98,0.72
4339,0,43316550,3914,35.87,396740.12,2,43342983,26433,43316550,3914,35.85,91.44,396740.12,1,12.28,14.98,0.74
4340,0,43320648,4098,37.52,396777.62,2,43345032,24384,43320648,4098,37.53,91.42,396777.62,0,10.30,14.98,0.70
4341,0,43324712,4064,37.22,396814.84,2,43347064,22352,43324712,4064,37.22,91.41,396814.84,1,10.34,14.98,0.72
4342,0,43328954,4242,38.83,396853.69,2,43349185,20231,43328954,4242,38.85,91.40,396853.69,1,9.38,14.98,0.71
4343,0,43333538,4584,41.99,396895.69,2,43351477,17939,43333538,4584,41.99,91.39,396895.69,1,8.79,14.98,0.70
4344,0,43339282,5744,52.61,396948.28,2,43354349,15067,43339282,5744,52.61,91.38,396948.28,0,8.88,14.98,0.69
4345,0,43348634,9352,85.66,397033.94,2,43359025,10391,43348634,9352,85.66,91.38,397033.94,0,9.22,14.98,0.71
4346,0,43366286,17652,161.71,397195.66,2,43367851,1565,43366286,17652,161.68,91.39,397195.66,1,9.30,14.98,0.73
4347,0,43399294,33008,302.32,397497.97,2,43399294,0,43399294,33008,302.32,91.44,397497.97,0,9.57,14.98,0.70
4348,0,43429644,30350,277.96,397775.94,2,43429644,0,43429644,30350,277.98,91.48,397775.94,1,12.02,14.98,0.73
4349,0,43459809,30165,276.27,398052.22,2,43459809,0,43459809,30165,276.28,91.53,398052.22,0,12.88,14.98,0.70
4350,0,43489885,30076,275.47,398327.69,2,43489885,0,43489885,30076,275.47,91.57,398327.69,1,13.79,14.98,0.73
4351,0,43522043,32158,294.56,398622.25,2,43522043,0,43522043,32158,294.54,91.62,398622.25,0,12.46,14.98,0.70
4352,0,43554761,32718,299.65,398921.88,2,43554761,0,43554761,32718,299.67,91.66,398921.88,1,14.04,14.98,0.72
4353,0,43586709,31948,292.61,399214.50,2,43586709,0,43586709,31948,292.61,91.71,399214.50,0,13.97,14.98,0.67
4354,0,43586709,0,0.00,399214.50,2,43597109,10400,43586709,0,0.00,91.69,399214.50,1,16.26,15.26,0.69
4355,0,43606337,19628,179.77,399394.28,2,43606923,586,43606337,19628,179.77,91.71,399394.28,0,14.88,15.26,0.67
4356,0,43606337,0,0.00,399394.28,2,43617497,11160,43606337,0,0.00,91.69,399394.28,1,16.01,15.01,0.69
4357,0,43624347,18010,164.97,399559.25,2,43626502,2155,43624347,18010,164.96,91.71,399559.25,0,14.05,15.01,0.65
4358,0,43658269,33922,310.68,399869.94,2,43658269,0,43658269,33922,310.69,91.76,399869.94,0,14.40,15.01,0.67
4359,0,43658269,0,0.00,399869.94,2,43668706,10437,43658269,0,0.00,91.73,399869.94,1,15.54,14.54,0.70
4360,0,43679229,20960,191.97,400061.91,2,43679229,0,43679229,20960,191.97,91.76,400061.91,0,13.80,14.54,0.66
4361,0,43710078,30849,282.58,400344.47,2,43710078,0,43710078,30849,282.55,91.80,400344.47,1,14.32,14.54,0.68
4362,0,43710078,0,0.00,400344.47,2,43720357,10279,43710078,0,0.00,91.78,400344.47,0,14.88,13.88,0.65
4363,0,43710078,0,0.00,400344.47,2,43726252,16174,43710078,0,0.00,91.76,400344.47,1,15.95,14.95,0.68
4364,0,43710078,0,0.00,400344.47,2,43730869,20791,43710078,0,0.00,91.74,400344.47,0,15.48,14.48,0.64
4365,0,43710078,0,0.00,400344.47,2,43734925,24847,43710078,0,0.00,91.72,400344.47,1,15.82,14.82,0.66
4366,0,43710078,0,0.00,400344.47,2,43738512,28434,43710078,0,0.00,91.70,400344.47,0,15.24,14.24,0.65
4367,0,43710078,0,0.00,400344.47,2,43741773,31695,43710078,0,0.00,91.67,400344.47,1,15.51,14.51,0.67
4368,0,43710078,0,0.00,400344.47,2,43744646,34568,43710078,0,0.00,91.65,400344.47,1,14.86,13.86,0.65
4369,0,43710078,0,0.00,400344.47,2,43747261,37183,43710078,0,0.00,91.63,400344.47,0,14.14,13.14,0.64
4370,0,43710078,0,0.00,400344.47,2,43749845,39767,43710078,0,0.00,91.61,400344.47,1,14.59,13.59,0.66
4371,0,43710078,0,0.00,400344.47,2,43752344,42266,43710078,0,0.00,91.59,400344.47,0,13.93,12.93,0.65
4372,0,43710078,0,0.00,400344.47,2,43754746,44668,43710078,0,0.00,91.57,400344.47,1,14.30,13.30,0.68
4373,0,43710078,0,0.00,400344.47,2,43757020,46942,43710078,0,0.00,91.55,400344.47,0,13.34,12.34,0.66
4374,0,43710078,0,0.00,400344.47,2,43759199,49121,43710078,0,0.00,91.53,400344.47,1,13.34,12.34,0.69
4375,0,43714342,4264,39.05,400383.53,2,43761331,46989,43714342,4264,39.05,91.52,400383.53,1,11.90,12.34,0.66
4376,0,43718610,4268,39.05,400422.59,2,43763465,44855,43718610,4268,39.09,91.50,400422.59,0,10.89,12.34,0.65
4377,0,43722772,4162,38.14,400460.72,2,43765546,42774,43722772,4162,38.12,91.49,400460.72,0,11.50,12.34,0.67
4378,0,43726974,4202,38.50,400499.22,2,43767647,40673,43726974,4202,38.49,91.48,400499.22,1,12.11,12.34,0.70
4379,0,43731132,4158,38.07,400537.28,2,43769726,38594,43731132,4158,38.08,91.47,400537.28,1,11.26,12.34,0.67
4380,0,43735280,4148,37.99,400575.28,2,43771800,36520,43735280,4148,37.99,91.46,400575.28,0,10.68,12.34,0.68
4381,0,43739420,4140,37.92,400613.19,2,43773870,34450,43739420,4140,37.92,91.44,400613.19,1,11.00,12.34,0.70
4382,0,43743474,4054,37.11,400650.31,2,43775897,32423,43743474,4054,37.13,91.43,400650.31,0,9.95,12.34,0.69
4383,0,43747402,3928,35.98,400686.28,2,43777861,30459,43747402,3928,35.98,91.42,400686.28,1,9.99,12.34,0.71
4384,0,43751234,3832,35.10,400721.38,2,43779777,28543,43751234,3832,35.10,91.41,400721.38,0,9.38,12.34,0.71
4385,0,43755246,4012,36.78,400758.19,2,43781783,26537,43755246,4012,36.75,91.39,400758.19,1,9.99,12.34,0.73
4386,0,43759356,4110,37.63,400795.81,2,43783838,24482,43759356,4110,37.64,91.38,400795.81,0,9.39,12.34,0.74
4387,0,43763590,4234,38.80,400834.59,2,43785955,22365,43763590,4234,38.78,91.37,400834.59,0,10.65,12.34,0.76
4388,0,43768152,4562,41.77,400876.38,2,43788236,20084,43768152,4562,41.78,91.36,400876.38,1,10.69,12.34,0.78
4389,0,43773062,4910,44.99,400921.34,2,43790691,17629,43773062,4910,44.97,91.35,400921.34,0,9.87,12.34,0.77
4390,0,43778858,5796,53.05,400974.41,2,43793589,14731,43778858,5796,53.09,91.34,400974.41,1,9.91,12.34,0.79
4391,0,43788570,9712,88.95,401063.34,2,43798445,9875,43788570,9712,88.95,91.34,401063.34,0,8.81,12.34,0.78
4392,0,43810516,21946,201.02,401264.38,2,43810516,0,43810516,21946,201.01,91.36,401264.38,1,10.04,12.34,0.80
4393,0,43843633,33117,303.31,401567.69,2,43843633,0,43843633,33117,303.32,91.41,401567.69,0,10.35,12.34,0.80
4394,0,43843633,0,0.00,401567.69,2,43854416,10783,43843633,0,0.00,91.39,401567.69,1,12.91,11.91,0.82
4395,0,43843633,0,0.00,401567.69,2,43860509,16876,43843633,0,0.00,91.37,401567.69,0,13.22,12.22,0.80
4396,0,43843633,0,0.00,401567.69,2,43865237,21604,43843633,0,0.00,91.35,401567.69,1,13.91,12.91,0.82
4397,0,43843633,0,0.00,401567.69,2,43869336,25703,43843633,0,0.00,91.33,401567.69,0,13.17,12.17,0.82
4398,0,43843633,0,0.00,401567.69,2,43872803,29170,43843633,0,0.00,91.31,401567.69,1,13.17,12.17,0.84
4399,0,43843633,0,0.00,401567.69,2,43875892,32259,43843633,0,0.00,91.29,401567.69,0,12.69,11.69,0.82
4400,0,43843633,0,0.00,401567.69,2,43878992,35359,43843633,0,0.00,91.27,401567.69,1,12.69,11.69,0.84
4401,0,43843633,0,0.00,401567.69,2,43881880,38247,43843633,0,0.00,91.24,401567.69,0,11.69,10.69,0.83
4402,0,43843633,0,0.00,401567.69,2,43884653,41020,43843633,0,0.00,91.22,401567.69,1,11.69,10.69,0.86
4403,0,43848915,5282,48.40,401616.09,2,43887294,38379,43848915,5282,48.38,91.21,401616.09,0,10.63,10.69,0.84
4404,0,43854085,5170,47.33,401663.41,2,43889879,35794,43854085,5170,47.35,91.20,401663.41,1,10.67,10.69,0.87
4405,0,43859217,5132,47.00,401710.44,2,43892445,33228,43859217,5132,47.00,91.19,401710.44,0,9.67,10.69,0.86
4406,0,43864269,5052,46.27,401756.69,2,43894971,30702,43864269,5052,46.27,91.18,401756.69,1,9.72,10.69,0.88
4407,0,43869247,4978,45.61,401802.31,2,43897460,28213,43869247,4978,45.59,91.17,401802.31,1,9.01,10.69,0.87
4408,0,43874153,4906,44.92,401847.22,2,43899913,25760,43874153,4906,44.93,91.16,401847.22,0,9.15,10.69,0.87
4409,0,43879011,4858,44.51,401891.75,2,43902342,23331,43879011,4858,44.49,91.15,401891.75,1,10.05,10.69,0.89
4410,0,43883589,4578,41.91,401933.66,2,43904631,21042,43883589,4578,41.93,91.14,401933.66,0,9.51,10.69,0.90
4411,0,43888123,4534,41.55,401975.19,2,43906898,18775,43888123,4534,41.53,91.13,401975.19,1,9.55,10.69,0.92
4412,0,43893009,4886,44.73,402019.94,2,43909341,16332,43893009,4886,44.75,91.12,402019.94,0,9.07,10.69,0.93
4413,0,43899029,6020,55.14,402075.06,2,43912351,13322,43899029,6020,55.14,91.11,402075.06,0,9.11,10.69,0.95
4414,0,43910529,11500,105.33,402180.41,2,43918101,7572,43910529,11500,105.33,91.11,402180.41,1,9.16,10.69,0.97
4415,0,43935030,24501,224.43,402404.84,2,43935030,0,43935030,24501,224.41,91.14,402404.84,0,8.19,10.69,0.96
4416,0,43965916,30886,282.87,402687.69,2,43965916,0,43965916,30886,282.89,91.19,402687.69,1,10.58,10.69,0.98
4417,0,43965916,0,0.00,402687.69,2,43976508,10592,43965916,0,0.00,91.17,402687.69,0,11.68,10.68,0.97
4418,0,43965916,0,0.00,402687.69,2,43982576,16660,43965916,0,0.00,91.15,402687.69,1,12.63,11.63,0.99
4419,0,43965916,0,0.00,402687.69,2,43987275,21359,43965916,0,0.00,91.13,402687.69,0,11.84,10.84,0.99
4420,0,43965916,0,0.00,402687.69,2,43991350,25434,43965916,0,0.00,91.11,402687.69,1,11.84,10.84,1.01
4421,0,43973452,7536,69.02,402756.72,2,43995118,21666,43973452,7536,69.02,91.10,402756.72,0,10.52,10.84,0.99
4422,0,43980844,7392,67.70,402824.44,2,43998814,17970,43980844,7392,67.70,91.10,402824.44,1,10.58,10.84,1.01
4423,0,43987668,6824,62.50,402886.94,2,44002226,14558,43987668,6824,62.50,91.09,402886.94,0,9.48,10.84,1.00
4424,0,43995060,7392,67.70,402954.62,2,44005922,10862,43995060,7392,67.70,91.08,402954.62,1,9.54,10.84,1.02
4425,0,44013732,18672,171.02,403125.66,2,44015258,1526,44013732,18672,171.02,91.10,403125.66,0,8.15,10.84,1.00
4426,0,44045283,31551,288.99,403414.62,2,44045283,0,44045283,31551,288.98,91.15,403414.62,1,8.31,10.84,1.02
4427,0,44076281,30998,283.90,403698.53,2,44076281,0,44076281,30998,283.91,91.19,403698.53,0,8.68,10.84,1.00
4428,0,44107016,30735,281.51,403980.06,2,44107016,0,44107016,30735,281.50,91.23,403980.06,1,10.74,10.84,1.03
4429,0,44107016,0,0.00,403980.06,2,44117717,10701,44107016,0,0.00,91.21,403980.06,1,11.44,10.44,1.00
4430,0,44107016,0,0.00,403980.06,2,44123458,16442,44107016,0,0.00,91.19,403980.06,0,10.82,9.82,0.98
4431,0,44107016,0,0.00,403980.06,2,44127773,20757,44107016,0,0.00,91.17,403980.06,1,12.25,11.25,1.01
4432,0,44114670,7654,70.12,404050.16,2,44131600,16930,44114670,7654,70.10,91.17,404050.16,0,10.87,11.25,0.99
4433,0,44122924,8254,75.58,404125.75,2,44135727,12803,44122924,8254,75.60,91.16,404125.75,1,10.94,11.25,1.01
4434,0,44134986,12062,110.46,404236.22,2,44141758,6772,44134986,12062,110.48,91.17,404236.22,0,9.75,11.25,0.99
4435,0,44162494,27508,251.98,404488.19,2,44162494,0,44162494,27508,251.95,91.20,404488.19,0,10.40,11.25,1.01
4436,0,44191374,28880,264.51,404752.72,2,44191374,0,44191374,28880,264.51,91.24,404752.72,1,11.19,11.25,1.03
4437,0,44220603,29229,267.70,405020.41,2,44220603,0,44220603,29229,267.71,91.28,405020.41,0,10.00,11.25,1.01
4438,0,44249549,28946,265.10,405285.50,2,44249549,0,44249549,28946,265.12,91.32,405285.50,0,11.16,11.25,1.03
4439,0,44249549,0,0.00,405285.50,2,44259342,9793,44249549,0,0.00,91.30,405285.50,1,13.43,12.43,1.06
4440,0,44249549,0,0.00,405285.50,2,44265116,15567,44249549,0,0.00,91.28,405285.50,0,13.94,12.94,1.03
4441,0,44249549,0,0.00,405285.50,2,44269683,20134,44249549,0,0.00,91.26,405285.50,1,13.94,12.94,1.05
4442,0,44257805,8256,75.62,405361.12,2,44273811,16006,44257805,8256,75.62,91.26,405361.12,1,12.41,12.94,1.03
4443,0,44265757,7952,72.83,405433.97,2,44277787,12030,44265757,7952,72.83,91.25,405433.97,0,11.64,12.94,1.00
4444,0,44276671,10914,99.98,405533.94,2,44283244,6573,44276671,10914,99.96,91.25,405533.94,0,12.91,12.94,1.02
4445,0,44276671,0,0.00,405533.94,2,44289946,13275,44276671,0,0.00,91.23,405533.94,1,13.01,12.01,1.04
4446,0,44276671,0,0.00,405533.94,2,44293876,17205,44276671,0,0.00,91.21,405533.94,1,12.46,11.46,1.03
4447,0,44285483,8812,80.71,405614.66,2,44298282,12799,44285483,8812,80.71,91.21,405614.66,0,11.22,11.46,1.00
4448,0,44299919,14436,132.22,405746.88,2,44305500,5581,44299919,14436,132.22,91.22,405746.88,1,11.29,11.46,1.02
4449,0,44325903,25984,237.99,405984.88,2,44325903,0,44325903,25984,237.99,91.25,405984.88,0,10.18,11.46,1.01
4450,0,44354409,28506,261.07,406245.94,2,44354409,0,44354409,28506,261.09,91.29,406245.94,1,11.42,11.46,1.03
4451,0,44354409,0,0.00,406245.94,2,44364250,9841,44354409,0,0.00,91.27,406245.94,1,11.61,10.61,1.01
4452,0,44375088,20679,189.41,406435.34,2,44375088,0,44375088,20679,189.40,91.29,406435.34,0,10.25,10.61,0.99
4453,0,44375088,0,0.00,406435.34,2,44385170,10082,44375088,0,0.00,91.27,406435.34,0,11.22,10.22,1.02
4454,0,44375088,0,0.00,406435.34,2,44390402,15314,44375088,0,0.00,91.25,406435.34,1,12.67,11.67,1.04
4455,0,44375088,0,0.00,406435.34,2,44394557,19469,44375088,0,0.00,91.23,406435.34,0,13.81,12.81,1.01
4456,0,44375088,0,0.00,406435.34,2,44398316,23228,44375088,0,0.00,91.21,406435.34,1,13.90,12.90,1.03
4457,0,44382198,7110,65.14,406500.47,2,44401871,19673,44382198,7110,65.12,91.20,406500.47,0,12.31,12.90,1.00
4458,0,44389514,7316,66.97,406567.44,2,44405529,16015,44389514,7316,67.01,91.20,406567.44,0,12.37,12.90,1.03
4459,0,44396526,7012,64.26,406631.72,2,44409035,12509,44396526,7012,64.22,91.19,406631.72,1,12.44,12.90,1.05
4460,0,44405066,8540,78.18,406709.91,2,44413305,8239,44405066,8540,78.22,91.19,406709.91,0,11.17,12.90,1.03
4461,0,44425063,19997,183.18,406893.06,2,44425063,0,44425063,19997,183.15,91.21,406893.06,1,11.25,12.90,1.05
4462,0,44454139,29076,266.31,407159.38,2,44454139,0,44454139,29076,266.31,91.25,407159.38,1,11.51,12.90,1.02
4463,0,44481710,27571,252.53,407411.91,2,44481710,0,44481710,27571,252.53,91.29,407411.91,0,11.63,12.90,1.02
4464,0,44481710,0,0.00,407411.91,2,44491453,9743,44481710,0,0.00,91.27,407411.91,1,13.31,12.31,1.04
4465,0,44481710,0,0.00,407411.91,2,44497021,15311,44481710,0,0.00,91.25,407411.91,0,14.39,13.39,1.03
4466,0,44481710,0,0.00,407411.91,2,44501329,19619,44481710,0,0.00,91.23,407411.91,1,14.39,13.39,1.06
4467,0,44481710,0,0.00,407411.91,2,44505030,23320,44481710,0,0.00,91.20,407411.91,0,14.45,13.45,1.03
4468,0,44481710,0,0.00,407411.91,2,44508468,26758,44481710,0,0.00,91.18,407411.91,1,14.74,13.74,1.05
4469,0,44481710,0,0.00,407411.91,2,44511626,29916,44481710,0,0.00,91.16,407411.91,0,13.98,12.98,1.04
4470,0,44481710,0,0.00,407411.91,2,44514278,32568,44481710,0,0.00,91.14,407411.91,1,14.50,13.50,1.06
4471,0,44487158,5448,49.90,407461.81,2,44517002,29844,44487158,5448,49.90,91.13,407461.81,1,12.77,13.50,1.02
4472,0,44492880,5722,52.39,407514.22,2,44519863,26983,44492880,5722,52.41,91.13,407514.22,0,12.71,13.50,1.02
4473,0,44498562,5682,52.02,407566.22,2,44522704,24142,44498562,5682,52.04,91.12,407566.22,0,12.92,13.50,1.04
4474,0,44504156,5594,51.25,407617.50,2,44525501,21345,44504156,5594,51.24,91.11,407617.50,1,13.14,13.50,1.06
4475,0,44509666,5510,50.45,407667.94,2,44528256,18590,44509666,5510,50.47,91.10,407667.94,1,11.73,13.50,1.02
4476,0,44515186,5520,50.56,407718.50,2,44531016,15830,44515186,5520,50.56,91.09,407718.50,0,11.11,13.50,1.03
4477,0,44521266,6080,55.69,407774.19,2,44534056,12790,44521266,6080,55.69,91.08,407774.19,1,11.29,13.50,1.05
4478,0,44532948,11682,107.01,407881.19,2,44539897,6949,44532948,11682,107.00,91.09,407881.19,0,10.77,13.50,1.05
4479,0,44559323,26375,241.58,408122.78,2,44559323,0,44559323,26375,241.57,91.12,408122.78,1,10.89,13.50,1.07
4480,0,44591247,31924,292.39,408415.16,2,44591247,0,44591247,31924,292.39,91.16,408415.16,0,11.02,13.50,1.07
4481,0,44623548,32301,295.84,408711.00,2,44623548,0,44623548,32301,295.85,91.21,408711.00,1,12.46,13.50,1.10
4482,0,44656630,33082,303.02,409014.03,2,44656630,0,44656630,33082,303.00,91.26,409014.03,0,12.48,13.50,1.09
4483,0,44656630,0,0.00,409014.03,2,44667656,11026,44656630,0,0.00,91.24,409014.03,1,15.61,14.61,1.11
4484,0,44676520,19890,182.16,409196.19,2,44677601,1081,44676520,19890,182.17,91.26,409196.19,0,14.04,14.61,1.08
4485,0,44676520,0,0.00,409196.19,2,44687573,11053,44676520,0,0.00,91.24,409196.19,0,15.79,14.79,1.10
4486,0,44676520,0,0.00,409196.19,2,44692872,16352,44676520,0,0.00,91.22,409196.19,1,16.69,15.69,1.13
4487,0,44685800,9280,85.00,409281.19,2,44697512,11712,44685800,9280,85.00,91.21,409281.19,0,15.09,15.69,1.10
4488,0,44703298,17498,160.25,409441.44,2,44706261,2963,44703298,17498,160.27,91.23,409441.44,1,15.25,15.69,1.12
4489,0,44735451,32153,294.52,409735.94,2,44735451,0,44735451,32153,294.49,91.28,409735.94,0,13.04,15.69,1.07
4490,0,44768527,33076,302.95,410038.91,2,44768527,0,44768527,33076,302.95,91.32,410038.91,1,14.92,15.69,1.09
4491,0,44800663,32136,294.34,410333.22,2,44800663,0,44800663,32136,294.34,91.37,410333.22,0,15.64,15.69,1.07
4492,0,44800663,0,0.00,410333.22,2,44811104,10441,44800663,0,0.00,91.35,410333.22,1,17.93,16.93,1.09
4493,0,44820971,20308,186.00,410519.22,2,44821258,287,44820971,20308,186.00,91.37,410519.22,0,16.13,16.93,1.05
4494,0,44820971,0,0.00,410519.22,2,44831676,10705,44820971,0,0.00,91.35,410519.22,1,17.14,16.14,1.07
4495,0,44840173,19202,175.85,410695.09,2,44841277,1104,44840173,19202,175.87,91.37,410695.09,0,15.24,16.14,1.04
4496,0,44873890,33717,308.81,411003.91,2,44873890,0,44873890,33717,308.82,91.42,411003.91,1,15.61,16.14,1.06
4497,0,44873890,0,0.00,411003.91,2,44884456,10566,44873890,0,0.00,91.40,411003.91,0,16.32,15.32,1.03
4498,0,44873890,0,0.00,411003.91,2,44890303,16413,44873890,0,0.00,91.37,411003.91,0,17.10,16.10,1.05
4499,0,44873890,0,0.00,411003.91,2,44894893,21003,44873890,0,0.00,91.35,411003.91,1,18.81,17.81,1.07
4500,0,44881984,8094,74.15,411078.06,2,44898940,16956,44881984,8094,74.13,91.35,411078.06,1,17.11,17.81,1.03
4501,0,44890120,8136,74.52,411152.56,2,44903008,12888,44890120,8136,74.52,91.35,411152.56,0,15.44,17.81,1.00
4502,0,44901412,11292,103.42,411256.00,2,44908654,7242,44901412,11292,103.42,91.35,411256.00,1,15.51,17.81,1.02
4503,0,44929340,27928,255.80,411511.78,2,44929340,0,44929340,27928,255.80,91.39,411511.78,0,16.05,17.81,1.00
4504,0,44929340,0,0.00,411511.78,2,44939596,10256,44929340,0,0.00,91.37,411511.78,1,18.30,17.30,1.02
4505,0,44929340,0,0.00,411511.78,2,44945467,16127,44929340,0,0.00,91.35,411511.78,0,17.80,16.80,1.00
4506,0,44929340,0,0.00,411511.78,2,44950041,20701,44929340,0,0.00,91.33,411511.78,1,18.90,17.90,1.02
4507,0,44937590,8250,75.58,411587.38,2,44954166,16576,44937590,8250,75.56,91.32,411587.38,0,17.26,17.90,0.99
4508,0,44945766,8176,74.88,411662.25,2,44958254,12488,44945766,8176,74.88,91.32,411662.25,1,17.33,17.90,1.01
4509,0,44955834,10068,92.18,411754.44,2,44963288,7454,44955834,10068,92.21,91.32,411754.44,0,15.79,17.90,0.98
4510,0,44982181,26347,241.32,411995.75,2,44982181,0,44982181,26347,241.31,91.35,411995.75,1,16.28,17.90,1.01
4511,0,45014304,32123,294.23,412289.97,2,45014304,0,45014304,32123,294.22,91.40,412289.97,0,15.86,17.90,0.98
4512,0,45045575,31271,286.42,412576.41,2,45045575,0,45045575,31271,286.41,91.44,412576.41,1,17.09,17.90,1.01
4513,0,45076591,31016,284.08,412860.47,2,45076591,0,45076591,31016,284.08,91.48,412860.47,0,16.26,17.90,0.99
4514,0,45076591,0,0.00,412860.47,2,45087677,11086,45076591,0,0.00,91.46,412860.47,1,20.24,19.24,1.01
4515,0,45094253,17662,161.75,413022.22,2,45096508,2255,45094253,17662,161.77,91.48,413022.22,0,19.18,19.24,0.95
4516,0,45094253,0,0.00,413022.22,2,45105900,11647,45094253,0,0.00,91.46,413022.22,1,20.17,19.17,0.98
4517,0,45094253,0,0.00,413022.22,2,45111272,17019,45094253,0,0.00,91.44,413022.22,0,19.84,18.84,0.96
4518,0,45094253,0,0.00,413022.22,2,45114589,20336,45094253,0,0.00,91.42,413022.22,0,19.84,18.84,0.99
4519,0,45094253,0,0.00,413022.22,2,45117370,23117,45094253,0,0.00,91.40,413022.22,1,20.66,19.66,1.01
4520,0,45099935,5682,52.06,413074.28,2,45120211,20276,45099935,5682,52.04,91.39,413074.28,0,19.03,19.66,0.98
4521,0,45106349,6414,58.73,413133.03,2,45123418,17069,45106349,6414,58.75,91.38,413133.03,1,19.09,19.66,1.00
4522,0,45114277,7928,72.61,413205.62,2,45127382,13105,45114277,7928,72.61,91.38,413205.62,0,17.52,19.66,0.97
4523,0,45127323,13046,119.51,413325.12,2,45133905,6582,45127323,13046,119.49,91.38,413325.12,1,17.86,19.66,0.99
4524,0,45156073,28750,263.31,413588.44,2,45156073,0,45156073,28750,263.32,91.42,413588.44,0,16.88,19.66,0.98
4525,0,45187877,31804,291.30,413879.75,2,45187877,0,45187877,31804,291.30,91.47,413879.75,0,18.74,19.66,1.00
4526,0,45219466,31589,289.32,414169.06,2,45219466,0,45219466,31589,289.33,91.51,414169.06,0,19.03,19.66,1.02
4527,0,45219466,0,0.00,414169.06,2,45229438,9972,45219466,0,0.00,91.49,414169.06,1,21.30,19.00,1.04
4528,0,45219466,0,0.00,414169.06,2,45235011,15545,45219466,0,0.00,91.47,414169.06,1,20.18,19.18,1.03
4529,0,45219466,0,0.00,414169.06,2,45239308,19842,45219466,0,0.00,91.45,414169.06,1,20.86,19.86,1.01
4530,0,45219466,0,0.00,414169.06,2,45242994,23528,45219466,0,0.00,91.43,414169.06,0,20.06,19.06,1.01
4531,0,45219466,0,0.00,414169.06,2,45246513,27047,45219466,0,0.00,91.41,414169.06,1,20.06,19.06,1.03
4532,0,45225968,6502,59.57,414228.62,2,45249764,23796,45225968,6502,59.55,91.40,414228.62,0,18.82,19.06,1.01
4533,0,45232424,6456,59.13,414287.75,2,45252992,20568,45232424,6456,59.13,91.39,414287.75,1,18.88,19.06,1.03
4534,0,45239240,6816,62.43,414350.19,2,45256400,17160,45239240,6816,62.43,91.39,414350.19,1,18.66,19.06,1.02
4535,0,45245838,6598,60.45,414410.62,2,45259699,13861,45245838,6598,60.43,91.38,414410.62,0,18.03,19.06,1.02
4536,0,45254172,8334,76.31,414486.94,2,45263866,9694,45254172,8334,76.33,91.38,414486.94,1,18.09,19.06,1.04
4537,0,45277050,22878,209.52,414696.47,2,45277050,0,45277050,22878,209.54,91.40,414696.47,0,17.06,19.06,1.03
4538,0,45308125,31075,284.63,414981.09,2,45308125,0,45308125,31075,284.62,91.45,414981.09,1,17.87,19.06,1.05
4539,0,45340167,32042,293.49,415274.59,2,45340167,0,45340167,32042,293.48,91.49,415274.59,0,18.50,19.06,1.04
4540,0,45340167,0,0.00,415274.59,2,45350718,10551,45340167,0,0.00,91.47,415274.59,1,21.72,19.00,1.06
4541,0,45340167,0,0.00,415274.59,2,45356611,16444,45340167,0,0.00,91.45,415274.59,1,21.71,19.00,1.04
4542,0,45340167,0,0.00,415274.59,2,45361277,21110,45340167,0,0.00,91.43,415274.59,0,21.49,19.00,1.03
4543,0,45340167,0,0.00,415274.59,2,45365224,25057,45340167,0,0.00,91.41,415274.59,1,21.49,19.00,1.05
4544,0,45340167,0,0.00,415274.59,2,45368920,28753,45340167,0,0.00,91.39,415274.59,0,20.44,19.44,1.03
4545,0,45340167,0,0.00,415274.59,2,45372301,32134,45340167,0,0.00,91.37,415274.59,0,22.23,19.00,1.06
4546,0,45340167,0,0.00,415274.59,2,45375418,35251,45340167,0,0.00,91.35,415274.59,1,22.23,19.00,1.08
4547,0,45340167,0,0.00,415274.59,2,45378050,37883,45340167,0,0.00,91.33,415274.59,0,20.81,19.81,1.05
4548,0,45340167,0,0.00,415274.59,2,45380662,40495,45340167,0,0.00,91.31,415274.59,1,20.81,19.81,1.08
4549,0,45345443,5276,48.32,415322.91,2,45383300,37857,45345443,5276,48.32,91.30,415322.91,1,18.63,19.81,1.03
4550,0,45350647,5204,47.66,415370.59,2,45385902,35255,45350647,5204,47.66,91.29,415370.59,0,17.56,19.81,1.02
4551,0,45355825,5178,47.41,415418.00,2,45388491,32666,45355825,5178,47.43,91.28,415418.00,1,17.61,19.81,1.04
4552,0,45360891,5066,46.42,415464.41,2,45391024,30133,45360891,5066,46.40,91.27,415464.41,0,16.05,19.81,1.01
4553,0,45365921,5030,46.05,415510.47,2,45393539,27618,45365921,5030,46.07,91.26,415510.47,1,16.67,19.81,1.03
4554,0,45370681,4760,43.60,415554.06,2,45395919,25238,45370681,4760,43.60,91.25,415554.06,0,16.19,19.81,1.03
4555,0,45375287,4606,42.21,415596.25,2,45398222,22935,45375287,4606,42.19,91.24,415596.25,1,16.44,19.81,1.05
4556,0,45379889,4602,42.13,415638.41,2,45400523,20634,45379889,4602,42.15,91.23,415638.41,0,15.47,19.81,1.04
4557,0,45384589,4700,43.05,415681.44,2,45402873,18284,45384589,4700,43.05,91.22,415681.44,0,15.51,19.81,1.06
4558,0,45389647,5058,46.34,415727.78,2,45405402,15755,45389647,5058,46.33,91.21,415727.78,1,15.55,19.81,1.08
4559,0,45395881,6234,57.08,415784.88,2,45408519,12638,45395881,6234,57.10,91.20,415784.88,1,14.25,19.81,1.06
4560,0,45408307,12426,113.83,415898.69,2,45414732,6425,45408307,12426,113.81,91.21,415898.69,0,13.40,19.81,1.05
4561,0,45434667,26360,241.43,416140.12,2,45434667,0,45434667,26360,241.43,91.24,416140.12,1,13.83,19.81,1.08
4562,0,45466888,32221,295.11,416435.25,2,45466888,0,45466888,32221,295.11,91.28,416435.25,0,14.34,19.81,1.07
4563,0,45499109,32221,295.11,416730.34,2,45499109,0,45499109,32221,295.11,91.33,416730.34,0,15.87,19.81,1.10
4564,0,45531472,32363,296.42,417026.75,2,45531472,0,45531472,32363,296.42,91.37,417026.75,1,19.07,19.81,1.12
4565,0,45563575,32103,294.04,417320.81,2,45563575,0,45563575,32103,294.03,91.42,417320.81,0,18.73,19.81,1.09
4566,0,45596114,32539,298.00,417618.81,2,45596114,0,45596114,32539,298.03,91.46,417618.81,0,19.01,19.81,1.11
4567,0,45596114,0,0.00,417618.81,2,45606629,10515,45596114,0,0.00,91.44,417618.81,1,21.18,19.00,1.13
4568,0,45617840,21726,199.01,417817.81,2,45617840,0,45617840,21726,198.99,91.47,417817.81,1,17.73,19.00,1.05
4569,0,45650450,32610,298.66,418116.47,2,45650450,0,45650450,32610,298.68,91.51,418116.47,0,18.62,19.00,1.03
4570,0,45650450,0,0.00,418116.47,2,45661274,10824,45650450,0,0.00,91.49,418116.47,1,20.91,19.91,1.05
4571,0,45650450,0,0.00,418116.47,2,45667063,16613,45650450,0,0.00,91.47,418116.47,0,20.94,19.94,1.01
4572,0,45650450,0,0.00,418116.47,2,45671543,21093,45650450,0,0.00,91.45,418116.47,1,20.94,19.94,1.03
4573,0,45659098,8648,79.21,418195.69,2,45675867,16769,45659098,8648,79.21,91.45,418195.69,0,18.79,19.94,0.99
4574,0,45667516,8418,77.12,418272.81,2,45680076,12560,45667516,8418,77.10,91.45,418272.81,1,18.87,19.94,1.01
4575,0,45679744,12228,112.00,418384.81,2,45686190,6446,45679744,12228,112.00,91.45,418384.81,0,17.69,19.94,0.97
4576,0,45707664,27920,255.72,418640.53,2,45707664,0,45707664,27920,255.72,91.49,418640.53,1,17.95,19.94,0.99
4577,0,45739719,32055,293.60,418934.12,2,45739719,0,45739719,32055,293.59,91.53,418934.12,0,16.16,19.94,0.95
4578,0,45772107,32388,296.64,419230.78,2,45772107,0,45772107,32388,296.64,91.58,419230.78,1,17.60,19.94,0.97
4579,0,45804754,32647,298.99,419529.75,2,45804754,0,45804754,32647,299.02,91.62,419529.75,0,18.04,19.94,0.94
4580,0,45804754,0,0.00,419529.75,2,45815392,10638,45804754,0,0.00,91.60,419529.75,1,20.34,19.34,0.96
4581,0,45824412,19658,180.07,419709.84,2,45825221,809,45824412,19658,180.05,91.62,419709.84,0,18.31,19.34,0.92
4582,0,45824412,0,0.00,419709.84,2,45834959,10547,45824412,0,0.00,91.60,419709.84,1,20.49,19.49,0.94
4583,0,45824412,0,0.00,419709.84,2,45840492,16080,45824412,0,0.00,91.58,419709.84,0,20.54,19.54,0.91
4584,0,45824412,0,0.00,419709.84,2,45844009,19597,45824412,0,0.00,91.56,419709.84,1,20.82,19.82,0.93
4585,0,45831514,7102,65.03,419774.84,2,45847560,16046,45831514,7102,65.05,91.55,419774.84,0,18.32,19.82,0.88
4586,0,45841588,10074,92.29,419867.16,2,45852597,11009,45841588,10074,92.27,91.55,419867.16,1,18.39,19.82,0.90
4587,0,45858980,17392,159.29,420026.44,2,45861293,2313,45858980,17392,159.29,91.57,420026.44,0,18.94,19.82,0.88
4588,0,45891914,32934,301.63,420328.06,2,45891914,0,45891914,32934,301.65,91.61,420328.06,0,19.10,19.82,0.90
4589,0,45891914,0,0.00,420328.06,2,45902420,10506,45891914,0,0.00,91.59,420328.06,1,21.39,19.00,0.92
4590,0,45891914,0,0.00,420328.06,2,45908229,16315,45891914,0,0.00,91.57,420328.06,1,20.46,19.46,0.85
4591,0,45902714,10800,98.92,420427.00,2,45913629,10915,45902714,10800,98.92,91.58,420427.00,0,19.08,19.46,0.83
4592,0,45902714,0,0.00,420427.00,2,45918650,15936,45902714,0,0.00,91.56,420427.00,1,19.89,18.89,0.85
4593,0,45911328,8614,78.91,420505.91,2,45922957,11629,45911328,8614,78.90,91.55,420505.91,0,17.98,18.89,0.81
4594,0,45929032,17704,162.15,420668.06,2,45931809,2777,45929032,17704,162.15,91.57,420668.06,1,18.73,18.89,0.83
4595,0,45961107,32075,293.79,420961.84,2,45961107,0,45961107,32075,293.78,91.61,420961.84,0,17.65,18.89,0.80
4596,0,45961107,0,0.00,420961.84,2,45971423,10316,45961107,0,0.00,91.59,420961.84,1,20.00,19.00,0.82
4597,0,45982698,21591,197.73,421159.56,2,45982698,0,45982698,21591,197.75,91.62,421159.56,0,18.54,19.00,0.80
4598,0,45982698,0,0.00,421159.56,2,45993094,10396,45982698,0,0.00,91.60,421159.56,0,19.26,18.26,0.82
4599,0,45982698,0,0.00,421159.56,2,45998900,16202,45982698,0,0.00,91.58,421159.56,0,19.90,18.90,0.84
4600,0,45982698,0,0.00,421159.56,2,46003332,20634,45982698,0,0.00,91.56,421159.56,1,19.90,18.90,0.86
4601,0,45990942,8244,75.54,421235.12,2,46007454,16512,45990942,8244,75.51,91.55,421235.12,1,17.80,18.90,0.82
4602,0,45999400,8458,77.45,421312.56,2,46011683,12283,45999400,8458,77.47,91.55,421312.56,0,16.83,18.90,0.79
4603,0,46010750,11350,103.97,421416.53,2,46017358,6608,46010750,11350,103.96,91.55,421416.53,1,16.91,18.90,0.82
4604,0,46037883,27133,248.50,421665.03,2,46037883,0,46037883,27133,248.51,91.59,421665.03,0,14.56,18.90,0.76
4605,0,46037883,0,0.00,421665.03,2,46048530,10647,46037883,0,0.00,91.57,421665.03,1,18.97,17.97,0.78
4606,0,46037883,0,0.00,421665.03,2,46054134,16251,46037883,0,0.00,91.55,421665.03,1,20.23,19.23,0.78
4607,0,46048291,10408,95.33,421760.38,2,46059338,11047,46048291,10408,95.33,91.55,421760.38,0,18.43,19.23,0.75
4608,0,46066527,18236,167.03,421927.38,2,46068456,1929,46066527,18236,167.03,91.56,421927.38,1,18.52,19.23,0.77
4609,0,46098803,32276,295.62,422223.00,2,46098803,0,46098803,32276,295.62,91.61,422223.00,0,17.73,19.23,0.76
4610,0,46098803,0,0.00,422223.00,2,46109472,10669,46098803,0,0.00,91.59,422223.00,1,19.83,18.83,0.78
4611,0,46118539,19736,180.76,422403.78,2,46119340,801,46118539,19736,180.76,91.61,422403.78,0,18.57,18.83,0.76
4612,0,46118539,0,0.00,422403.78,2,46129138,10599,46118539,0,0.00,91.59,422403.78,1,19.75,18.75,0.78
4613,0,46137925,19386,177.54,422581.31,2,46138831,906,46137925,19386,177.56,91.61,422581.31,0,18.54,18.75,0.74
4614,0,46137925,0,0.00,422581.31,2,46148409,10484,46137925,0,0.00,91.59,422581.31,1,20.72,19.72,0.76
4615,0,46137925,0,0.00,422581.31,2,46153913,15988,46137925,0,0.00,91.57,422581.31,0,19.76,18.76,0.74
4616,0,46137925,0,0.00,422581.31,2,46157444,19519,46137925,0,0.00,91.55,422581.31,1,20.51,19.51,0.77
4617,0,46144923,6998,64.11,422645.44,2,46160943,16020,46144923,6998,64.10,91.54,422645.44,0,18.60,19.51,0.72
4618,0,46154789,9866,90.35,422735.78,2,46165876,11087,46154789,9866,90.36,91.54,422735.78,1,18.66,19.51,0.74
4619,0,46172591,17802,163.07,422898.84,2,46174777,2186,46172591,17802,163.05,91.56,422898.84,0,17.39,19.51,0.73
4620,0,46204186,31595,289.35,423188.19,2,46204186,0,46204186,31595,289.38,91.60,423188.19,1,18.24,19.51,0.75
4621,0,46236194,32008,293.16,423481.34,2,46236194,0,46236194,32008,293.16,91.64,423481.34,0,18.49,19.51,0.72
4622,0,46268381,32187,294.81,423776.16,2,46268381,0,46268381,32187,294.80,91.69,423776.16,1,19.50,19.51,0.74
4623,0,46268381,0,0.00,423776.16,2,46278818,10437,46268381,0,0.00,91.67,423776.16,1,19.94,18.94,0.71
4624,0,46289509,21128,193.51,423969.69,2,46289509,0,46289509,21128,193.51,91.69,423969.69,0,18.37,18.94,0.69
4625,0,46289509,0,0.00,423969.69,2,46300047,10538,46289509,0,0.00,91.67,423969.69,0,19.37,18.37,0.71
4626,0,46289509,0,0.00,423969.69,2,46305816,16307,46289509,0,0.00,91.65,423969.69,1,20.54,19.54,0.73
4627,0,46299485,9976,91.37,424061.06,2,46310804,11319,46299485,9976,91.37,91.65,424061.06,0,18.49,19.54,0.69
4628,0,46318823,19338,177.14,424238.19,2,46320473,1650,46318823,19338,177.12,91.67,424238.19,1,18.58,19.54,0.71
4629,0,46351579,32756,300.02,424538.22,2,46351579,0,46351579,32756,300.02,91.71,424538.22,0,19.26,19.54,0.69
4630,0,46351579,0,0.00,424538.22,2,46362406,10827,46351579,0,0.00,91.69,424538.22,1,20.01,19.01,0.71
4631,0,46371793,20214,185.12,424723.34,2,46372513,720,46371793,20214,185.14,91.71,424723.34,0,18.90,19.01,0.66
4632,0,46371793,0,0.00,424723.34,2,46382360,10567,46371793,0,0.00,91.69,424723.34,1,19.28,18.28,0.68
4633,0,46371793,0,0.00,424723.34,2,46387543,15750,46371793,0,0.00,91.67,424723.34,0,19.87,18.87,0.66
4634,0,46371793,0,0.00,424723.34,2,46390990,19197,46371793,0,0.00,91.65,424723.34,1,19.87,18.87,0.68
4635,0,46378763,6970,63.86,424787.19,2,46394475,15712,46378763,6970,63.84,91.65,424787.19,0,17.80,18.87,0.64
4636,0,46388941,10178,93.20,424880.38,2,46399564,10623,46388941,10178,93.22,91.65,424880.38,1,18.07,18.87,0.66
4637,0,46406969,18028,165.12,425045.50,2,46408578,1609,46406969,18028,165.12,91.66,425045.50,0,16.93,18.87,0.63
4638,0,46439603,32634,298.92,425344.44,2,46439603,0,46439603,32634,298.90,91.71,425344.44,0,17.29,18.87,0.65
4639,0,46439603,0,0.00,425344.44,2,46450163,10560,46439603,0,0.00,91.69,425344.44,1,19.11,18.11,0.67
4640,0,46461077,21474,196.66,425541.09,2,46461077,0,46461077,21474,196.68,91.71,425541.09,0,17.42,18.11,0.64
4641,0,46493961,32884,301.19,425842.28,2,46493961,0,46493961,32884,301.19,91.76,425842.28,1,18.03,18.11,0.66
4642,0,46526178,32217,295.07,426137.34,2,46526178,0,46526178,32217,295.08,91.80,426137.34,0,17.14,18.11,0.62
4643,0,46558459,32281,295.69,426433.03,2,46558459,0,46558459,32281,295.66,91.84,426433.03,1,18.09,18.11,0.64
4644,0,46558459,0,0.00,426433.03,2,46569000,10541,46558459,0,0.00,91.82,426433.03,0,21.13,19.00,0.61
4645,0,46558459,0,0.00,426433.03,2,46574864,16405,46558459,0,0.00,91.80,426433.03,1,22.08,19.00,0.63
4646,0,46558459,0,0.00,426433.03,2,46579554,21095,46558459,0,0.00,91.78,426433.03,0,20.89,19.89,0.61
4647,0,46558459,0,0.00,426433.03,2,46583632,25173,46558459,0,0.00,91.77,426433.03,1,21.52,19.00,0.63
4648,0,46558459,0,0.00,426433.03,2,46587284,28825,46558459,0,0.00,91.75,426433.03,1,20.04,19.04,0.61
4649,0,46558459,0,0.00,426433.03,2,46590623,32164,46558459,0,0.00,91.73,426433.03,0,19.83,18.83,0.59
4650,0,46558459,0,0.00,426433.03,2,46593491,35032,46558459,0,0.00,91.71,426433.03,1,19.96,18.96,0.61
4651,0,46564059,5600,51.29,426484.34,2,46596291,32232,46564059,5600,51.29,91.70,426484.34,0,18.63,18.96,0.60
4652,0,46569951,5892,53.97,426538.28,2,46599237,29286,46569951,5892,53.97,91.69,426538.28,1,18.73,18.96,0.62
4653,0,46575847,5896,54.00,426592.28,2,46602185,26338,46575847,5896,54.00,91.68,426592.28,0,17.39,18.96,0.59
4654,0,46581565,5718,52.35,426644.66,2,46605044,23479,46581565,5718,52.37,91.67,426644.66,1,17.50,18.96,0.62
4655,0,46587223,5658,51.84,426696.50,2,46607873,20650,46587223,5658,51.82,91.66,426696.50,0,16.15,18.96,0.59
4656,0,46592631,5408,49.53,426746.03,2,46610577,17946,46592631,5408,49.53,91.66,426746.03,1,16.47,18.96,0.61
4657,0,46598249,5618,51.44,426797.47,2,46613386,15137,46598249,5618,51.46,91.65,426797.47,0,14.61,18.96,0.58
4658,0,46604913,6664,61.04,426858.50,2,46616718,11805,46604913,6664,61.04,91.64,426858.50,0,14.66,18.96,0.60
4659,0,46620081,15168,138.93,426997.41,2,46624302,4221,46620081,15168,138.93,91.65,426997.41,1,14.88,18.96,0.62
4660,0,46649930,29849,273.38,427270.81,2,46649930,0,46649930,29849,273.39,91.69,427270.81,0,15.06,18.96,0.60
4661,0,46682338,32408,296.83,427567.62,2,46682338,0,46682338,32408,296.83,91.73,427567.62,1,17.04,18.96,0.62
4662,0,46714069,31731,290.64,427858.28,2,46714069,0,46714069,31731,290.63,91.78,427858.28,0,16.20,18.96,0.60
4663,0,46745768,31699,290.34,428148.59,2,46745768,0,46745768,31699,290.33,91.82,428148.59,1,17.57,18.96,0.62
4664,0,46778103,32335,296.17,428444.78,2,46778103,0,46778103,32335,296.16,91.86,428444.78,1,17.43,18.96,0.61
4665,0,46810204,32101,294.01,428738.78,2,46810204,0,46810204,32101,294.02,91.91,428738.78,0,18.63,18.96,0.59
4666,0,46842730,32526,297.89,429036.69,2,46842730,0,46842730,32526,297.91,91.95,429036.69,1,18.92,18.96,0.62
4667,0,46842730,0,0.00,429036.69,2,46853008,10278,46842730,0,0.00,91.93,429036.69,1,19.77,18.77,0.59
4668,0,46842730,0,0.00,429036.69,2,46858732,16002,46842730,0,0.00,91.91,429036.69,0,20.28,19.28,0.57
4669,0,46842730,0,0.00,429036.69,2,46863191,20461,46842730,0,0.00,91.89,429036.69,0,20.28,19.28,0.59
4670,0,46842730,0,0.00,429036.69,2,46867155,24425,46842730,0,0.00,91.87,429036.69,1,22.28,19.00,0.61
4671,0,46842730,0,0.00,429036.69,2,46870608,27878,46842730,0,0.00,91.85,429036.69,1,20.54,19.54,0.58
4672,0,46849434,6704,61.40,429098.06,2,46873960,24526,46849434,6704,61.40,91.84,429098.06,0,19.22,19.54,0.55
4673,0,46856242,6808,62.36,429160.44,2,46877364,21122,46856242,6808,62.36,91.84,429160.44,0,19.28,19.54,0.58
4674,0,46856242,0,0.00,429160.44,2,46880441,24199,46856242,0,0.00,91.82,429160.44,1,19.83,18.83,0.60
4675,0,46861562,5320,48.73,429209.16,2,46883101,21539,46861562,5320,48.73,91.81,429209.16,0,18.64,18.83,0.55
4676,0,46867238,5676,52.02,429261.19,2,46885939,18701,46867238,5676,51.99,91.80,429261.19,1,18.72,18.83,0.57
4677,0,46873006,5768,52.83,429314.00,2,46888823,15817,46873006,5768,52.83,91.79,429314.00,0,17.42,18.83,0.55
4678,0,46879820,6814,62.39,429376.41,2,46892230,12410,46879820,6814,62.41,91.79,429376.41,0,17.47,18.83,0.57
4679,0,46894634,14814,135.66,429512.06,2,46899637,5003,46894634,14814,135.68,91.80,429512.06,1,17.53,18.83,0.59
4680,0,46924971,30337,277.89,429789.97,2,46924971,0,46924971,30337,277.86,91.84,429789.97,0,15.92,18.83,0.56
4681,0,46956471,31500,288.51,430078.47,2,46956471,0,46956471,31500,288.51,91.88,430078.47,1,16.85,18.83,0.58
4682,0,46988695,32224,295.14,430373.59,2,46988695,0,46988695,32224,295.14,91.92,430373.59,0,16.06,18.83,0.55
4683,0,47020761,32066,293.68,430667.28,2,47020761,0,47020761,32066,293.70,91.96,430667.28,1,18.16,18.83,0.57
4684,0,47053044,32283,295.69,430962.97,2,47053044,0,47053044,32283,295.68,92.01,430962.97,0,18.45,18.83,0.55
4685,0,47053044,0,0.00,430962.97,2,47063776,10732,47053044,0,0.00,91.99,430962.97,1,21.04,19.00,0.57
4686,0,47053044,0,0.00,430962.97,2,47069506,16462,47053044,0,0.00,91.97,430962.97,0,20.73,19.73,0.56
4687,0,47053044,0,0.00,430962.97,2,47073863,20819,47053044,0,0.00,91.95,430962.97,1,22.15,19.00,0.58
4688,0,47053044,0,0.00,430962.97,2,47077720,24676,47053044,0,0.00,91.93,430962.97,0,20.67,19.67,0.55
4689,0,47053044,0,0.00,430962.97,2,47081168,28124,47053044,0,0.00,91.91,430962.97,1,20.67,19.67,0.57
4690,0,47059820,6776,62.06,431025.03,2,47084556,24736,47059820,6776,62.06,91.90,431025.03,1,19.59,19.67,0.56
4691,0,47059820,0,0.00,431025.03,2,47087757,27937,47059820,0,0.00,91.88,431025.03,0,19.77,18.77,0.55
4692,0,47059820,0,0.00,431025.03,2,47090648,30828,47059820,0,0.00,91.86,431025.03,1,19.77,18.77,0.57
4693,0,47065320,5500,50.37,431075.41,2,47093398,28078,47065320,5500,50.37,91.85,431075.41,0,18.36,18.77,0.55
4694,0,47070700,5380,49.28,431124.69,2,47096088,25388,47070700,5380,49.28,91.85,431124.69,1,18.41,18.77,0.57
4695,0,47076042,5342,48.91,431173.59,2,47098759,22717,47076042,5342,48.93,91.84,431173.59,0,17.45,18.77,0.55
4696,0,47081304,5262,48.21,431221.81,2,47101390,20086,47081304,5262,48.20,91.83,431221.81,1,17.78,18.77,0.57
4697,0,47086548,5244,48.03,431269.84,2,47104012,17464,47086548,5244,48.03,91.82,431269.84,0,17.03,18.77,0.54
4698,0,47091904,5356,49.06,431318.91,2,47106690,14786,47091904,5356,49.06,91.81,431318.91,1,17.22,18.77,0.56
4699,0,47099032,7128,65.29,431384.19,2,47110254,11222,47099032,7128,65.29,91.80,431384.19,0,16.26,18.77,0.55
4700,0,47117266,18234,166.99,431551.19,2,47119371,2105,47117266,18234,167.01,91.82,431551.19,1,16.52,18.77,0.57
4701,0,47117266,0,0.00,431551.19,2,47128570,11304,47117266,0,0.00,91.80,431551.19,1,18.87,17.87,0.56
4702,0,47134676,17410,159.48,431710.66,2,47137275,2599,47134676,17410,159.46,91.81,431710.66,0,17.70,17.87,0.54
4703,0,47134676,0,0.00,431710.66,2,47145583,10907,47134676,0,0.00,91.79,431710.66,0,19.56,18.56,0.56
4704,0,47134676,0,0.00,431710.66,2,47151009,16333,47134676,0,0.00,91.78,431710.66,1,20.18,19.18,0.58
4705,0,47144922,10246,93.83,431804.47,2,47156132,11210,47144922,10246,93.84,91.78,431804.47,0,18.83,19.18,0.56
4706,0,47162020,17098,156.62,431961.09,2,47164681,2661,47162020,17098,156.60,91.79,431961.09,1,18.92,19.18,0.58
4707,0,47192745,30725,281.40,432242.50,2,47192745,0,47192745,30725,281.41,91.83,432242.50,0,17.20,19.18,0.54
4708,0,47224297,31552,288.99,432531.50,2,47224297,0,47224297,31552,288.99,91.87,432531.50,1,18.74,19.18,0.56
4709,0,47256112,31815,291.41,432822.91,2,47256112,0,47256112,31815,291.40,91.91,432822.91,0,18.70,19.18,0.54
4710,0,47288064,31952,292.65,433115.53,2,47288064,0,47288064,31952,292.65,91.96,433115.53,1,18.99,19.18,0.56
4711,0,47320667,32603,298.62,433414.16,2,47320667,0,47320667,32603,298.61,92.00,433414.16,0,18.02,19.18,0.53
4712,0,47320667,0,0.00,433414.16,2,47331437,10770,47320667,0,0.00,91.98,433414.16,1,20.26,19.26,0.55
4713,0,47320667,0,0.00,433414.16,2,47337310,16643,47320667,0,0.00,91.96,433414.16,0,19.62,18.62,0.52
4714,0,47320667,0,0.00,433414.16,2,47342062,21395,47320667,0,0.00,91.94,433414.16,1,24.86,19.00,0.54
4715,0,47320667,0,0.00,433414.16,2,47346157,25490,47320667,0,0.00,91.92,433414.16,0,23.02,19.00,0.51
4716,0,47320667,0,0.00,433414.16,2,47349810,29143,47320667,0,0.00,91.90,433414.16,1,23.02,19.00,0.53
4717,0,47320667,0,0.00,433414.16,2,47353146,32479,47320667,0,0.00,91.88,433414.16,0,21.24,19.00,0.50
4718,0,47320667,0,0.00,433414.16,2,47356235,35568,47320667,0,0.00,91.86,433414.16,0,21.52,19.00,0.52
4719,0,47320667,0,0.00,433414.16,2,47359094,38427,47320667,0,0.00,91.84,433414.16,1,21.52,19.00,0.54
4720,0,47320667,0,0.00,433414.16,2,47361586,40919,47320667,0,0.00,91.83,433414.16,0,19.80,18.80,0.51
4721,0,47320667,0,0.00,433414.16,2,47363977,43310,47320667,0,0.00,91.81,433414.16,1,19.80,18.80,0.53
4722,0,47325607,4940,45.25,433459.41,2,47366447,40840,47325607,4940,45.25,91.80,433459.41,0,18.01,18.80,0.50
4723,0,47330485,4878,44.66,433504.06,2,47368886,38401,47330485,4878,44.68,91.79,433504.06,1,18.05,18.80,0.52
4724,0,47335341,4856,44.48,433548.56,2,47371314,35973,47335341,4856,44.48,91.78,433548.56,0,16.33,18.80,0.49
4725,0,47340143,4802,44.00,433592.56,2,47373715,33572,47340143,4802,43.98,91.77,433592.56,1,16.38,18.80,0.51
4726,0,47344891,4748,43.49,433636.03,2,47376089,31198,47344891,4748,43.49,91.76,433636.03,0,15.55,18.80,0.50
4727,0,47349579,4688,42.94,433678.97,2,47378433,28854,47349579,4688,42.94,91.75,433678.97,1,16.14,18.80,0.52
4728,0,47354221,4642,42.50,433721.47,2,47380754,26533,47354221,4642,42.52,91.73,433721.47,0,14.55,18.80,0.49
4729,0,47358685,4464,40.89,433762.38,2,47382986,24301,47358685,4464,40.89,91.72,433762.38,1,15.46,18.80,0.51
4730,0,47363111,4426,40.56,433802.91,2,47385199,22088,47363111,4426,40.54,91.71,433802.91,1,14.21,18.80,0.49
4731,0,47367739,4628,42.39,433845.31,2,47387513,19774,47367739,4628,42.39,91.70,433845.31,0,13.24,18.80,0.48
4732,0,47372723,4984,45.65,433890.97,2,47390005,17282,47372723,4984,45.65,91.69,433890.97,1,13.28,18.80,0.50
4733,0,47378015,5292,48.47,433939.44,2,47392651,14636,47378015,5292,48.47,91.68,433939.44,0,12.28,18.80,0.49
4734,0,47384997,6982,63.93,434003.34,2,47396142,11145,47384997,6982,63.95,91.68,434003.34,1,12.32,18.80,0.51
4735,0,47400753,15756,144.31,434147.66,2,47404020,3267,47400753,15756,144.31,91.69,434147.66,0,11.35,18.80,0.50
4736,0,47430946,30193,276.53,434424.19,2,47430946,0,47430946,30193,276.54,91.73,434424.19,1,13.27,18.80,0.52
4737,0,47461620,30674,280.96,434705.16,2,47461620,0,47461620,30674,280.95,91.77,434705.16,0,12.76,18.80,0.51
4738,0,47492402,30782,281.92,434987.06,2,47492402,0,47492402,30782,281.94,91.81,434987.06,1,14.75,18.80,0.53
4739,0,47523069,30667,280.89,435267.97,2,47523069,0,47523069,30667,280.88,91.85,435267.97,0,15.19,18.80,0.53
4740,0,47554196,31127,285.10,435553.06,2,47554196,0,47554196,31127,285.09,91.89,435553.06,1,15.51,18.80,0.55
4741,0,47584729,30533,279.65,435832.72,2,47584729,0,47584729,30533,279.65,91.93,435832.72,1,16.97,18.80,0.53
4742,0,47615163,30434,278.77,436111.47,2,47615163,0,47615163,30434,278.75,91.97,436111.47,0,18.48,18.80,0.52
4743,0,47615163,0,0.00,436111.47,2,47625291,10128,47615163,0,0.00,91.95,436111.47,0,20.76,19.76,0.54
4744,0,47615163,0,0.00,436111.47,2,47631304,16141,47615163,0,0.00,91.93,436111.47,1,22.77,19.00,0.56
4745,0,47615163,0,0.00,436111.47,2,47635829,20666,47615163,0,0.00,91.91,436111.47,0,21.54,19.00,0.54
4746,0,47615163,0,0.00,436111.47,2,47639721,24558,47615163,0,0.00,91.89,436111.47,1,21.69,19.00,0.56
4747,0,47615163,0,0.00,436111.47,2,47643196,28033,47615163,0,0.00,91.87,436111.47,0,20.84,19.84,0.53
4748,0,47615163,0,0.00,436111.47,2,47646422,31259,47615163,0,0.00,91.85,436111.47,0,21.45,19.00,0.55
4749,0,47615163,0,0.00,436111.47,2,47649244,34081,47615163,0,0.00,91.83,436111.47,1,21.45,19.00,0.57
4750,0,47615163,0,0.00,436111.47,2,47651871,36708,47615163,0,0.00,91.81,436111.47,1,19.59,18.59,0.53
4751,0,47620281,5118,46.86,436158.34,2,47654430,34149,47620281,5118,46.88,91.80,436158.34,0,18.06,18.59,0.51
4752,0,47625691,5410,49.57,436207.91,2,47657135,31444,47625691,5410,49.55,91.79,436207.91,1,18.11,18.59,0.53
4753,0,47631013,5322,48.73,436256.62,2,47659796,28783,47631013,5322,48.74,91.79,436256.62,0,16.83,18.59,0.51
4754,0,47636309,5296,48.51,436305.16,2,47662444,26135,47636309,5296,48.51,91.78,436305.16,1,17.21,18.59,0.53
4755,0,47641445,5136,47.04,436352.19,2,47665012,23567,47641445,5136,47.04,91.77,436352.19,0,15.85,18.59,0.51
4756,0,47646563,5118,46.89,436399.09,2,47667571,21008,47646563,5118,46.88,91.76,436399.09,1,15.90,18.59,0.53
4757,0,47651531,4968,45.50,436444.59,2,47670055,18524,47651531,4968,45.50,91.75,436444.59,0,14.49,18.59,0.50
4758,0,47656795,5264,48.21,436492.78,2,47672687,15892,47656795,5264,48.21,91.74,436492.78,0,14.53,18.59,0.53
4759,0,47663101,6306,57.74,436550.53,2,47675840,12739,47663101,6306,57.76,91.73,436550.53,1,14.58,18.59,0.55
4760,0,47675581,12480,114.31,436664.84,2,47682080,6499,47675581,12480,114.31,91.74,436664.84,0,13.33,18.59,0.53
4761,0,47700747,25166,230.52,436895.34,2,47700747,0,47700747,25166,230.50,91.77,436895.34,1,13.44,18.59,0.55
4762,0,47730995,30248,277.04,437172.41,2,47730995,0,47730995,30248,277.04,91.80,437172.41,1,12.28,18.59,0.53
4763,0,47761514,30519,279.50,437451.91,2,47761514,0,47761514,30519,279.53,91.84,437451.91,0,13.57,18.59,0.52
4764,0,47792792,31278,286.50,437738.41,2,47792792,0,47792792,31278,286.48,91.88,437738.41,1,15.60,18.59,0.54
4765,0,47823394,30602,280.27,438018.66,2,47823394,0,47823394,30602,280.29,91.92,438018.66,0,16.94,18.59,0.53
4766,0,47823394,0,0.00,438018.66,2,47833677,10283,47823394,0,0.00,91.90,438018.66,1,18.99,17.99,0.55
4767,0,47823394,0,0.00,438018.66,2,47839396,16002,47823394,0,0.00,91.89,438018.66,0,18.93,17.93,0.52
4768,0,47823394,0,0.00,438018.66,2,47843622,20228,47823394,0,0.00,91.87,438018.66,1,19.16,18.16,0.54
4769,0,47831670,8276,75.84,438094.50,2,47847760,16090,47831670,8276,75.80,91.86,438094.50,0,17.81,18.16,0.52
4770,0,47831670,0,0.00,438094.50,2,47851604,19934,47831670,0,0.00,91.84,438094.50,1,19.46,18.46,0.54
4771,0,47838626,6956,63.67,438158.19,2,47855082,16456,47838626,6956,63.71,91.84,438158.19,0,18.19,18.46,0.52
4772,0,47846508,7882,72.21,438230.38,2,47859023,12515,47846508,7882,72.19,91.83,438230.38,1,18.25,18.46,0.54
4773,0,47861018,14510,132.88,438363.25,2,47866278,5260,47861018,14510,132.90,91.84,438363.25,0,16.46,18.46,0.51
4774,0,47861018,0,0.00,438363.25,2,47873851,12833,47861018,0,0.00,91.82,438363.25,1,18.47,17.47,0.53
4775,0,47875448,14430,132.18,438495.44,2,47881066,5618,47875448,14430,132.17,91.83,438495.44,0,17.19,17.47,0.51
4776,0,47875448,0,0.00,438495.44,2,47888429,12981,47875448,0,0.00,91.81,438495.44,1,19.35,18.35,0.53
4777,0,47889836,14388,131.78,438627.22,2,47895623,5787,47889836,14388,131.78,91.82,438627.22,0,17.95,18.35,0.51
4778,0,47889836,0,0.00,438627.22,2,47902881,13045,47889836,0,0.00,91.80,438627.22,0,20.05,19.05,0.53
4779,0,47889836,0,0.00,438627.22,2,47907178,17342,47889836,0,0.00,91.78,438627.22,1,20.63,19.63,0.55
4780,0,47898370,8534,78.15,438705.38,2,47911445,13075,47898370,8534,78.16,91.78,438705.38,0,19.33,19.63,0.53
4781,0,47911228,12858,117.79,438823.16,2,47917874,6646,47911228,12858,117.77,91.78,438823.16,1,19.59,19.63,0.55
4782,0,47936251,25023,229.20,439052.34,2,47936251,0,47936251,25023,229.19,91.81,439052.34,1,18.55,19.63,0.54
4783,0,47966183,29932,274.15,439326.50,2,47966183,0,47966183,29932,274.15,91.85,439326.50,0,17.80,19.63,0.53
4784,0,47996177,29994,274.70,439601.22,2,47996177,0,47996177,29994,274.72,91.89,439601.22,1,18.09,19.63,0.55
4785,0,48026374,30197,276.60,439877.81,2,48026374,0,48026374,30197,276.58,91.93,439877.81,0,18.14,19.63,0.54
4786,0,48026374,0,0.00,439877.81,2,48036523,10149,48026374,0,0.00,91.91,439877.81,1,20.68,19.68,0.56
4787,0,48026374,0,0.00,439877.81,2,48042420,16046,48026374,0,0.00,91.89,439877.81,1,21.26,19.00,0.54
4788,0,48026374,0,0.00,439877.81,2,48046997,20623,48026374,0,0.00,91.87,439877.81,0,20.27,19.27,0.54
4789,0,48026374,0,0.00,439877.81,2,48051000,24626,48026374,0,0.00,91.85,439877.81,0,21.99,19.00,0.56
4790,0,48026374,0,0.00,439877.81,2,48054547,28173,48026374,0,0.00,91.83,439877.81,1,22.28,19.00,0.58
4791,0,48026374,0,0.00,439877.81,2,48057739,31365,48026374,0,0.00,91.81,439877.81,1,20.62,19.62,0.55
4792,0,48032488,6114,55.98,439933.78,2,48060796,28308,48032488,6114,56.00,91.81,439933.78,0,19.55,19.62,0.54
4793,0,48032488,0,0.00,439933.78,2,48063704,31216,48032488,0,0.00,91.79,439933.78,0,19.89,18.89,0.56
4794,0,48032488,0,0.00,439933.78,2,48066163,33675,48032488,0,0.00,91.77,439933.78,1,21.61,19.00,0.58
4795,0,48032488,0,0.00,439933.78,2,48068550,36062,48032488,0,0.00,91.75,439933.78,0,19.91,18.91,0.55
4796,0,48032488,0,0.00,439933.78,2,48070962,38474,48032488,0,0.00,91.73,439933.78,1,19.91,18.91,0.57
4797,0,48037136,4648,42.57,439976.38,2,48073286,36150,48037136,4648,42.57,91.72,439976.38,0,18.21,18.91,0.54
4798,0,48041816,4680,42.86,440019.22,2,48075626,33810,48041816,4680,42.86,91.71,440019.22,0,18.25,18.91,0.56
4799,0,48046430,4614,42.28,440061.50,2,48077933,31503,48046430,4614,42.26,91.70,440061.50,1,18.57,18.91,0.59
4800,0,48050814,4384,40.15,440101.66,2,48080125,29311,48050814,4384,40.15,91.69,440101.66,0,17.72,18.91,0.56
4801,0,48055170,4356,39.86,440141.53,2,48082303,27133,48055170,4356,39.90,91.68,440141.53,1,18.90,18.91,0.58
4802,0,48059518,4348,39.86,440181.38,2,48084477,24959,48059518,4348,39.82,91.67,440181.38,0,17.53,18.91,0.56
4803,0,48064030,4512,41.33,440222.72,2,48086733,22703,48064030,4512,41.33,91.66,440222.72,1,17.57,18.91,0.58
4804,0,48068714,4684,42.86,440265.56,2,48089075,20361,48068714,4684,42.90,91.65,440265.56,0,16.65,18.91,0.56
4805,0,48073392,4678,42.86,440308.44,2,48091414,18022,48073392,4678,42.85,91.64,440308.44,1,16.85,18.91,0.58
4806,0,48078508,5116,46.86,440355.28,2,48093972,15464,48078508,5116,46.86,91.63,440355.28,1,16.30,18.91,0.58
4807,0,48085658,7150,65.47,440420.75,2,48097547,11889,48085658,7150,65.49,91.62,440420.75,0,15.62,18.91,0.57
4808,0,48099972,14314,131.12,440551.88,2,48104704,4732,48099972,14314,131.10,91.63,440551.88,1,16.04,18.91,0.59
4809,0,48129221,29249,267.89,440819.78,2,48129221,0,48129221,29249,267.89,91.67,440819.78,0,15.35,18.91,0.58
4810,0,48162258,33037,302.58,441122.34,2,48162258,0,48162258,33037,302.59,91.71,441122.34,1,15.92,18.91,0.60
4811,0,48194480,32222,295.14,441417.50,2,48194480,0,48194480,32222,295.12,91.75,441417.50,0,17.34,18.91,0.60
4812,0,48227216,32736,299.83,441717.31,2,48227216,0,48227216,32736,299.83,91.79,441717.31,1,17.63,18.91,0.62
4813,0,48259792,32576,298.37,442015.69,2,48259792,0,48259792,32576,298.37,91.84,442015.69,0,18.48,18.91,0.61
4814,0,48259792,0,0.00,442015.69,2,48270355,10563,48259792,0,0.00,91.82,442015.69,1,19.80,18.80,0.63
4815,0,48282405,22613,207.11,442222.78,2,48282405,0,48282405,22613,207.11,91.84,442222.78,0,18.77,18.80,0.62
4816,0,48282405,0,0.00,442222.78,2,48292882,10477,48282405,0,0.00,91.82,442222.78,1,19.39,18.39,0.64
4817,0,48282405,0,0.00,442222.78,2,48298851,16446,48282405,0,0.00,91.80,442222.78,0,20.37,19.37,0.61
4818,0,48282405,0,0.00,442222.78,2,48303473,21068,48282405,0,0.00,91.79,442222.78,1,20.66,19.66,0.63
4819,0,48282405,0,0.00,442222.78,2,48307471,25066,48282405,0,0.00,91.77,442222.78,0,21.62,19.00,0.63
4820,0,48282405,0,0.00,442222.78,2,48311057,28652,48282405,0,0.00,91.75,442222.78,1,21.62,19.00,0.65
4821,0,48282405,0,0.00,442222.78,2,48314322,31917,48282405,0,0.00,91.73,442222.78,0,20.16,19.16,0.63
4822,0,48282405,0,0.00,442222.78,2,48317358,34953,48282405,0,0.00,91.71,442222.78,1,20.45,19.45,0.65
4823,0,48282405,0,0.00,442222.78,2,48320133,37728,48282405,0,0.00,91.69,442222.78,0,20.77,19.77,0.63
4824,0,48282405,0,0.00,442222.78,2,48322566,40161,48282405,0,0.00,91.67,442222.78,1,21.05,19.00,0.65
4825,0,48282405,0,0.00,442222.78,2,48324936,42531,48282405,0,0.00,91.65,442222.78,0,19.83,18.83,0.63
4826,0,48282405,0,0.00,442222.78,2,48327235,44830,48282405,0,0.00,91.63,442222.78,1,19.83,18.83,0.65
4827,0,48282405,0,0.00,442222.78,2,48329471,47066,48282405,0,0.00,91.61,442222.78,0,18.91,17.91,0.64
4828,0,48282405,0,0.00,442222.78,2,48331683,49278,48282405,0,0.00,91.60,442222.78,1,18.91,17.91,0.66
4829,0,48286721,4316,39.53,442262.31,2,48333841,47120,48286721,4316,39.53,91.58,442262.31,0,17.05,17.91,0.63
4830,0,48291041,4320,39.57,442301.91,2,48336001,44960,48291041,4320,39.57,91.57,442301.91,1,17.09,17.91,0.65
4831,0,48295413,4372,40.04,442341.94,2,48338187,42774,48295413,4372,40.04,91.56,442341.94,0,16.12,17.91,0.64
4832,0,48299473,4060,37.19,442379.12,2,48340217,40744,48299473,4060,37.19,91.55,442379.12,1,16.35,17.91,0.66
4833,0,48303619,4146,37.99,442417.12,2,48342290,38671,48303619,4146,37.97,91.54,442417.12,0,15.37,17.91,0.65
4834,0,48307747,4128,37.81,442454.91,2,48344354,36607,48307747,4128,37.81,91.53,442454.91,1,15.41,17.91,0.67
4835,0,48311743,3996,36.60,442491.53,2,48346352,34609,48311743,3996,36.60,91.52,442491.53,0,14.39,17.91,0.66
4836,0,48315711,3968,36.34,442527.88,2,48348336,32625,48315711,3968,36.34,91.51,442527.88,1,14.43,17.91,0.68
4837,0,48319653,3942,36.09,442563.94,2,48350307,30654,48319653,3942,36.11,91.50,442563.94,0,13.34,17.91,0.67
4838,0,48323517,3864,35.39,442599.34,2,48352239,28722,48323517,3864,35.39,91.48,442599.34,1,13.37,17.91,0.69
4839,0,48327335,3818,34.99,442634.34,2,48354148,26813,48327335,3818,34.97,91.47,442634.34,0,12.60,17.91,0.69
4840,0,48331125,3790,34.69,442669.03,2,48356043,24918,48331125,3790,34.71,91.46,442669.03,1,12.64,17.91,0.71
4841,0,48334981,3856,35.32,442704.34,2,48357971,22990,48334981,3856,35.32,91.45,442704.34,0,11.57,17.91,0.70
4842,0,48339177,4196,38.43,442742.78,2,48360069,20892,48339177,4196,38.43,91.44,442742.78,1,11.61,17.91,0.72
4843,0,48343633,4456,40.81,442783.59,2,48362297,18664,48343633,4456,40.81,91.43,442783.59,0,10.79,17.91,0.71
4844,0,48348607,4974,45.58,442829.16,2,48364784,16177,48348607,4974,45.56,91.42,442829.16,1,10.83,17.91,0.73
4845,0,48355103,6496,59.50,442888.66,2,48368032,12929,48355103,6496,59.50,91.41,442888.66,0,9.60,17.91,0.72
4846,0,48369555,14452,132.37,443021.03,2,48375258,5703,48369555,14452,132.37,91.42,443021.03,1,9.66,17.91,0.74
4847,0,48399259,29704,272.06,443293.09,2,48399259,0,48399259,29704,272.06,91.46,443293.09,0,10.05,17.91,0.73
4848,0,48432011,32752,299.98,443593.06,2,48432011,0,48432011,32752,299.98,91.50,443593.06,1,11.08,17.91,0.75
4849,0,48464638,32627,298.84,443891.91,2,48464638,0,48464638,32627,298.83,91.54,443891.91,0,12.20,17.91,0.73
4850,0,48497098,32460,297.27,444189.19,2,48497098,0,48497098,32460,297.30,91.59,444189.19,1,14.23,17.91,0.76
4851,0,48529365,32267,295.55,444484.72,2,48529365,0,48529365,32267,295.54,91.63,444484.72,0,17.17,17.91,0.75
4852,0,48529365,0,0.00,444484.72,2,48540056,10691,48529365,0,0.00,91.61,444484.72,0,19.28,18.28,0.77
4853,0,48529365,0,0.00,444484.72,2,48545968,16603,48529365,0,0.00,91.59,444484.72,1,19.50,18.50,0.80
4854,0,48529365,0,0.00,444484.72,2,48550442,21077,48529365,0,0.00,91.57,444484.72,0,20.31,19.31,0.78
4855,0,48529365,0,0.00,444484.72,2,48554616,25251,48529365,0,0.00,91.55,444484.72,1,20.31,19.31,0.80
4856,0,48529365,0,0.00,444484.72,2,48558347,28982,48529365,0,0.00,91.53,444484.72,0,19.35,18.35,0.79
4857,0,48529365,0,0.00,444484.72,2,48561736,32371,48529365,0,0.00,91.51,444484.72,1,19.35,18.35,0.81
4858,0,48529365,0,0.00,444484.72,2,48564879,35514,48529365,0,0.00,91.50,444484.72,0,18.51,17.51,0.81
4859,0,48529365,0,0.00,444484.72,2,48567775,38410,48529365,0,0.00,91.48,444484.72,1,19.60,18.60,0.83
4860,0,48529365,0,0.00,444484.72,2,48570492,41127,48529365,0,0.00,91.46,444484.72,1,18.70,17.70,0.83
4861,0,48529365,0,0.00,444484.72,2,48573076,43711,48529365,0,0.00,91.44,444484.72,0,18.01,17.01,0.82
4862,0,48529365,0,0.00,444484.72,2,48575505,46140,48529365,0,0.00,91.42,444484.72,1,18.72,17.72,0.84
4863,0,48529365,0,0.00,444484.72,2,48577805,48440,48529365,0,0.00,91.40,444484.72,0,17.89,16.89,0.84
4864,0,48529365,0,0.00,444484.72,2,48580123,50758,48529365,0,0.00,91.38,444484.72,1,17.89,16.89,0.86
4865,0,48529365,0,0.00,444484.72,2,48582367,53002,48529365,0,0.00,91.36,444484.72,0,17.01,16.01,0.85
4866,0,48529365,0,0.00,444484.72,2,48584529,55164,48529365,0,0.00,91.34,444484.72,1,17.01,16.01,0.87
4867,0,48529365,0,0.00,444484.72,2,48586613,57248,48529365,0,0.00,91.33,444484.72,0,16.14,15.14,0.86
4868,0,48529365,0,0.00,444484.72,2,48588621,59256,48529365,0,0.00,91.31,444484.72,1,16.44,15.44,0.88
4869,0,48529365,0,0.00,444484.72,2,48590578,61213,48529365,0,0.00,91.29,444484.72,0,15.73,14.73,0.88
4870,0,48529365,0,0.00,444484.72,2,48592484,63119,48529365,0,0.00,91.27,444484.72,1,15.73,14.73,0.90
4871,0,48533113,3748,34.33,444519.06,2,48594358,61245,48533113,3748,34.33,91.26,444519.06,0,14.35,14.73,0.88
4872,0,48536647,3534,32.39,444551.44,2,48596125,59478,48536647,3534,32.37,91.25,444551.44,1,14.39,14.73,0.90
4873,0,48539877,3230,29.57,444581.00,2,48597740,57863,48539877,3230,29.58,91.23,444581.00,0,13.62,14.73,0.90
4874,0,48543097,3220,29.49,444610.50,2,48599350,56253,48543097,3220,29.49,91.22,444610.50,1,13.65,14.73,0.92
4875,0,48546305,3208,29.38,444639.88,2,48600954,54649,48546305,3208,29.38,91.21,444639.88,0,12.44,14.73,0.90
4876,0,48549695,3390,31.07,444670.94,2,48602649,52954,48549695,3390,31.05,91.20,444670.94,1,12.47,14.73,0.92
4877,0,48553075,3380,30.96,444701.91,2,48604339,51264,48553075,3380,30.96,91.18,444701.91,0,11.50,14.73,0.91
4878,0,48556367,3292,30.15,444732.06,2,48605985,49618,48556367,3292,30.15,91.17,444732.06,0,11.53,14.73,0.93
4879,0,48559515,3148,28.83,444760.88,2,48607559,48044,48559515,3148,28.83,91.16,444760.88,1,11.56,14.73,0.95
4880,0,48562553,3038,27.81,444788.69,2,48609078,46525,48562553,3038,27.83,91.15,444788.69,0,10.64,14.73,0.95
4881,0,48565659,3106,28.47,444817.16,2,48610631,44972,48565659,3106,28.45,91.13,444817.16,1,10.67,14.73,0.97
4882,0,48568791,3132,28.69,444845.84,2,48612197,43406,48568791,3132,28.69,91.12,444845.84,0,9.65,14.73,0.96
4883,0,48571925,3134,28.69,444874.53,2,48613764,41839,48571925,3134,28.70,91.11,444874.53,1,9.67,14.73,0.98
4884,0,48575037,3112,28.50,444903.03,2,48615320,40283,48575037,3112,28.50,91.09,444903.03,1,8.69,14.73,0.97
4885,0,48578149,3112,28.50,444931.53,2,48616876,38727,48578149,3112,28.50,91.08,444931.53,0,8.04,14.73,0.97
4886,0,48581257,3108,28.47,444960.00,2,48618430,37173,48581257,3108,28.47,91.07,444960.00,1,8.07,14.73,0.99
4887,0,48584357,3100,28.39,444988.41,2,48619980,35623,48584357,3100,28.39,91.06,444988.41,0,7.12,14.73,0.98
4888,0,48587551,3194,29.27,445017.66,2,48621577,34026,48587551,3194,29.25,91.04,445017.66,1,7.14,14.73,1.00
4889,0,48590775,3224,29.53,445047.19,2,48623189,32414,48590775,3224,29.53,91.03,445047.19,0,6.30,14.73,1.00
4890,0,48594019,3244,29.71,445076.91,2,48624811,30792,48594019,3244,29.71,91.02,445076.91,1,6.33,14.73,1.02
4891,0,48597291,3272,29.97,445106.88,2,48626447,29156,48597291,3272,29.97,91.01,445106.88,0,5.48,14.73,1.01
4892,0,48600743,3452,31.62,445138.50,2,48628173,27430,48600743,3452,31.62,90.99,445138.50,1,5.51,14.73,1.03
4893,0,48604335,3592,32.90,445171.41,2,48629969,25634,48604335,3592,32.90,90.98,445171.41,0,4.61,14.73,1.03
4894,0,48607981,3646,33.38,445204.78,2,48631792,23811,48607981,3646,33.39,90.97,445204.78,1,4.64,14.73,1.05
4895,0,48611847,3866,35.43,445240.19,2,48633725,21878,48611847,3866,35.41,90.96,445240.19,1,3.63,14.73,1.04
4896,0,48615879,4032,36.93,445277.12,2,48635741,19862,48615879,4032,36.93,90.95,445277.12,0,3.24,14.73,1.04
4897,0,48620237,4358,39.90,445317.03,2,48637920,17683,48620237,4358,39.92,90.94,445317.03,1,3.47,14.73,1.06
4898,0,48625367,5130,47.00,445364.03,2,48640485,15118,48625367,5130,46.99,90.93,445364.03,0,3.89,14.73,1.07
4899,0,48633271,7904,72.39,445436.44,2,48644437,11166,48633271,7904,72.39,90.92,445436.44,1,3.94,14.73,1.09
4900,0,48648479,15208,139.29,445575.72,2,48652041,3562,48648479,15208,139.29,90.93,445575.72,0,3.39,14.73,1.09
4901,0,48678016,29537,270.52,445846.25,2,48678016,0,48678016,29537,270.53,90.97,445846.25,0,4.67,14.73,1.11
4902,0,48708953,30937,283.35,446129.59,2,48708953,0,48708953,30937,283.35,91.01,446129.59,1,6.08,14.73,1.13
4903,0,48742634,33681,308.48,446438.06,2,48742634,0,48742634,33681,308.49,91.05,446438.06,0,7.07,14.73,1.11
4904,0,48776104,33470,306.57,446744.62,2,48776104,0,48776104,33470,306.55,91.10,446744.62,1,9.66,14.73,1.13
4905,0,48808596,32492,297.60,447042.22,2,48808596,0,48808596,32492,297.60,91.14,447042.22,0,10.55,14.73,1.11
4906,0,48841264,32668,299.21,447341.44,2,48841264,0,48841264,32668,299.21,91.18,447341.44,1,13.71,14.73,1.13
4907,0,48873682,32418,296.90,447638.34,2,48873682,0,48873682,32418,296.92,91.22,447638.34,0,14.26,14.73,1.09
4908,0,48873682,0,0.00,447638.34,2,48884302,10620,48873682,0,0.00,91.21,447638.34,1,14.82,13.82,1.11
4909,0,48894098,20416,186.99,447825.34,2,48894510,412,48894098,20416,186.99,91.23,447825.34,0,13.22,13.82,1.09
4910,0,48926492,32394,296.72,448122.06,2,48926492,0,48926492,32394,296.70,91.27,448122.06,1,13.40,13.82,1.11
4911,0,48958675,32183,294.78,448416.84,2,48958675,0,48958675,32183,294.77,91.31,448416.84,0,11.42,13.82,1.06
4912,0,48991130,32455,297.23,448714.06,2,48991130,0,48991130,32455,297.26,91.35,448714.06,1,11.71,13.82,1.08
4913,0,49022504,31374,287.38,449001.44,2,49022504,0,49022504,31374,287.36,91.39,449001.44,0,12.28,13.82,1.06
4914,0,49022504,0,0.00,449001.44,2,49032177,9673,49022504,0,0.00,91.37,449001.44,1,14.92,13.92,1.08
4915,0,49043211,20707,189.67,449191.09,2,49043211,0,49043211,20707,189.66,91.39,449191.09,0,13.16,13.92,1.04
4916,0,49043211,0,0.00,449191.09,2,49054452,11241,49043211,0,0.00,91.37,449191.09,1,14.51,13.51,1.06
4917,0,49043211,0,0.00,449191.09,2,49059772,16561,49043211,0,0.00,91.35,449191.09,0,14.66,13.66,1.03
4918,0,49043211,0,0.00,449191.09,2,49064043,20832,49043211,0,0.00,91.34,449191.09,1,15.65,14.65,1.05
4919,0,49051333,8122,74.37,449265.47,2,49068104,16771,49051333,8122,74.39,91.33,449265.47,0,13.80,14.65,1.01
4920,0,49059775,8442,77.34,449342.81,2,49072325,12550,49059775,8442,77.32,91.33,449342.81,1,14.39,14.65,1.03
4921,0,49073383,13608,124.64,449467.44,2,49079129,5746,49073383,13608,124.64,91.34,449467.44,0,13.24,14.65,0.99
4922,0,49103020,29637,271.44,449738.88,2,49103020,0,49103020,29637,271.45,91.37,449738.88,1,13.87,14.65,1.01
4923,0,49135064,32044,293.49,450032.38,2,49135064,0,49135064,32044,293.49,91.41,450032.38,0,13.44,14.65,0.98
4924,0,49135064,0,0.00,450032.38,2,49145542,10478,49135064,0,0.00,91.40,450032.38,1,16.62,15.62,1.00
4925,0,49155250,20186,184.87,450217.25,2,49155635,385,49155250,20186,184.89,91.41,450217.25,0,14.99,15.62,0.95
4926,0,49155250,0,0.00,450217.25,2,49165713,10463,49155250,0,0.00,91.40,450217.25,1,17.59,16.59,0.97
4927,0,49175686,20436,187.21,450404.47,2,49175931,245,49175686,20436,187.18,91.42,450404.47,0,15.93,16.59,0.95
4928,0,49175686,0,0.00,450404.47,2,49186383,10697,49175686,0,0.00,91.40,450404.47,1,18.12,17.12,0.97
4929,0,49194988,19302,176.77,450581.22,2,49196034,1046,49194988,19302,176.79,91.41,450581.22,0,16.11,17.12,0.93
4930,0,49194988,0,0.00,450581.22,2,49206068,11080,49194988,0,0.00,91.40,450581.22,1,17.14,16.14,0.95
4931,0,49194988,0,0.00,450581.22,2,49211579,16591,49194988,0,0.00,91.38,450581.22,0,16.36,15.36,0.92
4932,0,49194988,0,0.00,450581.22,2,49214953,19965,49194988,0,0.00,91.36,450581.22,1,16.93,15.93,0.94
4933,0,49194988,0,0.00,450581.22,2,49217669,22681,49194988,0,0.00,91.34,450581.22,0,16.58,15.58,0.91
4934,0,49194988,0,0.00,450581.22,2,49220156,25168,49194988,0,0.00,91.32,450581.22,1,16.58,15.58,0.93
4935,0,49200382,5394,49.42,450630.66,2,49222853,22471,49200382,5394,49.40,91.31,450630.66,0,14.61,15.58,0.89
4936,0,49206750,6368,58.33,450688.97,2,49226037,19287,49206750,6368,58.33,91.31,450688.97,1,14.66,15.58,0.91
4937,0,49213662,6912,63.31,450752.28,2,49229493,15831,49213662,6912,63.31,91.30,450752.28,0,13.91,15.58,0.90
4938,0,49221336,7674,70.27,450822.56,2,49233330,11994,49221336,7674,70.29,91.30,450822.56,1,15.40,15.58,0.92
4939,0,49236358,15022,137.61,450960.16,2,49240841,4483,49236358,15022,137.59,91.31,450960.16,0,13.96,15.58,0.89
4940,0,49266536,30178,276.38,451236.53,2,49266536,0,49266536,30178,276.40,91.34,451236.53,1,14.09,15.58,0.91
4941,0,49298355,31819,291.44,451528.00,2,49298355,0,49298355,31819,291.43,91.38,451528.00,1,15.56,15.58,0.91
4942,0,49298355,0,0.00,451528.00,2,49309186,10831,49298355,0,0.00,91.37,451528.00,0,17.05,16.05,0.90
4943,0,49298355,0,0.00,451528.00,2,49314808,16453,49298355,0,0.00,91.35,451528.00,1,18.04,17.04,0.92
4944,0,49308219,9864,90.35,451618.34,2,49319740,11521,49308219,9864,90.35,91.35,451618.34,0,16.80,17.04,0.91
4945,0,49325097,16878,154.57,451772.91,2,49328179,3082,49325097,16878,154.59,91.36,451772.91,1,16.89,17.04,0.93
4946,0,49356768,31671,290.09,452063.00,2,49356768,0,49356768,31671,290.08,91.40,452063.00,0,17.00,17.04,0.92
4947,0,49356768,0,0.00,452063.00,2,49367195,10427,49356768,0,0.00,91.38,452063.00,0,18.04,17.04,0.94
4948,0,49356768,0,0.00,452063.00,2,49373154,16386,49356768,0,0.00,91.36,452063.00,1,18.82,17.82,0.96
4949,0,49356768,0,0.00,452063.00,2,49377584,20816,49356768,0,0.00,91.34,452063.00,0,18.18,17.18,0.94
4950,0,49356768,0,0.00,452063.00,2,49381309,24541,49356768,0,0.00,91.33,452063.00,1,18.34,17.34,0.96
4951,0,49356768,0,0.00,452063.00,2,49384713,27945,49356768,0,0.00,91.31,452063.00,0,18.01,17.01,0.93
4952,0,49356768,0,0.00,452063.00,2,49387970,31202,49356768,0,0.00,91.29,452063.00,1,18.01,17.01,0.95
4953,0,49356768,0,0.00,452063.00,2,49391010,34242,49356768,0,0.00,91.27,452063.00,0,17.20,16.20,0.94
4954,0,49356768,0,0.00,452063.00,2,49393847,37079,49356768,0,0.00,91.25,452063.00,1,17.89,16.89,0.96
4955,0,49356768,0,0.00,452063.00,2,49396500,39732,49356768,0,0.00,91.23,452063.00,0,17.06,16.06,0.94
4956,0,49356768,0,0.00,452063.00,2,49399007,42239,49356768,0,0.00,91.22,452063.00,1,17.48,16.48,0.96
4957,0,49361710,4942,45.28,452108.28,2,49401478,39768,49361710,4942,45.26,91.21,452108.28,0,15.98,16.48,0.94
4958,0,49366594,4884,44.70,452152.97,2,49403920,37326,49366594,4884,44.73,91.20,452152.97,1,16.02,16.48,0.96
4959,0,49371402,4808,44.04,452197.00,2,49406324,34922,49371402,4808,44.04,91.19,452197.00,0,15.19,16.48,0.95
4960,0,49375932,4530,41.51,452238.50,2,49408589,32657,49375932,4530,41.49,91.18,452238.50,1,15.38,16.48,0.97
4961,0,49380336,4404,40.34,452278.84,2,49410791,30455,49380336,4404,40.34,91.17,452278.84,0,14.18,16.48,0.95
4962,0,49384922,4586,41.99,452320.84,2,49413084,28162,49384922,4586,42.00,91.16,452320.84,1,14.32,16.48,0.97
4963,0,49389544,4622,42.35,452363.19,2,49415395,25851,49389544,4622,42.33,91.15,452363.19,0,13.55,16.48,0.96
4964,0,49394136,4592,42.06,452405.25,2,49417691,23555,49394136,4592,42.06,91.14,452405.25,1,13.59,16.48,0.98
4965,0,49398546,4410,40.37,452445.62,2,49419896,21350,49398546,4410,40.39,91.13,452445.62,0,12.41,16.48,0.97
4966,0,49403056,4510,41.33,452486.94,2,49422151,19095,49403056,4510,41.31,91.12,452486.94,1,12.45,16.48,0.99
4967,0,49408032,4976,45.58,452532.53,2,49424639,16607,49408032,4976,45.58,91.11,452532.53,1,11.07,16.48,0.97
4968,0,49413814,5782,52.98,452585.50,2,49427530,13716,49413814,5782,52.96,91.10,452585.50,0,10.55,16.48,0.97
4969,0,49425516,11702,107.16,452692.66,2,49433381,7865,49425516,11702,107.18,91.10,452692.66,0,10.60,16.48,0.99
4970,0,49450033,24517,224.54,452917.19,2,49450033,0,49450033,24517,224.55,91.13,452917.19,1,12.01,16.48,1.01
4971,0,49482206,32173,294.70,453211.91,2,49482206,0,49482206,32173,294.68,91.17,453211.91,1,11.42,16.48,0.99
4972,0,49514852,32646,298.99,453510.91,2,49514852,0,49514852,32646,299.01,91.21,453510.91,0,11.07,16.48,0.99
4973,0,49546960,32108,294.08,453804.97,2,49546960,0,49546960,32108,294.08,91.25,453804.97,0,12.56,16.48,1.01
4974,0,49578824,31864,291.85,454096.81,2,49578824,0,49578824,31864,291.85,91.29,454096.81,1,14.35,16.48,1.03
4975,0,49611584,32760,300.05,454396.88,2,49611584,0,49611584,32760,300.05,91.34,454396.88,0,13.59,16.48,1.01
4976,0,49644205,32621,298.77,454695.62,2,49644205,0,49644205,32621,298.78,91.38,454695.62,1,14.55,16.48,1.03
4977,0,49644205,0,0.00,454695.62,2,49654879,10674,49644205,0,0.00,91.36,454695.62,0,17.99,16.99,1.03
4978,0,49644205,0,0.00,454695.62,2,49660577,16372,49644205,0,0.00,91.34,454695.62,0,18.16,17.16,1.05
4979,0,49644205,0,0.00,454695.62,2,49664924,20719,49644205,0,0.00,91.32,454695.62,1,18.61,17.61,1.07
4980,0,49644205,0,0.00,454695.62,2,49668638,24433,49644205,0,0.00,91.30,454695.62,0,18.74,17.74,1.06
4981,0,49644205,0,0.00,454695.62,2,49672125,27920,49644205,0,0.00,91.29,454695.62,1,18.74,17.74,1.08
4982,0,49644205,0,0.00,454695.62,2,49675402,31197,49644205,0,0.00,91.27,454695.62,1,17.78,16.78,1.07
4983,0,49644205,0,0.00,454695.62,2,49678431,34226,49644205,0,0.00,91.25,454695.62,0,17.03,16.03,1.07
4984,0,49644205,0,0.00,454695.62,2,49681286,37081,49644205,0,0.00,91.23,454695.62,1,17.03,16.03,1.09
4985,0,49644205,0,0.00,454695.62,2,49683970,39765,49644205,0,0.00,91.21,454695.62,0,16.36,15.36,1.08
4986,0,49644205,0,0.00,454695.62,2,49686507,42302,49644205,0,0.00,91.19,454695.62,1,16.36,15.36,1.10
4987,0,49648931,4726,43.30,454738.94,2,49688870,39939,49648931,4726,43.29,91.18,454738.94,0,15.12,15.36,1.09
4988,0,49653591,4660,42.68,454781.62,2,49691200,37609,49653591,4660,42.68,91.18,454781.62,1,15.16,15.36,1.11
4989,0,49658239,4648,42.57,454824.19,2,49693524,35285,49658239,4648,42.57,91.17,454824.19,0,14.27,15.36,1.10
4990,0,49662857,4618,42.28,454866.47,2,49695833,32976,49662857,4618,42.30,91.16,454866.47,1,14.33,15.36,1.12
4991,0,49667393,4536,41.55,454908.03,2,49698101,30708,49667393,4536,41.55,91.15,454908.03,0,12.75,15.36,1.10
4992,0,49672021,4628,42.39,454950.41,2,49700415,28394,49672021,4628,42.39,91.14,454950.41,1,12.79,15.36,1.12
4993,0,49676749,4728,43.30,454993.72,2,49702779,26030,49676749,4728,43.30,91.13,454993.72,0,12.20,15.36,1.12
4994,0,49681443,4694,43.01,455036.72,2,49705126,23683,49681443,4694,42.99,91.12,455036.72,1,12.24,15.36,1.14
4995,0,49686015,4572,41.88,455078.59,2,49707412,21397,49686015,4572,41.88,91.11,455078.59,0,10.77,15.36,1.12
4996,0,49690819,4804,44.00,455122.59,2,49709814,18995,49690819,4804,44.00,91.10,455122.59,1,10.81,15.36,1.14
4997,0,49695979,5160,47.26,455169.88,2,49712394,16415,49695979,5160,47.26,91.09,455169.88,0,10.15,15.36,1.14
4998,0,49702011,6032,55.25,455225.09,2,49715410,13399,49702011,6032,55.25,91.08,455225.09,0,10.20,15.36,1.16
4999,0,49714363,12352,113.13,455338.25,2,49721586,7223,49714363,12352,113.13,91.09,455338.25,1,10.25,15.36,1.18
5000,0,49740442,26079,238.83,455577.06,2,49740442,0,49740442,26079,238.86,91.12,455577.06,0,10.15,15.36,1.16
5001,0,49773376,32934,301.66,455878.75,2,49773376,0,49773376,32934,301.65,91.16,455878.75,1,11.41,15.36,1.18
5002,0,49805439,32063,293.68,456172.41,2,49805439,0,49805439,32063,293.67,91.20,456172.41,0,13.57,15.36,1.18
5003,0,49805439,0,0.00,456172.41,2,49816098,10659,49805439,0,0.00,91.18,456172.41,1,15.95,14.95,1.20
5004,0,49805439,0,0.00,456172.41,2,49822239,16800,49805439,0,0.00,91.16,456172.41,0,15.00,14.00,1.19
5005,0,49805439,0,0.00,456172.41,2,49826625,21186,49805439,0,0.00,91.14,456172.41,1,16.71,15.71,1.21
5006,0,49805439,0,0.00,456172.41,2,49830490,25051,49805439,0,0.00,91.13,456172.41,1,16.33,15.33,1.21
5007,0,49805439,0,0.00,456172.41,2,49834081,28642,49805439,0,0.00,91.11,456172.41,0,15.57,14.57,1.21
5008,0,49805439,0,0.00,456172.41,2,49837349,31910,49805439,0,0.00,91.09,456172.41,1,15.57,14.57,1.23
5009,0,49805439,0,0.00,456172.41,2,49840363,34924,49805439,0,0.00,91.07,456172.41,0,15.00,14.00,1.23
5010,0,49805439,0,0.00,456172.41,2,49843152,37713,49805439,0,0.00,91.05,456172.41,1,16.79,15.79,1.25
5011,0,49805439,0,0.00,456172.41,2,49845759,40320,49805439,0,0.00,91.03,456172.41,0,16.05,15.05,1.24
5012,0,49805439,0,0.00,456172.41,2,49848222,42783,49805439,0,0.00,91.02,456172.41,1,16.41,15.41,1.26
5013,0,49810213,4774,43.71,456216.12,2,49850609,40396,49810213,4774,43.73,91.01,456216.12,0,15.40,15.41,1.25
5014,0,49810213,0,0.00,456216.12,2,49852917,42704,49810213,0,0.00,90.99,456216.12,1,15.44,14.44,1.27
5015,0,49810213,0,0.00,456216.12,2,49855097,44884,49810213,0,0.00,90.97,456216.12,0,14.81,13.81,1.27
5016,0,49810213,0,0.00,456216.12,2,49857033,46820,49810213,0,0.00,90.95,456216.12,1,15.06,14.06,1.29
5017,0,49810213,0,0.00,456216.12,2,49858867,48654,49810213,0,0.00,90.93,456216.12,0,14.86,13.86,1.28
5018,0,49810213,0,0.00,456216.12,2,49860761,50548,49810213,0,0.00,90.92,456216.12,1,14.86,13.86,1.30
5019,0,49810213,0,0.00,456216.12,2,49862611,52398,49810213,0,0.00,90.90,456216.12,0,14.26,13.26,1.30
5020,0,49810213,0,0.00,456216.12,2,49864411,54198,49810213,0,0.00,90.88,456216.12,1,14.26,13.26,1.32
5021,0,49813751,3538,32.42,456248.53,2,49866180,52429,49813751,3538,32.40,90.87,456248.53,1,12.99,13.26,1.31
5022,0,49813751,0,0.00,456248.53,2,49867926,54175,49813751,0,0.00,90.85,456248.53,0,13.38,12.38,1.30
5023,0,49813751,0,0.00,456248.53,2,49869597,55846,49813751,0,0.00,90.83,456248.53,1,13.38,12.38,1.32
5024,0,49813751,0,0.00,456248.53,2,49871215,57464,49813751,0,0.00,90.81,456248.53,0,12.81,11.81,1.32
5025,0,49813751,0,0.00,456248.53,2,49872797,59046,49813751,0,0.00,90.80,456248.53,1,13.09,12.09,1.34
5026,0,49813751,0,0.00,456248.53,2,49874343,60592,49813751,0,0.00,90.78,456248.53,0,13.11,12.11,1.33
5027,0,49813751,0,0.00,456248.53,2,49875861,62110,49813751,0,0.00,90.76,456248.53,1,13.11,12.11,1.34
5028,0,49816597,2846,26.05,456274.59,2,49877284,60687,49816597,2846,26.07,90.75,456274.59,0,11.61,12.11,1.32
5029,0,49819471,2874,26.34,456300.94,2,49878721,59250,49819471,2874,26.32,90.73,456300.94,1,11.63,12.11,1.34
5030,0,49822435,2964,27.15,456328.09,2,49880203,57768,49822435,2964,27.15,90.72,456328.09,0,9.99,12.11,1.32
5031,0,49825389,2954,27.04,456355.12,2,49881680,56291,49825389,2954,27.06,90.71,456355.12,0,10.02,12.11,1.34
5032,0,49828339,2950,27.04,456382.16,2,49883155,54816,49828339,2950,27.02,90.70,456382.16,1,10.05,12.11,1.36
5033,0,49831291,2952,27.04,456409.19,2,49884631,53340,49831291,2952,27.04,90.68,456409.19,1,8.62,12.11,1.33
5034,0,49834241,2950,27.00,456436.19,2,49886106,51865,49834241,2950,27.02,90.67,456436.19,0,7.83,12.11,1.32
5035,0,49837153,2912,26.67,456462.88,2,49887562,50409,49837153,2912,26.67,90.66,456462.88,0,7.85,12.11,1.34
5036,0,49839895,2742,25.13,456488.00,2,49888933,49038,49839895,2742,25.11,90.64,456488.00,1,8.44,12.11,1.36
5037,0,49842703,2808,25.72,456513.72,2,49890337,47634,49842703,2808,25.72,90.63,456513.72,0,8.36,12.11,1.36
5038,0,49845451,2748,25.17,456538.88,2,49891711,46260,49845451,2748,25.17,90.62,456538.88,0,8.81,12.11,1.37
5039,0,49848221,2770,25.35,456564.25,2,49893096,44875,49848221,2770,25.37,90.61,456564.25,1,8.83,12.11,1.39
5040,0,49850997,2776,25.43,456589.66,2,49894484,43487,49850997,2776,25.43,90.59,456589.66,0,7.98,12.11,1.39
5041,0,49853845,2848,26.09,456615.75,2,49895908,42063,49853845,2848,26.09,90.58,456615.75,1,8.00,12.11,1.41
5042,0,49856725,2880,26.38,456642.12,2,49897348,40623,49856725,2880,26.38,90.57,456642.12,0,6.98,12.11,1.40
5043,0,49859667,2942,26.96,456669.09,2,49898819,39152,49859667,2942,26.95,90.56,456669.09,1,7.01,12.11,1.42
5044,0,49862697,3030,27.73,456696.81,2,49900334,37637,49862697,3030,27.75,90.54,456696.81,0,5.98,12.11,1.41
5045,0,49865711,3014,27.62,456724.44,2,49901841,36130,49865711,3014,27.61,90.53,456724.44,1,6.01,12.11,1.43
5046,0,49868783,3072,28.14,456752.59,2,49903377,34594,49868783,3072,28.14,90.52,456752.59,1,4.83,12.11,1.40
5047,0,49871889,3106,28.43,456781.03,2,49904930,33041,49871889,3106,28.45,90.51,456781.03,0,3.89,12.11,1.39
5048,0,49874971,3082,28.25,456809.25,2,49906471,31500,49874971,3082,28.23,90.49,456809.25,1,3.92,12.11,1.41
5049,0,49877983,3012,27.59,456836.84,2,49907977,29994,49877983,3012,27.59,90.48,456836.84,0,3.92,12.11,1.41
5050,0,49881113,3130,28.65,456865.50,2,49909542,28429,49881113,3130,28.67,90.47,456865.50,1,3.95,12.11,1.43
5051,0,49884437,3324,30.44,456895.94,2,49911204,26767,49884437,3324,30.44,90.46,456895.94,0,3.45,12.11,1.43
5052,0,49887845,3408,31.21,456927.16,2,49912908,25063,49887845,3408,31.21,90.44,456927.16,1,3.74,12.11,1.45
5053,0,49891401,3556,32.57,456959.72,2,49914686,23285,49891401,3556,32.57,90.43,456959.72,0,2.62,12.11,1.44
5054,0,49895115,3714,34.04,456993.75,2,49916543,21428,49895115,3714,34.02,90.42,456993.75,1,2.65,12.11,1.45
5055,0,49898973,3858,35.32,457029.09,2,49918472,19499,49898973,3858,35.34,90.41,457029.09,0,1.96,12.11,1.45
5056,0,49903341,4368,40.01,457069.09,2,49920656,17315,49903341,4368,40.01,90.40,457069.09,0,2.00,12.11,1.47
5057,0,49909281,5940,54.40,457123.50,2,49923626,14345,49909281,5940,54.40,90.39,457123.50,0,2.04,12.11,1.49
5058,0,49920887,11606,106.32,457229.81,2,49929429,8542,49920887,11606,106.30,90.40,457229.81,1,2.09,12.11,1.51
5059,0,49944802,23915,219.01,457448.81,2,49944802,0,49944802,23915,219.04,90.42,457448.81,0,0.84,12.11,1.49
5060,0,49979211,34409,315.18,457764.00,2,49979211,0,49979211,34409,315.16,90.47,457764.00,1,1.05,12.11,1.51
5061,0,50013482,34271,313.86,458077.88,2,50013482,0,50013482,34271,313.89,90.51,458077.88,0,1.15,12.11,1.52
5062,0,50047720,34238,313.61,458391.47,2,50047720,0,50047720,34238,313.59,90.56,458391.47,1,4.24,12.11,1.54
5063,0,50081998,34278,313.97,458705.44,2,50081998,0,50081998,34278,313.96,90.60,458705.44,0,4.38,12.11,1.52
5064,0,50115870,33872,310.24,459015.69,2,50115870,0,50115870,33872,310.24,90.64,459015.69,1,7.06,12.11,1.54
5065,0,50149725,33855,310.05,459325.75,2,50149725,0,50149725,33855,310.08,90.69,459325.75,1,7.63,12.11,1.52
5066,0,50183836,34111,312.43,459638.19,2,50183836,0,50183836,34111,312.43,90.73,459638.19,0,6.65,12.11,1.50
5067,0,50217870,34034,311.74,459949.91,2,50217870,0,50217870,34034,311.72,90.77,459949.91,1,6.96,12.11,1.52
5068,0,50252298,34428,315.29,460265.22,2,50252298,0,50252298,34428,315.33,90.82,460265.22,0,7.56,12.11,1.50
5069,0,50286197,33899,310.49,460575.69,2,50286197,0,50286197,33899,310.48,90.86,460575.69,1,8.25,12.11,1.52
5070,0,50319869,33672,308.40,460884.09,2,50319869,0,50319869,33672,308.40,90.90,460884.09,1,9.03,12.11,1.51
5071,0,50352719,32850,300.89,461185.00,2,50352719,0,50352719,32850,300.88,90.95,461185.00,0,10.16,12.11,1.50
5072,0,50352719,0,0.00,461185.00,2,50363234,10515,50352719,0,0.00,90.93,461185.00,1,12.46,11.46,1.52
5073,0,50352719,0,0.00,461185.00,2,50368791,16072,50352719,0,0.00,90.91,461185.00,0,11.68,10.68,1.50
5074,0,50352719,0,0.00,461185.00,2,50373051,20332,50352719,0,0.00,90.89,461185.00,1,13.11,12.11,1.52
5075,0,50360921,8202,75.10,461260.09,2,50377152,16231,50360921,8202,75.12,90.89,461260.09,0,11.87,12.11,1.50
5076,0,50360921,0,0.00,461260.09,2,50380999,20078,50360921,0,0.00,90.87,461260.09,1,12.23,11.23,1.52
5077,0,50360921,0,0.00,461260.09,2,50384324,23403,50360921,0,0.00,90.85,461260.09,0,12.26,11.26,1.50
5078,0,50360921,0,0.00,461260.09,2,50387311,26390,50360921,0,0.00,90.83,461260.09,0,12.57,11.57,1.52
5079,0,50360921,0,0.00,461260.09,2,50390098,29177,50360921,0,0.00,90.82,461260.09,1,12.57,11.57,1.54
5080,0,50366235,5314,48.69,461308.78,2,50392755,26520,50366235,5314,48.67,90.81,461308.78,1,10.87,11.57,1.51
5081,0,50371571,5336,48.87,461357.66,2,50395423,23852,50371571,5336,48.87,90.80,461357.66,0,9.67,11.57,1.50
5082,0,50376801,5230,47.88,461405.56,2,50398038,21237,50376801,5230,47.90,90.79,461405.56,1,10.59,11.57,1.52
5083,0,50382149,5348,48.98,461454.53,2,50400712,18563,50382149,5348,48.98,90.78,461454.53,0,10.52,11.57,1.51
5084,0,50387843,5694,52.17,461506.72,2,50403559,15716,50387843,5694,52.15,90.78,461506.72,1,10.87,11.57,1.53
5085,0,50394747,6904,63.23,461569.94,2,50407011,12264,50394747,6904,63.23,90.77,461569.94,0,10.16,11.57,1.53
5086,0,50410623,15876,145.41,461715.34,2,50414949,4326,50410623,15876,145.41,90.78,461715.34,1,10.22,11.57,1.55
5087,0,50441260,30637,280.60,461995.94,2,50441260,0,50441260,30637,280.61,90.82,461995.94,0,9.81,11.57,1.54
5088,0,50441260,0,0.00,461995.94,2,50451538,10278,50441260,0,0.00,90.80,461995.94,1,13.44,12.44,1.56
5089,0,50441260,0,0.00,461995.94,2,50457400,16140,50441260,0,0.00,90.78,461995.94,0,12.52,11.52,1.54
5090,0,50441260,0,0.00,461995.94,2,50461935,20675,50441260,0,0.00,90.77,461995.94,1,14.23,13.23,1.56
5091,0,50449226,7966,72.94,462068.88,2,50465918,16692,50449226,7966,72.96,90.76,462068.88,0,12.38,13.23,1.53
5092,0,50457466,8240,75.47,462144.38,2,50470038,12572,50457466,8240,75.47,90.76,462144.38,1,12.46,13.23,1.55
5093,0,50469822,12356,113.21,462257.56,2,50476216,6394,50469822,12356,113.17,90.76,462257.56,0,12.28,13.23,1.55
5094,0,50469822,0,0.00,462257.56,2,50483826,14004,50469822,0,0.00,90.75,462257.56,1,13.82,12.82,1.57
5095,0,50469822,0,0.00,462257.56,2,50488254,18432,50469822,0,0.00,90.73,462257.56,0,13.15,12.15,1.54
5096,0,50469822,0,0.00,462257.56,2,50491184,21362,50469822,0,0.00,90.71,462257.56,1,14.15,13.15,1.56
5097,0,50475640,5818,53.27,462310.84,2,50494093,18453,50475640,5818,53.29,90.70,462310.84,0,13.14,13.15,1.54
5098,0,50475640,0,0.00,462310.84,2,50496949,21309,50475640,0,0.00,90.68,462310.84,0,13.30,12.30,1.56
5099,0,50475640,0,0.00,462310.84,2,50499134,23494,50475640,0,0.00,90.67,462310.84,1,13.30,12.30,1.58
5100,0,50480278,4638,42.50,462353.34,2,50501453,21175,50480278,4638,42.48,90.66,462353.34,1,12.09,12.30,1.57
5101,0,50486016,5738,52.54,462405.88,2,50504322,18306,50486016,5738,52.55,90.65,462405.88,0,11.10,12.30,1.56
5102,0,50486016,0,0.00,462405.88,2,50507173,21157,50486016,0,0.00,90.63,462405.88,1,12.74,11.74,1.58
5103,0,50486016,0,0.00,462405.88,2,50509542,23526,50486016,0,0.00,90.61,462405.88,0,11.77,10.77,1.57
5104,0,50486016,0,0.00,462405.88,2,50511615,25599,50486016,0,0.00,90.60,462405.88,1,12.01,11.01,1.59
5105,0,50490176,4160,38.10,462443.97,2,50513695,23519,50490176,4160,38.10,90.59,462443.97,0,10.99,11.01,1.58
5106,0,50490176,0,0.00,462443.97,2,50515800,25624,50490176,0,0.00,90.57,462443.97,1,11.03,10.03,1.60
5107,0,50490176,0,0.00,462443.97,2,50517729,27553,50490176,0,0.00,90.55,462443.97,1,10.07,9.07,1.60
5108,0,50490176,0,0.00,462443.97,2,50519556,29380,50490176,0,0.00,90.53,462443.97,0,9.75,8.75,1.61
5109,0,50490176,0,0.00,462443.97,2,50521302,31126,50490176,0,0.00,90.52,462443.97,1,11.22,10.22,1.62
5110,0,50490176,0,0.00,462443.97,2,50522995,32819,50490176,0,0.00,90.50,462443.97,0,11.01,10.01,1.63
5111,0,50490176,0,0.00,462443.97,2,50524634,34458,50490176,0,0.00,90.48,462443.97,1,11.01,10.01,1.65
5112,0,50490176,0,0.00,462443.97,2,50526233,36057,50490176,0,0.00,90.46,462443.97,0,10.52,9.52,1.66
5113,0,50490176,0,0.00,462443.97,2,50527781,37605,50490176,0,0.00,90.44,462443.97,1,10.83,9.83,1.67
5114,0,50490176,0,0.00,462443.97,2,50529229,39053,50490176,0,0.00,90.43,462443.97,1,10.40,9.40,1.68
5115,0,50490176,0,0.00,462443.97,2,50530641,40465,50490176,0,0.00,90.41,462443.97,0,10.24,9.24,1.70
5116,0,50490176,0,0.00,462443.97,2,50532035,41859,50490176,0,0.00,90.39,462443.97,0,10.24,9.24,1.72
5117,0,50490176,0,0.00,462443.97,2,50533446,43270,50490176,0,0.00,90.37,462443.97,0,10.24,9.24,1.73
5118,0,50490176,0,0.00,462443.97,2,50534861,44685,50490176,0,0.00,90.36,462443.97,1,10.24,9.24,1.75
5119,0,50490176,0,0.00,462443.97,2,50536257,46081,50490176,0,0.00,90.34,462443.97,1,9.71,8.71,1.75
5120,0,50490176,0,0.00,462443.97,2,50537633,47457,50490176,0,0.00,90.32,462443.97,0,8.93,8.00,1.74
5121,0,50492920,2744,25.13,462469.09,2,50539005,46085,50492920,2744,25.13,90.31,462469.09,1,8.93,9.93,1.76
5122,0,50495764,2844,26.05,462495.16,2,50540427,44663,50495764,2844,26.05,90.30,462495.16,0,9.22,9.93,1.77
5123,0,50498582,2818,25.83,462520.97,2,50541836,43254,50498582,2818,25.81,90.28,462520.97,1,9.60,9.93,1.79
5124,0,50501462,2880,26.38,462547.38,2,50543276,41814,50501462,2880,26.38,90.27,462547.38,0,9.27,9.93,1.79
5125,0,50504462,3000,27.48,462574.84,2,50544776,40314,50504462,3000,27.48,90.26,462574.84,1,9.30,9.93,1.81
5126,0,50507600,3138,28.72,462603.56,2,50546345,38745,50507600,3138,28.74,90.25,462603.56,0,8.40,9.93,1.80
5127,0,50510892,3292,30.15,462633.72,2,50547991,37099,50510892,3292,30.15,90.23,462633.72,0,8.78,9.93,1.82
5128,0,50514402,3510,32.13,462665.84,2,50549746,35344,50514402,3510,32.15,90.22,462665.84,1,8.96,9.93,1.84
5129,0,50518038,3636,33.34,462699.19,2,50551564,33526,50518038,3636,33.30,90.21,462699.19,0,7.78,9.93,1.82
5130,0,50521780,3742,34.25,462733.44,2,50553435,31655,50521780,3742,34.27,90.20,462733.44,1,8.98,9.93,1.84
5131,0,50525546,3766,34.47,462767.91,2,50555318,29772,50525546,3766,34.49,90.19,462767.91,0,7.64,9.93,1.82
5132,0,50529130,3584,32.83,462800.75,2,50557110,27980,50529130,3584,32.83,90.18,462800.75,1,7.68,9.93,1.84
5133,0,50532692,3562,32.64,462833.38,2,50558891,26199,50532692,3562,32.62,90.17,462833.38,0,6.67,9.93,1.83
5134,0,50536182,3490,31.98,462865.38,2,50560636,24454,50536182,3490,31.97,90.16,462865.38,1,6.70,9.93,1.85
5135,0,50539742,3560,32.61,462897.97,2,50562416,22674,50539742,3560,32.61,90.15,462897.97,0,4.85,9.93,1.82
5136,0,50543580,3838,35.13,462933.09,2,50564335,20755,50543580,3838,35.15,90.13,462933.09,1,4.88,9.93,1.84
5137,0,50547794,4214,38.58,462971.69,2,50566442,18648,50547794,4214,38.60,90.12,462971.69,0,4.56,9.93,1.84
5138,0,50552618,4824,44.18,463015.88,2,50568854,16236,50552618,4824,44.18,90.12,463015.88,1,5.17,9.93,1.86
5139,0,50558532,5914,54.19,463070.06,2,50571811,13279,50558532,5914,54.17,90.11,463070.06,1,5.23,9.93,1.85
5140,0,50571192,12660,115.95,463186.00,2,50578141,6949,50571192,12660,115.95,90.11,463186.00,0,4.40,9.93,1.84
5141,0,50597956,26764,245.13,463431.12,2,50597956,0,50597956,26764,245.13,90.14,463431.12,1,4.51,9.93,1.86
5142,0,50632090,34134,312.62,463743.75,2,50632090,0,50632090,34134,312.64,90.19,463743.75,0,5.65,9.93,1.85
5143,0,50666162,34072,312.07,464055.81,2,50666162,0,50666162,34072,312.07,90.23,464055.81,1,6.37,9.93,1.87
5144,0,50699076,32914,301.48,464357.31,2,50699076,0,50699076,32914,301.46,90.27,464357.31,0,5.59,9.93,1.85
5145,0,50732056,32980,302.07,464659.38,2,50732056,0,50732056,32980,302.07,90.31,464659.38,0,7.83,9.93,1.87
5146,0,50764704,32648,299.03,464958.41,2,50764704,0,50764704,32648,299.03,90.35,464958.41,1,9.56,9.93,1.89
5147,0,50799357,34653,317.38,465275.78,2,50799357,0,50799357,34653,317.39,90.40,465275.78,0,7.96,9.93,1.86
5148,0,50799357,0,0.00,465275.78,2,50810198,10841,50799357,0,0.00,90.38,465275.78,1,10.27,9.27,1.88
5149,0,50819555,20198,185.01,465460.78,2,50820297,742,50819555,20198,185.00,90.40,465460.78,0,8.17,9.27,1.84
5150,0,50854230,34675,317.60,465778.41,2,50854230,0,50854230,34675,317.59,90.44,465778.41,1,8.35,9.27,1.86
5151,0,50888589,34359,314.67,466093.06,2,50888589,0,50888589,34359,314.70,90.49,466093.06,0,8.86,9.27,1.83
5152,0,50888589,0,0.00,466093.06,2,50899646,11057,50888589,0,0.00,90.47,466093.06,1,9.87,8.87,1.85
5153,0,50910163,21574,197.62,466290.69,2,50910433,270,50910163,21574,197.60,90.49,466290.69,0,8.02,8.87,1.82
5154,0,50910163,0,0.00,466290.69,2,50920914,10751,50910163,0,0.00,90.47,466290.69,1,9.50,8.50,1.84
5155,0,50931255,21092,193.18,466483.88,2,50931460,205,50931255,21092,193.18,90.49,466483.88,0,8.03,8.50,1.80
5156,0,50966639,35384,324.09,466807.94,2,50966639,0,50966639,35384,324.09,90.54,466807.94,1,8.22,8.50,1.82
5157,0,50966639,0,0.00,466807.94,2,50977562,10923,50966639,0,0.00,90.52,466807.94,0,9.71,8.71,1.79
5158,0,50966639,0,0.00,466807.94,2,50983106,16467,50966639,0,0.00,90.50,466807.94,0,12.12,11.12,1.81
5159,0,50966639,0,0.00,466807.94,2,50987484,20845,50966639,0,0.00,90.48,466807.94,1,12.54,11.54,1.83
5160,0,50975155,8516,78.00,466885.94,2,50991742,16587,50975155,8516,78.00,90.48,466885.94,0,11.35,11.54,1.80
5161,0,50975155,0,0.00,466885.94,2,50995644,20489,50975155,0,0.00,90.46,466885.94,1,11.95,10.95,1.82
5162,0,50982139,6984,63.97,466949.91,2,50999136,16997,50982139,6984,63.97,90.46,466949.91,0,10.16,10.95,1.79
5163,0,50989503,7364,67.45,467017.38,2,51002818,13315,50989503,7364,67.45,90.45,467017.38,0,10.22,10.95,1.81
5164,0,51002327,12824,117.46,467134.81,2,51009230,6903,51002327,12824,117.46,90.46,467134.81,1,10.28,10.95,1.82
5165,0,51029587,27260,249.68,467384.50,2,51029587,0,51029587,27260,249.68,90.49,467384.50,1,10.87,10.95,1.79
5166,0,51029587,0,0.00,467384.50,2,51040363,10776,51029587,0,0.00,90.47,467384.50,0,11.66,10.66,1.78
5167,0,51029587,0,0.00,467384.50,2,51046123,16536,51029587,0,0.00,90.46,467384.50,0,11.95,10.95,1.80
5168,0,51029587,0,0.00,467384.50,2,51050641,21054,51029587,0,0.00,90.44,467384.50,0,13.71,12.71,1.82
5169,0,51029587,0,0.00,467384.50,2,51054521,24934,51029587,0,0.00,90.42,467384.50,1,14.00,13.00,1.84
5170,0,51036999,7412,67.89,467452.38,2,51058227,21228,51036999,7412,67.89,90.42,467452.38,0,12.49,13.00,1.81
5171,0,51036999,0,0.00,467452.38,2,51061730,24731,51036999,0,0.00,90.40,467452.38,0,13.09,12.09,1.83
5172,0,51036999,0,0.00,467452.38,2,51064841,27842,51036999,0,0.00,90.38,467452.38,1,14.29,13.29,1.85
5173,0,51036999,0,0.00,467452.38,2,51067725,30726,51036999,0,0.00,90.36,467452.38,1,13.36,12.36,1.84
5174,0,51036999,0,0.00,467452.38,2,51070383,33384,51036999,0,0.00,90.35,467452.38,0,12.63,11.63,1.84
5175,0,51036999,0,0.00,467452.38,2,51072797,35798,51036999,0,0.00,90.33,467452.38,1,12.63,11.63,1.86
5176,0,51041595,4596,42.10,467494.47,2,51075095,33500,51041595,4596,42.10,90.32,467494.47,1,11.34,11.63,1.84
5177,0,51046263,4668,42.75,467537.22,2,51077429,31166,51046263,4668,42.75,90.31,467537.22,0,10.76,11.63,1.84
5178,0,51050963,4700,43.05,467580.28,2,51079779,28816,51050963,4700,43.05,90.30,467580.28,1,11.09,11.63,1.86
5179,0,51055693,4730,43.30,467623.59,2,51082144,26451,51055693,4730,43.32,90.29,467623.59,0,10.71,11.63,1.86
5180,0,51060441,4748,43.49,467667.06,2,51084518,24077,51060441,4748,43.49,90.28,467667.06,1,10.76,11.63,1.88
5181,0,51065511,5070,46.45,467713.53,2,51087053,21542,51065511,5070,46.44,90.27,467713.53,1,9.99,11.63,1.88
5182,0,51070375,4864,44.55,467758.06,2,51089485,19110,51070375,4864,44.55,90.27,467758.06,1,9.67,11.63,1.87
5183,0,51075509,5134,47.00,467805.09,2,51092052,16543,51075509,5134,47.02,90.26,467805.09,1,9.92,11.63,1.87
5184,0,51081463,5954,54.55,467859.62,2,51095029,13566,51081463,5954,54.53,90.25,467859.62,0,9.29,11.63,1.87
5185,0,51092671,11208,102.66,467962.28,2,51100633,7962,51092671,11208,102.66,90.25,467962.28,1,9.42,11.63,1.89
5186,0,51118702,26031,238.43,468200.72,2,51118702,0,51118702,26031,238.42,90.28,468200.72,0,8.81,11.63,1.88
5187,0,51153309,34607,316.94,468517.66,2,51153309,0,51153309,34607,316.97,90.33,468517.66,1,10.54,11.63,1.90
5188,0,51153309,0,0.00,468517.66,2,51164691,11382,51153309,0,0.00,90.31,468517.66,0,12.03,11.03,1.90
5189,0,51153309,0,0.00,468517.66,2,51170879,17570,51153309,0,0.00,90.29,468517.66,1,12.03,11.03,1.92
5190,0,51153309,0,0.00,468517.66,2,51175859,22550,51153309,0,0.00,90.27,468517.66,0,13.04,12.04,1.91
5191,0,51153309,0,0.00,468517.66,2,51180113,26804,51153309,0,0.00,90.26,468517.66,1,13.42,12.42,1.93
5192,0,51161147,7838,71.81,468589.47,2,51184032,22885,51161147,7838,71.79,90.25,468589.47,0,12.30,12.42,1.91
5193,0,51168731,7584,69.46,468658.94,2,51187824,19093,51168731,7584,69.46,90.25,468658.94,0,12.37,12.42,1.93
5194,0,51168731,0,0.00,468658.94,2,51191216,22485,51168731,0,0.00,90.23,468658.94,1,12.44,11.44,1.95
5195,0,51174905,6174,56.53,468715.47,2,51194303,19398,51174905,6174,56.55,90.22,468715.47,1,11.11,11.44,1.93
5196,0,51180603,5698,52.21,468767.66,2,51197152,16549,51180603,5698,52.19,90.22,468767.66,0,10.63,11.44,1.93
5197,0,51180603,0,0.00,468767.66,2,51199870,19267,51180603,0,0.00,90.20,468767.66,0,11.96,10.96,1.95
5198,0,51180603,0,0.00,468767.66,2,51202134,21531,51180603,0,0.00,90.18,468767.66,1,12.20,11.20,1.97
5199,0,51180603,0,0.00,468767.66,2,51204175,23572,51180603,0,0.00,90.16,468767.66,0,11.23,10.23,1.96
5200,0,51180603,0,0.00,468767.66,2,51206264,25661,51180603,0,0.00,90.15,468767.66,1,11.35,10.35,1.98
5201,0,51184729,4126,37.77,468805.44,2,51208327,23598,51184729,4126,37.79,90.14,468805.44,0,10.10,10.35,1.97
5202,0,51189031,4302,39.42,468844.84,2,51210478,21447,51189031,4302,39.40,90.13,468844.84,1,10.14,10.35,1.99
5203,0,51193851,4820,44.15,468889.00,2,51212888,19037,51193851,4820,44.15,90.12,468889.00,0,9.31,10.35,1.98
5204,0,51193851,0,0.00,468889.00,2,51215287,21436,51193851,0,0.00,90.10,468889.00,1,10.65,9.65,1.99
5205,0,51198637,4786,43.82,468932.81,2,51217680,19043,51198637,4786,43.84,90.09,468932.81,0,9.32,9.65,1.97
5206,0,51204793,6156,56.38,468989.19,2,51220758,15965,51204793,6156,56.38,90.09,468989.19,1,9.36,9.65,1.99
5207,0,51214267,9474,86.79,469076.00,2,51225495,11228,51214267,9474,86.77,90.09,469076.00,0,8.27,9.65,1.98
5208,0,51231485,17218,157.68,469233.69,2,51234104,2619,51231485,17218,157.70,90.10,469233.69,1,8.35,9.65,2.00
5209,0,51263626,32141,294.37,469528.06,2,51263626,0,51263626,32141,294.38,90.14,469528.06,0,6.96,9.65,1.97
5210,0,51297621,33995,311.37,469839.44,2,51297621,0,51297621,33995,311.36,90.18,469839.44,1,7.73,9.65,1.98
5211,0,51332058,34437,315.40,470154.81,2,51332058,0,51332058,34437,315.41,90.22,470154.81,0,8.51,9.65,1.98
5212,0,51332058,0,0.00,470154.81,2,51342708,10650,51332058,0,0.00,90.21,470154.81,1,10.80,9.80,2.00
5213,0,51353028,20970,192.08,470346.91,2,51353193,165,51353028,20970,192.07,90.23,470346.91,0,9.80,9.80,1.98
5214,0,51353028,0,0.00,470346.91,2,51363607,10579,51353028,0,0.00,90.21,470346.91,1,10.42,9.42,2.00
5215,0,51353028,0,0.00,470346.91,2,51368925,15897,51353028,0,0.00,90.19,470346.91,1,9.79,8.79,2.00
5216,0,51353028,0,0.00,470346.91,2,51373052,20024,51353028,0,0.00,90.17,470346.91,0,9.44,8.44,2.00
5217,0,51353028,0,0.00,470346.91,2,51376709,23681,51353028,0,0.00,90.16,470346.91,0,9.94,8.94,2.02
5218,0,51353028,0,0.00,470346.91,2,51379983,26955,51353028,0,0.00,90.14,470346.91,0,10.39,9.39,2.04
5219,0,51353028,0,0.00,470346.91,2,51383003,29975,51353028,0,0.00,90.12,470346.91,1,10.81,9.81,2.05
5220,0,51353028,0,0.00,470346.91,2,51385800,32772,51353028,0,0.00,90.10,470346.91,1,10.07,9.07,2.04
5221,0,51353028,0,0.00,470346.91,2,51388422,35394,51353028,0,0.00,90.09,470346.91,0,9.86,8.86,2.05
5222,0,51353028,0,0.00,470346.91,2,51390876,37848,51353028,0,0.00,90.07,470346.91,1,10.31,9.31,2.07
5223,0,51353028,0,0.00,470346.91,2,51393023,39995,51353028,0,0.00,90.05,470346.91,1,9.66,8.66,2.07
5224,0,51353028,0,0.00,470346.91,2,51395112,42084,51353028,0,0.00,90.04,470346.91,0,9.12,8.12,2.08
5225,0,51353028,0,0.00,470346.91,2,51397404,44376,51353028,0,0.00,90.02,470346.91,1,9.12,8.12,2.09
5226,0,51353028,0,0.00,470346.91,2,51399609,46581,51353028,0,0.00,90.00,470346.91,0,8.54,8.00,2.09
5227,0,51357426,4398,40.26,470387.19,2,51401808,44382,51357426,4398,40.28,89.99,470387.19,0,8.54,9.54,2.11
5228,0,51361840,4414,40.45,470427.62,2,51404015,42175,51361840,4414,40.43,89.98,470427.62,1,8.58,9.54,2.13
5229,0,51366192,4352,39.86,470467.47,2,51406191,39999,51366192,4352,39.86,89.97,470467.47,0,7.35,9.54,2.11
5230,0,51370488,4296,39.35,470506.81,2,51408339,37851,51370488,4296,39.35,89.96,470506.81,1,7.38,9.54,2.13
5231,0,51374862,4374,40.08,470546.91,2,51410526,35664,51374862,4374,40.06,89.95,470546.91,0,6.39,9.54,2.12
5232,0,51379154,4292,39.27,470586.19,2,51412672,33518,51379154,4292,39.31,89.94,470586.19,1,6.42,9.54,2.14
5233,0,51383486,4332,39.71,470625.91,2,51414838,31352,51383486,4332,39.68,89.93,470625.91,1,5.46,9.54,2.14
5234,0,51387658,4172,38.18,470664.06,2,51416924,29266,51387658,4172,38.21,89.92,470664.06,0,4.74,9.54,2.13
5235,0,51391732,4074,37.33,470701.41,2,51418961,27229,51391732,4074,37.31,89.91,470701.41,1,5.32,9.54,2.15
5236,0,51395904,4172,38.21,470739.62,2,51421047,25143,51395904,4172,38.21,89.90,470739.62,0,4.99,9.54,2.15
5237,0,51399954,4050,37.08,470776.69,2,51423072,23118,51399954,4050,37.09,89.89,470776.69,0,7.81,9.54,2.16
5238,0,51404148,4194,38.43,470815.12,2,51425169,21021,51404148,4194,38.41,89.88,470815.12,0,7.87,9.54,2.18
5239,0,51408410,4262,39.02,470854.12,2,51427300,18890,51408410,4262,39.04,89.87,470854.12,1,7.94,9.54,2.20
5240,0,51413014,4604,42.21,470896.34,2,51429602,16588,51413014,4604,42.17,89.87,470896.34,0,6.89,9.54,2.19
5241,0,51418598,5584,51.14,470947.50,2,51432394,13796,51418598,5584,51.14,89.86,470947.50,1,6.93,9.54,2.21
5242,0,51430902,12304,112.69,471060.19,2,51438546,7644,51430902,12304,112.69,89.86,471060.19,1,5.89,9.54,2.20
5243,0,51457310,26408,241.87,471302.06,2,51457310,0,51457310,26408,241.87,89.89,471302.06,0,4.96,9.54,2.19
5244,0,51492017,34707,317.86,471619.91,2,51492017,0,51492017,34707,317.88,89.94,471619.91,1,5.56,9.54,2.21
5245,0,51527181,35164,322.07,471941.97,2,51527181,0,51527181,35164,322.07,89.98,471941.97,1,6.08,9.54,2.20
5246,0,51561414,34233,313.57,472255.56,2,51561414,0,51561414,34233,313.54,90.02,472255.56,0,6.42,9.54,2.19
5247,0,51595988,34574,316.65,472572.19,2,51595988,0,51595988,34574,316.67,90.07,472572.19,0,7.74,9.54,2.20
5248,0,51630380,34392,315.00,472887.19,2,51630380,0,51630380,34392,315.00,90.11,472887.19,1,8.05,9.54,2.22
5249,0,51665298,34918,319.80,473207.00,2,51665298,0,51665298,34918,319.82,90.15,473207.00,0,7.98,9.54,2.20
5250,0,51665298,0,0.00,473207.00,2,51676133,10835,51665298,0,0.00,90.13,473207.00,1,11.82,10.82,2.21
5251,0,51665298,0,0.00,473207.00,2,51681997,16699,51665298,0,0.00,90.12,473207.00,0,11.89,10.89,2.20
5252,0,51665298,0,0.00,473207.00,2,51686552,21254,51665298,0,0.00,90.10,473207.00,1,13.74,12.74,2.22
5253,0,51673908,8610,78.88,473285.88,2,51690857,16949,51673908,8610,78.86,90.10,473285.88,0,11.72,12.74,2.18
5254,0,51682220,8312,76.13,473362.00,2,51695013,12793,51682220,8312,76.13,90.10,473362.00,1,11.80,12.74,2.20
5255,0,51693938,11718,107.31,473469.31,2,51700872,6934,51693938,11718,107.33,90.10,473469.31,0,10.84,12.74,2.19
5256,0,51721843,27905,255.61,473724.94,2,51721843,0,51721843,27905,255.58,90.13,473724.94,1,11.37,12.74,2.21
5257,0,51754458,32615,298.70,474023.62,2,51754458,0,51754458,32615,298.72,90.17,474023.62,0,10.09,12.74,2.18
5258,0,51787440,32982,302.10,474325.72,2,51787440,0,51787440,32982,302.09,90.21,474325.72,1,10.38,12.74,2.20
5259,0,51820358,32918,301.52,474627.25,2,51820358,0,51820358,32918,301.50,90.25,474627.25,0,11.04,12.74,2.19
5260,0,51820358,0,0.00,474627.25,2,51830947,10589,51820358,0,0.00,90.23,474627.25,1,13.67,12.67,2.21
5261,0,51820358,0,0.00,474627.25,2,51836827,16469,51820358,0,0.00,90.22,474627.25,1,13.01,12.01,2.20
5262,0,51820358,0,0.00,474627.25,2,51841331,20973,51820358,0,0.00,90.20,474627.25,0,12.81,11.81,2.19
5263,0,51820358,0,0.00,474627.25,2,51845479,25121,51820358,0,0.00,90.18,474627.25,0,14.26,13.26,2.21
5264,0,51820358,0,0.00,474627.25,2,51849163,28805,51820358,0,0.00,90.16,474627.25,1,14.63,13.63,2.23
5265,0,51827336,6978,63.89,474691.12,2,51852652,25316,51827336,6978,63.91,90.16,474691.12,0,13.13,13.63,2.21
5266,0,51834122,6786,62.14,474753.28,2,51856045,21923,51834122,6786,62.15,90.15,474753.28,1,13.19,13.63,2.23
5267,0,51840430,6308,57.81,474811.09,2,51859199,18769,51840430,6308,57.78,90.15,474811.09,0,12.74,13.63,2.21
5268,0,51846698,6268,57.37,474868.47,2,51862333,15635,51846698,6268,57.41,90.14,474868.47,1,13.48,13.63,2.23
5269,0,51853320,6622,60.67,474929.12,2,51865644,12324,51853320,6622,60.65,90.14,474929.12,1,12.94,13.63,2.21
5270,0,51866156,12836,117.57,475046.69,2,51872062,5906,51866156,12836,117.57,90.14,475046.69,0,11.91,13.63,2.20
5271,0,51894558,28402,260.15,475306.84,2,51894558,0,51894558,28402,260.14,90.17,475306.84,0,12.03,13.63,2.22
5272,0,51894558,0,0.00,475306.84,2,51905289,10731,51894558,0,0.00,90.16,475306.84,1,14.44,13.44,2.24
5273,0,51894558,0,0.00,475306.84,2,51911147,16589,51894558,0,0.00,90.14,475306.84,0,15.32,14.32,2.22
5274,0,51894558,0,0.00,475306.84,2,51915887,21329,51894558,0,0.00,90.12,475306.84,1,15.32,14.32,2.24
5275,0,51903088,8530,78.11,475384.97,2,51920152,17064,51903088,8530,78.13,90.12,475384.97,0,14.03,14.32,2.21
5276,0,51903088,0,0.00,475384.97,2,51923968,20880,51903088,0,0.00,90.10,475384.97,1,15.54,14.54,2.23
5277,0,51910018,6930,63.45,475448.41,2,51927433,17415,51910018,6930,63.47,90.10,475448.41,0,14.34,14.54,2.21
5278,0,51910018,0,0.00,475448.41,2,51930650,20632,51910018,0,0.00,90.08,475448.41,1,14.97,13.97,2.23
5279,0,51916004,5986,54.84,475503.25,2,51933643,17639,51916004,5986,54.83,90.07,475503.25,0,13.73,13.97,2.21
5280,0,51916004,0,0.00,475503.25,2,51936461,20457,51916004,0,0.00,90.06,475503.25,1,14.75,13.75,2.23
5281,0,51921204,5200,47.63,475550.88,2,51939061,17857,51921204,5200,47.63,90.05,475550.88,0,13.45,13.75,2.21
5282,0,51928394,7190,65.84,475616.72,2,51942656,14262,51928394,7190,65.85,90.04,475616.72,1,13.50,13.75,2.23
5283,0,51942214,13820,126.62,475743.34,2,51949566,7352,51942214,13820,126.58,90.05,475743.34,0,12.39,13.75,2.21
5284,0,51969918,27704,253.74,475997.06,2,51969918,0,51969918,27704,253.74,90.08,475997.06,1,13.56,13.75,2.23
5285,0,52002399,32481,297.49,476294.56,2,52002399,0,52002399,32481,297.50,90.12,476294.56,0,13.39,13.75,2.21
5286,0,52002399,0,0.00,476294.56,2,52012944,10545,52002399,0,0.00,90.10,476294.56,1,14.39,13.39,2.23
5287,0,52023065,20666,189.26,476483.84,2,52023277,212,52023065,20666,189.28,90.12,476483.84,0,13.15,13.39,2.20
5288,0,52056130,33065,302.84,476786.66,2,52056130,0,52056130,33065,302.85,90.16,476786.66,1,13.34,13.39,2.22
5289,0,52056130,0,0.00,476786.66,2,52066863,10733,52056130,0,0.00,90.15,476786.66,0,14.06,13.06,2.22
5290,0,52056130,0,0.00,476786.66,2,52072662,16532,52056130,0,0.00,90.13,476786.66,1,17.51,16.51,2.23
5291,0,52056130,0,0.00,476786.66,2,52077119,20989,52056130,0,0.00,90.11,476786.66,0,17.18,16.18,2.22
5292,0,52056130,0,0.00,476786.66,2,52080943,24813,52056130,0,0.00,90.10,476786.66,1,17.90,16.90,2.23
5293,0,52063016,6886,63.09,476849.75,2,52084386,21370,52063016,6886,63.07,90.09,476849.75,0,16.81,16.90,2.22
5294,0,52070388,7372,67.52,476917.28,2,52088072,17684,52070388,7372,67.52,90.09,476917.28,1,16.87,16.90,2.24
5295,0,52077672,7284,66.71,476984.00,2,52091714,14042,52077672,7284,66.71,90.08,476984.00,0,15.45,16.90,2.22
5296,0,52085738,8066,73.86,477057.84,2,52095747,10009,52085738,8066,73.88,90.08,477057.84,1,15.80,16.90,2.24
5297,0,52105490,19752,180.91,477238.75,2,52105623,133,52105490,19752,180.91,90.10,477238.75,0,14.89,16.90,2.23
5298,0,52138404,32914,301.48,477540.25,2,52138404,0,52138404,32914,301.46,90.14,477540.25,1,15.07,16.90,2.25
5299,0,52170515,32111,294.12,477834.34,2,52170515,0,52170515,32111,294.11,90.17,477834.34,0,15.84,16.90,2.23
5300,0,52170515,0,0.00,477834.34,2,52181047,10532,52170515,0,0.00,90.16,477834.34,1,17.91,16.91,2.25
5301,0,52170515,0,0.00,477834.34,2,52186745,16230,52170515,0,0.00,90.14,477834.34,0,17.28,16.28,2.24
5302,0,52170515,0,0.00,477834.34,2,52191099,20584,52170515,0,0.00,90.12,477834.34,1,18.75,17.75,2.25
5303,0,52178339,7824,71.66,477906.00,2,52195011,16672,52178339,7824,71.66,90.12,477906.00,0,17.63,17.75,2.24
5304,0,52186459,8120,74.37,477980.38,2,52199071,12612,52186459,8120,74.37,90.12,477980.38,1,17.70,17.75,2.26
5305,0,52198085,11626,106.47,478086.84,2,52204884,6799,52198085,11626,106.48,90.12,478086.84,0,16.60,17.75,2.25
5306,0,52226482,28397,260.08,478346.94,2,52226482,0,52226482,28397,260.09,90.15,478346.94,1,17.09,17.75,2.27
5307,0,52258487,32005,293.16,478640.09,2,52258487,0,52258487,32005,293.14,90.19,478640.09,0,16.46,17.75,2.24
5308,0,52258487,0,0.00,478640.09,2,52269207,10720,52258487,0,0.00,90.17,478640.09,1,18.07,17.07,2.26
5309,0,52258487,0,0.00,478640.09,2,52275261,16774,52258487,0,0.00,90.16,478640.09,0,17.77,16.77,2.25
5310,0,52258487,0,0.00,478640.09,2,52279812,21325,52258487,0,0.00,90.14,478640.09,1,17.77,16.77,2.27
5311,0,52266793,8306,76.06,478716.16,2,52283965,17172,52266793,8306,76.08,90.14,478716.16,0,15.87,16.77,2.24
5312,0,52275091,8298,76.02,478792.19,2,52288114,13023,52275091,8298,76.00,90.13,478792.19,1,15.94,16.77,2.26
5313,0,52285025,9934,90.97,478883.16,2,52293081,8056,52285025,9934,90.99,90.13,478883.16,0,14.96,16.77,2.25
5314,0,52310446,25421,232.86,479116.00,2,52310446,0,52310446,25421,232.83,90.16,479116.00,1,15.05,16.77,2.27
5315,0,52342535,32089,293.90,479409.91,2,52342535,0,52342535,32089,293.91,90.20,479409.91,0,15.53,16.77,2.24
5316,0,52342535,0,0.00,479409.91,2,52353129,10594,52342535,0,0.00,90.18,479409.91,1,18.70,17.70,2.26
5317,0,52342535,0,0.00,479409.91,2,52358984,16449,52342535,0,0.00,90.17,479409.91,0,19.32,18.32,2.24
5318,0,52342535,0,0.00,479409.91,2,52363672,21137,52342535,0,0.00,90.15,479409.91,1,19.80,18.80,2.26
5319,0,52350965,8430,77.19,479487.09,2,52367887,16922,52350965,8430,77.21,90.15,479487.09,0,18.65,18.80,2.25
5320,0,52359421,8456,77.45,479564.53,2,52372115,12694,52359421,8456,77.45,90.14,479564.53,0,18.72,18.80,2.27
5321,0,52371445,12024,110.13,479674.66,2,52378127,6682,52371445,12024,110.13,90.15,479674.66,1,18.80,18.80,2.28
5322,0,52399045,27600,252.79,479927.47,2,52399045,0,52399045,27600,252.79,90.18,479927.47,1,17.41,18.80,2.26
5323,0,52429109,30064,275.36,480202.81,2,52429109,0,52429109,30064,275.36,90.21,480202.81,0,17.95,18.80,2.25
5324,0,52429109,0,0.00,480202.81,2,52439666,10557,52429109,0,0.00,90.20,480202.81,1,19.07,18.07,2.27
5325,0,52429109,0,0.00,480202.81,2,52445339,16230,52429109,0,0.00,90.18,480202.81,0,18.82,17.82,2.26
5326,0,52429109,0,0.00,480202.81,2,52449763,20654,52429109,0,0.00,90.16,480202.81,1,21.02,19.00,2.28
5327,0,52429109,0,0.00,480202.81,2,52453546,24437,52429109,0,0.00,90.15,480202.81,0,19.78,18.78,2.26
5328,0,52429109,0,0.00,480202.81,2,52457233,28124,52429109,0,0.00,90.13,480202.81,1,19.78,18.78,2.28
5329,0,52435923,6814,62.43,480265.25,2,52460640,24717,52435923,6814,62.41,90.12,480265.25,0,18.67,18.78,2.27
5330,0,52442755,6832,62.57,480327.81,2,52464056,21301,52442755,6832,62.57,90.12,480327.81,1,18.73,18.78,2.29
5331,0,52449295,6540,59.90,480387.72,2,52467326,18031,52449295,6540,59.90,90.11,480387.72,0,17.57,18.78,2.27
5332,0,52455697,6402,58.62,480446.34,2,52470527,14830,52455697,6402,58.64,90.11,480446.34,1,17.62,18.78,2.29
5333,0,52462829,7132,65.32,480511.66,2,52474093,11264,52462829,7132,65.32,90.10,480511.66,1,16.84,18.78,2.29
5334,0,52477337,14508,132.88,480644.53,2,52481347,4010,52477337,14508,132.88,90.11,480644.53,0,16.24,18.78,2.29
5335,0,52504696,27359,250.59,480895.12,2,52504696,0,52504696,27359,250.58,90.14,480895.12,1,17.91,18.78,2.31
5336,0,52504696,0,0.00,480895.12,2,52514903,10207,52504696,0,0.00,90.12,480895.12,0,19.12,18.12,2.31
5337,0,52504696,0,0.00,480895.12,2,52520955,16259,52504696,0,0.00,90.11,480895.12,0,20.09,19.09,2.33
5338,0,52504696,0,0.00,480895.12,2,52525688,20992,52504696,0,0.00,90.09,480895.12,1,21.22,19.00,2.35
5339,0,52504696,0,0.00,480895.12,2,52529733,25037,52504696,0,0.00,90.07,480895.12,1,20.72,19.72,2.33
5340,0,52512194,7498,68.66,480963.78,2,52533482,21288,52512194,7498,68.67,90.07,480963.78,0,19.64,19.72,2.32
5341,0,52519290,7096,64.99,481028.78,2,52537030,17740,52519290,7096,64.99,90.06,481028.78,1,19.71,19.72,2.34
5342,0,52526160,6870,62.94,481091.72,2,52540465,14305,52526160,6870,62.92,90.06,481091.72,0,18.80,19.72,2.33
5343,0,52533438,7278,66.68,481158.41,2,52544104,10666,52533438,7278,66.66,90.05,481158.41,1,19.21,19.72,2.35
5344,0,52548012,14574,133.47,481291.88,2,52551391,3379,52548012,14574,133.48,90.06,481291.88,0,18.75,19.72,2.34
5345,0,52577232,29220,267.63,481559.50,2,52577232,0,52577232,29220,267.63,90.10,481559.50,1,18.88,19.72,2.36
5346,0,52607068,29836,273.27,481832.78,2,52607068,0,52607068,29836,273.27,90.13,481832.78,0,19.02,19.72,2.34
5347,0,52607068,0,0.00,481832.78,2,52617543,10475,52607068,0,0.00,90.11,481832.78,0,21.07,19.00,2.36
5348,0,52607068,0,0.00,481832.78,2,52623291,16223,52607068,0,0.00,90.10,481832.78,1,22.78,19.00,2.38
5349,0,52607068,0,0.00,481832.78,2,52627588,20520,52607068,0,0.00,90.08,481832.78,0,20.76,19.76,2.33
5350,0,52607068,0,0.00,481832.78,2,52631347,24279,52607068,0,0.00,90.06,481832.78,1,20.96,19.96,2.35
5351,0,52614174,7106,65.10,481897.88,2,52634900,20726,52614174,7106,65.08,90.06,481897.88,0,19.48,19.96,2.33
5352,0,52621008,6834,62.57,481960.44,2,52638317,17309,52621008,6834,62.59,90.05,481960.44,1,19.65,19.96,2.35
5353,0,52627742,6734,61.70,482022.16,2,52641684,13942,52627742,6734,61.68,90.05,482022.16,0,17.82,19.96,2.31
5354,0,52635152,7410,67.85,482090.00,2,52645389,10237,52635152,7410,67.87,90.04,482090.00,1,17.88,19.96,2.33
5355,0,52655538,20386,186.70,482276.69,2,52655582,44,52655538,20386,186.72,90.06,482276.69,0,15.71,19.96,2.29
5356,0,52685349,29811,273.05,482549.75,2,52685349,0,52685349,29811,273.04,90.10,482549.75,1,17.40,19.96,2.31
5357,0,52715345,29996,274.74,482824.47,2,52715345,0,52715345,29996,274.74,90.13,482824.47,0,17.84,19.96,2.28
5358,0,52745439,30094,275.65,483100.12,2,52745439,0,52745439,30094,275.63,90.16,483100.12,0,18.65,19.96,2.30
5359,0,52776386,30947,283.42,483383.56,2,52776386,0,52776386,30947,283.45,90.20,483383.56,0,19.08,19.96,2.32
5360,0,52776386,0,0.00,483383.56,2,52786962,10576,52776386,0,0.00,90.18,483383.56,1,20.75,19.75,2.34
5361,0,52794802,18416,168.67,483552.22,2,52796170,1368,52794802,18416,168.67,90.20,483552.22,0,19.54,19.75,2.31
5362,0,52794802,0,0.00,483552.22,2,52805340,10538,52794802,0,0.00,90.18,483552.22,1,20.98,19.98,2.32
5363,0,52815246,20444,187.29,483739.50,2,52815562,316,52815246,20444,187.25,90.20,483739.50,0,19.79,19.98,2.30
5364,0,52815246,0,0.00,483739.50,2,52826465,11219,52815246,0,0.00,90.18,483739.50,1,21.42,19.00,2.31
5365,0,52815246,0,0.00,483739.50,2,52831826,16580,52815246,0,0.00,90.17,483739.50,0,20.39,19.39,2.29
5366,0,52815246,0,0.00,483739.50,2,52835412,20166,52815246,0,0.00,90.15,483739.50,1,20.48,19.48,2.31
5367,0,52823038,7792,71.37,483810.88,2,52839308,16270,52823038,7792,71.37,90.15,483810.88,1,19.16,19.48,2.30
5368,0,52832054,9016,82.58,483893.47,2,52843816,11762,52832054,9016,82.58,90.14,483893.47,0,18.21,19.48,2.28
5369,0,52849700,17646,161.60,484055.06,2,52852639,2939,52849700,17646,161.62,90.16,484055.06,1,18.59,19.48,2.30
5370,0,52880873,31173,285.51,484340.56,2,52880873,0,52880873,31173,285.52,90.19,484340.56,1,18.23,19.48,2.27
5371,0,52911813,30940,283.38,484623.94,2,52911813,0,52911813,30940,283.38,90.23,484623.94,0,19.35,19.48,2.27
5372,0,52911813,0,0.00,484623.94,2,52922761,10948,52911813,0,0.00,90.21,484623.94,1,21.54,19.00,2.29
5373,0,52911813,0,0.00,484623.94,2,52928656,16843,52911813,0,0.00,90.20,484623.94,0,20.87,19.87,2.27
5374,0,52911813,0,0.00,484623.94,2,52932968,21155,52911813,0,0.00,90.18,484623.94,0,21.19,19.00,2.29
5375,0,52911813,0,0.00,484623.94,2,52936954,25141,52911813,0,0.00,90.16,484623.94,1,21.19,19.00,2.30
5376,0,52911813,0,0.00,484623.94,2,52940635,28822,52911813,0,0.00,90.15,484623.94,0,19.75,18.75,2.29
5377,0,52911813,0,0.00,484623.94,2,52944017,32204,52911813,0,0.00,90.13,484623.94,1,19.76,18.76,2.30
5378,0,52918205,6392,58.54,484682.50,2,52947213,29008,52918205,6392,58.54,90.12,484682.50,0,18.52,18.76,2.29
5379,0,52918205,0,0.00,484682.50,2,52950223,32018,52918205,0,0.00,90.11,484682.50,0,19.19,18.19,2.30
5380,0,52918205,0,0.00,484682.50,2,52952964,34759,52918205,0,0.00,90.09,484682.50,1,19.38,18.38,2.32
5381,0,52923459,5254,48.14,484730.62,2,52955591,32132,52923459,5254,48.12,90.08,484730.62,1,18.37,18.38,2.31
5382,0,52928631,5172,47.37,484778.00,2,52958177,29546,52928631,5172,47.37,90.07,484778.00,1,17.19,18.38,2.29
5383,0,52933595,4964,45.47,484823.47,2,52960659,27064,52933595,4964,45.47,90.07,484823.47,0,16.24,18.38,2.29
5384,0,52938289,4694,42.97,484866.44,2,52963006,24717,52938289,4694,42.99,90.06,484866.44,1,16.28,18.38,2.30
5385,0,52943233,4944,45.28,484911.72,2,52965478,22245,52943233,4944,45.28,90.05,484911.72,0,15.75,18.38,2.30
5386,0,52948177,4944,45.28,484957.00,2,52967950,19773,52948177,4944,45.28,90.04,484957.00,1,16.19,18.38,2.32
5387,0,52953449,5272,48.29,485005.31,2,52970586,17137,52953449,5272,48.29,90.03,485005.31,0,14.69,18.38,2.30
5388,0,52959095,5646,51.73,485057.03,2,52973409,14314,52959095,5646,51.71,90.03,485057.03,1,15.81,18.38,2.32
5389,0,52968953,9858,90.27,485147.31,2,52978338,9385,52968953,9858,90.29,90.03,485147.31,0,15.40,18.38,2.30
5390,0,52991714,22761,208.46,485355.75,2,52991714,0,52991714,22761,208.47,90.05,485355.75,1,15.49,18.38,2.32
5391,0,53023545,31831,291.55,485647.31,2,53023545,0,53023545,31831,291.54,90.08,485647.31,0,14.60,18.38,2.30
5392,0,53055707,32162,294.59,485941.91,2,53055707,0,53055707,32162,294.57,90.12,485941.91,1,15.17,18.38,2.32
5393,0,53055707,0,0.00,485941.91,2,53066374,10667,53055707,0,0.00,90.11,485941.91,1,18.42,17.42,2.29
5394,0,53076353,20646,189.08,486131.00,2,53076697,344,53076353,20646,189.10,90.12,486131.00,0,17.32,17.42,2.28
5395,0,53076353,0,0.00,486131.00,2,53087268,10915,53076353,0,0.00,90.11,486131.00,0,19.49,18.49,2.30
5396,0,53076353,0,0.00,486131.00,2,53092331,15978,53076353,0,0.00,90.09,486131.00,1,19.84,18.84,2.32
5397,0,53086327,9974,91.37,486222.34,2,53097318,10991,53086327,9974,91.35,90.09,486222.34,0,18.68,18.84,2.29
5398,0,53104421,18094,165.71,486388.06,2,53106365,1944,53104421,18094,165.72,90.11,486388.06,1,18.77,18.84,2.31
5399,0,53135693,31272,286.42,486674.50,2,53135693,0,53135693,31272,286.42,90.14,486674.50,1,18.08,18.84,2.31
5400,0,53167858,32165,294.59,486969.09,2,53167858,0,53167858,32165,294.60,90.18,486969.09,0,17.70,18.84,2.29
5401,0,53167858,0,0.00,486969.09,2,53178536,10678,53167858,0,0.00,90.16,486969.09,1,20.07,19.07,2.31
5402,0,53167858,0,0.00,486969.09,2,53184144,16286,53167858,0,0.00,90.15,486969.09,0,19.63,18.63,2.29
5403,0,53167858,0,0.00,486969.09,2,53188337,20479,53167858,0,0.00,90.13,486969.09,0,21.06,19.00,2.31
5404,0,53167858,0,0.00,486969.09,2,53191949,24091,53167858,0,0.00,90.11,486969.09,1,21.06,19.00,2.33
5405,0,53167858,0,0.00,486969.09,2,53195169,27311,53167858,0,0.00,90.10,486969.09,0,19.62,18.62,2.30
5406,0,53167858,0,0.00,486969.09,2,53198098,30240,53167858,0,0.00,90.08,486969.09,1,20.75,19.75,2.32
5407,0,53173534,5676,52.02,487021.09,2,53200936,27402,53173534,5676,51.99,90.07,487021.09,0,19.41,19.75,2.29
5408,0,53179196,5662,51.84,487072.94,2,53203767,24571,53179196,5662,51.86,90.07,487072.94,1,19.46,19.75,2.31
5409,0,53184826,5630,51.55,487124.50,2,53206582,21756,53184826,5630,51.57,90.06,487124.50,0,17.67,19.75,2.28
5410,0,53190728,5902,54.08,487178.56,2,53209533,18805,53190728,5902,54.06,90.05,487178.56,1,17.72,19.75,2.29
5411,0,53196582,5854,53.64,487232.19,2,53212460,15878,53196582,5854,53.62,90.04,487232.19,0,15.31,19.75,2.25
5412,0,53202666,6084,55.69,487287.88,2,53215502,12836,53202666,6084,55.72,90.04,487287.88,1,15.39,19.75,2.27
5413,0,53213456,10790,98.84,487386.72,2,53220897,7441,53213456,10790,98.83,90.04,487386.72,0,13.89,19.75,2.24
5414,0,53241229,27773,254.37,487641.09,2,53241229,0,53241229,27773,254.38,90.07,487641.09,1,13.99,19.75,2.26
5415,0,53273654,32425,297.01,487938.12,2,53273654,0,53273654,32425,296.98,90.11,487938.12,0,12.38,19.75,2.22
5416,0,53306245,32591,298.48,488236.59,2,53306245,0,53306245,32591,298.50,90.15,488236.59,1,14.38,19.75,2.24
5417,0,53338896,32651,299.06,488535.66,2,53338896,0,53338896,32651,299.05,90.19,488535.66,0,13.74,19.75,2.21
5418,0,53371660,32764,300.09,488835.75,2,53371660,0,53371660,32764,300.09,90.22,488835.75,1,14.64,19.75,2.23
5419,0,53404255,32595,298.55,489134.28,2,53404255,0,53404255,32595,298.54,90.26,489134.28,1,13.61,19.75,2.19
5420,0,53436547,32292,295.77,489430.06,2,53436547,0,53436547,32292,295.77,90.30,489430.06,0,16.40,19.75,2.18
5421,0,53468836,32289,295.73,489725.78,2,53468836,0,53468836,32289,295.74,90.34,489725.78,1,17.52,19.75,2.20
5422,0,53500970,32134,294.30,490020.09,2,53500970,0,53500970,32134,294.32,90.38,490020.09,0,17.82,19.75,2.17
5423,0,53532961,31991,293.02,490313.09,2,53532961,0,53532961,31991,293.01,90.41,490313.09,1,18.66,19.75,2.19
5424,0,53532961,0,0.00,490313.09,2,53543430,10469,53532961,0,0.00,90.40,490313.09,0,20.38,19.38,2.17
5425,0,53532961,0,0.00,490313.09,2,53549178,16217,53532961,0,0.00,90.38,490313.09,0,22.38,19.00,2.19
5426,0,53532961,0,0.00,490313.09,2,53553582,20621,53532961,0,0.00,90.36,490313.09,1,22.38,19.00,2.21
5427,0,53532961,0,0.00,490313.09,2,53557340,24379,53532961,0,0.00,90.35,490313.09,0,19.93,18.93,2.16
5428,0,53532961,0,0.00,490313.09,2,53560824,27863,53532961,0,0.00,90.33,490313.09,1,19.98,18.98,2.18
5429,0,53539313,6352,58.18,490371.28,2,53564000,24687,53539313,6352,58.18,90.32,490371.28,0,17.94,18.98,2.15
5430,0,53545711,6398,58.62,490429.91,2,53567199,21488,53545711,6398,58.60,90.32,490429.91,1,18.00,18.98,2.17
5431,0,53551993,6282,57.52,490487.41,2,53570340,18347,53551993,6282,57.54,90.31,490487.41,0,15.82,18.98,2.13
5432,0,53558451,6458,59.17,490546.59,2,53573569,15118,53558451,6458,59.15,90.31,490546.59,1,15.92,18.98,2.14
5433,0,53565649,7198,65.91,490612.50,2,53577168,11519,53565649,7198,65.93,90.30,490612.50,0,13.95,18.98,2.11
5434,0,53581745,16096,147.42,490759.91,2,53585216,3471,53581745,16096,147.42,90.31,490759.91,0,14.50,18.98,2.12
5435,0,53613511,31766,290.97,491050.88,2,53613511,0,53613511,31766,290.95,90.35,491050.88,1,15.65,18.98,2.14
5436,0,53645896,32385,296.61,491347.50,2,53645896,0,53645896,32385,296.62,90.39,491347.50,1,13.92,18.98,2.09
5437,0,53678499,32603,298.62,491646.12,2,53678499,0,53678499,32603,298.61,90.43,491646.12,0,13.06,18.98,2.07
5438,0,53710739,32240,295.29,491941.41,2,53710739,0,53710739,32240,295.29,90.46,491941.41,0,14.11,18.98,2.09
5439,0,53741939,31200,285.76,492227.16,2,53741939,0,53741939,31200,285.76,90.50,492227.16,0,15.32,18.98,2.10
5440,0,53741939,0,0.00,492227.16,2,53752452,10513,53741939,0,0.00,90.48,492227.16,1,19.44,18.44,2.12
5441,0,53762361,20422,187.03,492414.19,2,53762663,302,53762361,20422,187.05,90.50,492414.19,0,17.06,18.44,2.08
5442,0,53794109,31748,290.78,492704.97,2,53794109,0,53794109,31748,290.78,90.54,492704.97,1,17.70,18.44,2.10
5443,0,53794109,0,0.00,492704.97,2,53804380,10271,53794109,0,0.00,90.52,492704.97,1,20.20,19.20,2.06
5444,0,53794109,0,0.00,492704.97,2,53810603,16494,53794109,0,0.00,90.50,492704.97,0,19.81,18.81,2.04
5445,0,53794109,0,0.00,492704.97,2,53815349,21240,53794109,0,0.00,90.49,492704.97,1,19.81,18.81,2.05
5446,0,53802973,8864,81.19,492786.16,2,53819781,16808,53802973,8864,81.19,90.49,492786.16,0,18.53,18.81,2.03
5447,0,53802973,0,0.00,492786.16,2,53823812,20839,53802973,0,0.00,90.47,492786.16,1,21.93,19.00,2.04
5448,0,53802973,0,0.00,492786.16,2,53826907,23934,53802973,0,0.00,90.45,492786.16,0,21.96,19.00,2.02
5449,0,53802973,0,0.00,492786.16,2,53829963,26990,53802973,0,0.00,90.44,492786.16,1,21.96,19.00,2.04
5450,0,53802973,0,0.00,492786.16,2,53832897,29924,53802973,0,0.00,90.42,492786.16,0,20.45,19.45,2.02
5451,0,53802973,0,0.00,492786.16,2,53835654,32681,53802973,0,0.00,90.40,492786.16,1,20.45,19.45,2.03
5452,0,53808255,5282,48.40,492834.56,2,53838295,30040,53808255,5282,48.38,90.40,492834.56,1,19.38,19.45,2.02
5453,0,53808255,0,0.00,492834.56,2,53840855,32600,53808255,0,0.00,90.38,492834.56,0,19.47,18.47,2.00
5454,0,53808255,0,0.00,492834.56,2,53843265,35010,53808255,0,0.00,90.36,492834.56,1,19.75,18.75,2.02
5455,0,53812901,4646,42.53,492877.09,2,53845588,32687,53812901,4646,42.55,90.35,492877.09,0,18.53,18.75,2.00
5456,0,53817521,4620,42.31,492919.41,2,53847898,30377,53817521,4620,42.31,90.34,492919.41,1,18.57,18.75,2.02
5457,0,53822169,4648,42.57,492961.97,2,53850222,28053,53822169,4648,42.57,90.34,492961.97,0,17.18,18.75,2.00
5458,0,53827155,4986,45.69,493007.66,2,53852715,25560,53827155,4986,45.67,90.33,493007.66,0,17.48,18.75,2.02
5459,0,53832171,5016,45.94,493053.59,2,53855223,23052,53832171,5016,45.94,90.32,493053.59,1,18.02,18.75,2.04
5460,0,53836867,4696,43.01,493096.62,2,53857571,20704,53836867,4696,43.01,90.31,493096.62,1,16.81,18.75,2.03
5461,0,53841119,4252,38.94,493135.56,2,53859697,18578,53841119,4252,38.94,90.30,493135.56,0,15.56,18.75,2.01
5462,0,53846267,5148,47.15,493182.72,2,53862271,16004,53846267,5148,47.15,90.29,493182.72,1,15.59,18.75,2.02
5463,0,53852679,6412,58.73,493241.44,2,53865477,12798,53852679,6412,58.73,90.29,493241.44,1,14.20,18.75,2.01
5464,0,53867199,14520,132.99,493374.44,2,53872737,5538,53867199,14520,132.99,90.30,493374.44,0,13.02,18.75,1.99
5465,0,53896536,29337,268.69,493643.12,2,53896536,0,53896536,29337,268.70,90.33,493643.12,0,13.19,18.75,2.01
5466,0,53926074,29538,270.52,493913.66,2,53926074,0,53926074,29538,270.54,90.36,493913.66,1,14.83,18.75,2.03
5467,0,53956966,30892,282.98,494196.62,2,53956966,0,53956966,30892,282.94,90.40,494196.62,1,13.27,18.75,1.99
5468,0,53988597,31631,289.68,494486.31,2,53988597,0,53988597,31631,289.71,90.43,494486.31,0,14.64,18.75,1.98
5469,0,54020266,31669,290.05,494776.34,2,54020266,0,54020266,31669,290.06,90.47,494776.34,0,16.43,18.75,1.99
5470,0,54051886,31620,289.65,495066.00,2,54051886,0,54051886,31620,289.61,90.51,495066.00,1,17.34,18.75,2.01
5471,0,54083433,31547,288.91,495354.91,2,54083433,0,54083433,31547,288.94,90.54,495354.91,1,16.52,18.75,1.97
5472,0,54113540,30107,275.76,495630.69,2,54113540,0,54113540,30107,275.75,90.58,495630.69,0,15.52,18.75,1.95
5473,0,54113540,0,0.00,495630.69,2,54123329,9789,54113540,0,0.00,90.56,495630.69,0,21.25,19.00,1.97
5474,0,54113540,0,0.00,495630.69,2,54129118,15578,54113540,0,0.00,90.54,495630.69,1,23.18,19.00,1.98
5475,0,54113540,0,0.00,495630.69,2,54133495,19955,54113540,0,0.00,90.53,495630.69,0,20.92,19.92,1.94
5476,0,54113540,0,0.00,495630.69,2,54137715,24175,54113540,0,0.00,90.51,495630.69,1,21.06,19.00,1.95
5477,0,54113540,0,0.00,495630.69,2,54141429,27889,54113540,0,0.00,90.49,495630.69,0,19.43,18.43,1.93
5478,0,54113540,0,0.00,495630.69,2,54144658,31118,54113540,0,0.00,90.48,495630.69,0,19.43,18.43,1.95
5479,0,54113540,0,0.00,495630.69,2,54147492,33952,54113540,0,0.00,90.46,495630.69,1,19.43,18.43,1.97
5480,0,54119266,5726,52.43,495683.09,2,54150355,31089,54119266,5726,52.44,90.45,495683.09,1,16.68,18.43,1.91
5481,0,54125172,5906,54.11,495737.22,2,54153308,28136,54125172,5906,54.09,90.45,495737.22,0,15.15,18.43,1.89
5482,0,54131020,5848,53.56,495790.78,2,54156232,25212,54131020,5848,53.56,90.44,495790.78,1,15.20,18.43,1.91
5483,0,54136720,5700,52.21,495843.00,2,54159082,22362,54136720,5700,52.21,90.43,495843.00,0,13.39,18.43,1.88
5484,0,54142362,5642,51.66,495894.66,2,54161903,19541,54142362,5642,51.68,90.43,495894.66,1,13.44,18.43,1.90
5485,0,54147916,5554,50.89,495945.53,2,54164680,16764,54147916,5554,50.87,90.42,495945.53,0,12.20,18.43,1.88
5486,0,54153716,5800,53.12,495998.66,2,54167580,13864,54153716,5800,53.12,90.41,495998.66,1,12.25,18.43,1.90
5487,0,54162844,9128,83.60,496082.25,2,54172144,9300,54162844,9128,83.60,90.41,496082.25,0,11.19,18.43,1.89
5488,0,54184476,21632,198.13,496280.41,2,54184476,0,54184476,21632,198.13,90.43,496280.41,1,11.44,18.43,1.91
5489,0,54216088,31612,289.54,496569.94,2,54216088,0,54216088,31612,289.54,90.47,496569.94,1,11.67,18.43,1.89
5490,0,54248719,32631,298.88,496868.81,2,54248719,0,54248719,32631,298.87,90.50,496868.81,0,10.93,18.43,1.88
5491,0,54281170,32451,297.19,497166.00,2,54281170,0,54281170,32451,297.22,90.54,497166.00,0,14.96,18.43,1.90
5492,0,54313745,32575,298.37,497464.38,2,54313745,0,54313745,32575,298.36,90.58,497464.38,1,17.11,18.43,1.91
5493,0,54346209,32464,297.34,497761.72,2,54346209,0,54346209,32464,297.34,90.62,497761.72,1,17.53,18.43,1.88
5494,0,54378185,31976,292.87,498054.59,2,54378185,0,54378185,31976,292.87,90.65,498054.59,0,17.25,18.43,1.87
5495,0,54378185,0,0.00,498054.59,2,54388879,10694,54378185,0,0.00,90.64,498054.59,0,20.96,19.96,1.88
5496,0,54378185,0,0.00,498054.59,2,54395127,16942,54378185,0,0.00,90.62,498054.59,1,21.38,19.00,1.90
5497,0,54378185,0,0.00,498054.59,2,54399865,21680,54378185,0,0.00,90.60,498054.59,0,20.61,19.61,1.86
5498,0,54378185,0,0.00,498054.59,2,54403605,25420,54378185,0,0.00,90.59,498054.59,0,20.61,19.61,1.88
5499,0,54378185,0,0.00,498054.59,2,54407174,28989,54378185,0,0.00,90.57,498054.59,1,20.89,19.89,1.90
5500,0,54378185,0,0.00,498054.59,2,54410589,32404,54378185,0,0.00,90.56,498054.59,0,21.14,19.00,1.89
5501,0,54378185,0,0.00,498054.59,2,54413747,35562,54378185,0,0.00,90.54,498054.59,1,21.43,19.00,1.90
5502,0,54378185,0,0.00,498054.59,2,54416632,38447,54378185,0,0.00,90.52,498054.59,0,19.49,18.49,1.87
5503,0,54378185,0,0.00,498054.59,2,54419339,41154,54378185,0,0.00,90.51,498054.59,1,19.49,18.49,1.89
5504,0,54383409,5224,47.85,498102.44,2,54421951,38542,54383409,5224,47.85,90.50,498102.44,1,17.91,18.49,1.86
5505,0,54388411,5002,45.83,498148.25,2,54424452,36041,54388411,5002,45.81,90.49,498148.25,0,17.54,18.49,1.85
5506,0,54388411,0,0.00,498148.25,2,54426951,38540,54388411,0,0.00,90.47,498148.25,1,18.71,17.71,1.87
5507,0,54393113,4702,43.05,498191.31,2,54429302,36189,54393113,4702,43.07,90.47,498191.31,0,17.00,17.71,1.85
5508,0,54397707,4594,42.10,498233.41,2,54431599,33892,54397707,4594,42.08,90.46,498233.41,1,17.04,17.71,1.86
5509,0,54402043,4336,39.71,498273.12,2,54433767,31724,54402043,4336,39.71,90.45,498273.12,0,15.54,17.71,1.84
5510,0,54406253,4210,38.54,498311.66,2,54435872,29619,54406253,4210,38.56,90.44,498311.66,1,15.58,17.71,1.86
5511,0,54410685,4432,40.59,498352.25,2,54438088,27403,54410685,4432,40.59,90.43,498352.25,0,13.56,17.71,1.83
5512,0,54415073,4388,40.19,498392.44,2,54440282,25209,54415073,4388,40.19,90.42,498392.44,1,13.60,17.71,1.84
5513,0,54419453,4380,40.12,498432.56,2,54442472,23019,54419453,4380,40.12,90.41,498432.56,0,12.52,17.71,1.82
5514,0,54423993,4540,41.58,498474.12,2,54444742,20749,54423993,4540,41.58,90.40,498474.12,1,13.22,17.71,1.84
5515,0,54428849,4856,44.48,498518.62,2,54447170,18321,54428849,4856,44.48,90.39,498518.62,0,11.64,17.71,1.82
5516,0,54434127,5278,48.36,498566.97,2,54449809,15682,54434127,5278,48.34,90.39,498566.97,1,11.68,17.71,1.84
5517,0,54441677,7550,69.13,498636.09,2,54453584,11907,54441677,7550,69.15,90.38,498636.09,0,10.59,17.71,1.82
5518,0,54458971,17294,158.42,498794.53,2,54462231,3260,54458971,17294,158.40,90.39,498794.53,1,10.65,17.71,1.84
5519,0,54491105,32134,294.30,499088.81,2,54491105,0,54491105,32134,294.32,90.43,499088.81,0,9.38,17.71,1.82
5520,0,54524190,33085,303.06,499391.88,2,54524190,0,54524190,33085,303.03,90.47,499391.88,1,10.16,17.71,1.84
5521,0,54556525,32335,296.13,499688.00,2,54556525,0,54556525,32335,296.16,90.51,499688.00,0,11.30,17.71,1.84
5522,0,54589039,32514,297.82,499985.84,2,54589039,0,54589039,32514,297.80,90.54,499985.84,1,13.98,17.71,1.85
5523,0,54622319,33280,304.81,500290.66,2,54622319,0,54622319,33280,304.81,90.58,500290.66,0,14.66,17.71,1.83
5524,0,54654665,32346,296.24,500586.88,2,54654665,0,54654665,32346,296.26,90.62,500586.88,1,17.47,17.71,1.85
5525,0,54654665,0,0.00,500586.88,2,54665021,10356,54654665,0,0.00,90.60,500586.88,0,17.78,16.78,1.84
5526,0,54654665,0,0.00,500586.88,2,54670895,16230,54654665,0,0.00,90.59,500586.88,1,20.35,19.35,1.85
5527,0,54664545,9880,90.49,500677.38,2,54675835,11290,54664545,9880,90.49,90.59,500677.38,0,18.90,19.35,1.83
5528,0,54681501,16956,155.30,500832.69,2,54684313,2812,54681501,16956,155.30,90.60,500832.69,1,19.27,19.35,1.85
5529,0,54681501,0,0.00,500832.69,2,54692778,11277,54681501,0,0.00,90.58,500832.69,0,19.97,18.97,1.84
5530,0,54681501,0,0.00,500832.69,2,54698279,16778,54681501,0,0.00,90.57,500832.69,1,20.69,19.69,1.85
5531,0,54691985,10484,96.02,500928.69,2,54703521,11536,54691985,10484,96.02,90.57,500928.69,0,19.19,19.69,1.83
5532,0,54709825,17840,163.40,501092.09,2,54712441,2616,54709825,17840,163.40,90.58,501092.09,1,19.28,19.69,1.84
5533,0,54740821,30996,283.90,501376.00,2,54740821,0,54740821,30996,283.90,90.62,501376.00,0,18.21,19.69,1.83
5534,0,54772094,31273,286.46,501662.47,2,54772094,0,54772094,31273,286.43,90.65,501662.47,1,18.49,19.69,1.85
5535,0,54802794,30700,281.15,501943.59,2,54802794,0,54802794,30700,281.18,90.69,501943.59,0,17.95,19.69,1.82
5536,0,54802794,0,0.00,501943.59,2,54813146,10352,54802794,0,0.00,90.67,501943.59,1,20.22,19.22,1.84
5537,0,54802794,0,0.00,501943.59,2,54818691,15897,54802794,0,0.00,90.65,501943.59,0,19.34,18.34,1.82
5538,0,54802794,0,0.00,501943.59,2,54822873,20079,54802794,0,0.00,90.64,501943.59,0,20.77,19.77,1.84
5539,0,54802794,0,0.00,501943.59,2,54826911,24117,54802794,0,0.00,90.62,501943.59,1,20.77,19.77,1.86
5540,0,54810428,7634,69.94,502013.53,2,54830728,20300,54810428,7634,69.92,90.62,502013.53,0,19.56,19.77,1.84
5541,0,54810428,0,0.00,502013.53,2,54834288,23860,54810428,0,0.00,90.60,502013.53,1,21.06,19.00,1.86
5542,0,54810428,0,0.00,502013.53,2,54837408,26980,54810428,0,0.00,90.58,502013.53,0,19.91,18.91,1.84
5543,0,54810428,0,0.00,502013.53,2,54840291,29863,54810428,0,0.00,90.57,502013.53,1,19.91,18.91,1.86
5544,0,54815892,5464,50.05,502063.59,2,54843023,27131,54815892,5464,50.05,90.56,502063.59,1,18.58,18.91,1.84
5545,0,54821378,5486,50.23,502113.81,2,54845766,24388,54821378,5486,50.25,90.55,502113.81,0,17.90,18.91,1.83
5546,0,54826572,5194,47.59,502161.41,2,54848363,21791,54826572,5194,47.57,90.54,502161.41,1,18.53,18.91,1.85
5547,0,54831582,5010,45.91,502207.31,2,54850868,19286,54831582,5010,45.89,90.54,502207.31,0,18.35,18.91,1.83
5548,0,54837238,5656,51.80,502259.12,2,54853696,16458,54837238,5656,51.80,90.53,502259.12,1,18.40,18.91,1.85
5549,0,54843488,6250,57.23,502316.34,2,54856821,13333,54843488,6250,57.24,90.52,502316.34,0,17.35,18.91,1.84
5550,0,54856164,12676,116.10,502432.44,2,54863159,6995,54856164,12676,116.10,90.53,502432.44,1,17.41,18.91,1.86
5551,0,54884762,28598,261.91,502694.34,2,54884762,0,54884762,28598,261.93,90.56,502694.34,0,17.70,18.91,1.84
5552,0,54884762,0,0.00,502694.34,2,54894751,9989,54884762,0,0.00,90.54,502694.34,1,19.13,18.13,1.86
5553,0,54884762,0,0.00,502694.34,2,54900508,15746,54884762,0,0.00,90.53,502694.34,0,19.28,18.28,1.85
5554,0,54884762,0,0.00,502694.34,2,54904841,20079,54884762,0,0.00,90.51,502694.34,1,19.82,18.82,1.86
5555,0,54884762,0,0.00,502694.34,2,54908771,24009,54884762,0,0.00,90.49,502694.34,0,19.60,18.60,1.84
5556,0,54884762,0,0.00,502694.34,2,54912334,27572,54884762,0,0.00,90.48,502694.34,1,19.60,18.60,1.86
5557,0,54891094,6332,58.03,502752.38,2,54915500,24406,54891094,6332,58.00,90.47,502752.38,0,18.25,18.60,1.84
5558,0,54897962,6868,62.87,502815.25,2,54918934,20972,54897962,6868,62.90,90.47,502815.25,1,18.60,18.60,1.86
5559,0,54897962,0,0.00,502815.25,2,54922153,24191,54897962,0,0.00,90.45,502815.25,0,18.99,17.99,1.84
5560,0,54897962,0,0.00,502815.25,2,54924988,27026,54897962,0,0.00,90.43,502815.25,1,18.99,17.99,1.86
5561,0,54903246,5284,48.43,502863.69,2,54927630,24384,54903246,5284,48.40,90.43,502863.69,0,17.38,17.99,1.84
5562,0,54908484,5238,47.96,502911.66,2,54930249,21765,54908484,5238,47.98,90.42,502911.66,1,17.43,17.99,1.86
5563,0,54913666,5182,47.44,502959.09,2,54932840,19174,54913666,5182,47.46,90.41,502959.09,0,16.11,17.99,1.84
5564,0,54919142,5476,50.19,503009.28,2,54935578,16436,54919142,5476,50.16,90.40,503009.28,1,16.15,17.99,1.86
5565,0,54925642,6500,59.50,503068.78,2,54938828,13186,54925642,6500,59.53,90.40,503068.78,0,15.22,17.99,1.84
5566,0,54938812,13170,120.64,503189.41,2,54945413,6601,54938812,13170,120.63,90.40,503189.41,1,15.84,17.99,1.86
5567,0,54963927,25115,230.04,503419.47,2,54963927,0,54963927,25115,230.03,90.43,503419.47,0,15.09,17.99,1.85
5568,0,54996030,32103,294.04,503713.50,2,54996030,0,54996030,32103,294.03,90.47,503713.50,1,15.45,17.99,1.87
5569,0,55027976,31946,292.58,504006.09,2,55027976,0,55027976,31946,292.60,90.50,504006.09,0,16.21,17.99,1.86
5570,0,55059740,31764,290.93,504297.00,2,55059740,0,55059740,31764,290.93,90.54,504297.00,1,17.66,17.99,1.88
5571,0,55091677,31937,292.50,504589.53,2,55091677,0,55091677,31937,292.51,90.57,504589.53,0,17.46,17.99,1.86
5572,0,55091677,0,0.00,504589.53,2,55102746,11069,55091677,0,0.00,90.56,504589.53,1,21.10,19.00,1.88
5573,0,55091677,0,0.00,504589.53,2,55108221,16544,55091677,0,0.00,90.54,504589.53,0,22.02,19.00,1.87
5574,0,55091677,0,0.00,504589.53,2,55112771,21094,55091677,0,0.00,90.53,504589.53,1,22.09,19.00,1.89
5575,0,55091677,0,0.00,504589.53,2,55116732,25055,55091677,0,0.00,90.51,504589.53,0,20.91,19.91,1.88
5576,0,55091677,0,0.00,504589.53,2,55120289,28612,55091677,0,0.00,90.49,504589.53,1,21.03,19.00,1.89
5577,0,55091677,0,0.00,504589.53,2,55123522,31845,55091677,0,0.00,90.48,504589.53,0,19.84,18.84,1.88
5578,0,55091677,0,0.00,504589.53,2,55126511,34834,55091677,0,0.00,90.46,504589.53,1,19.84,18.84,1.90
5579,0,55097403,5726,52.46,504641.97,2,55129374,31971,55097403,5726,52.44,90.45,504641.97,0,18.65,18.84,1.89
5580,0,55103113,5710,52.28,504694.25,2,55132229,29116,55103113,5710,52.30,90.45,504694.25,1,18.70,18.84,1.90
5581,0,55108545,5432,49.75,504744.00,2,55134945,26400,55108545,5432,49.75,90.44,504744.00,0,17.48,18.84,1.89
5582,0,55113853,5308,48.62,504792.62,2,55137599,23746,55113853,5308,48.62,90.43,504792.62,1,17.53,18.84,1.91
5583,0,55119131,5278,48.36,504841.00,2,55140238,21107,55119131,5278,48.34,90.42,504841.00,0,16.44,18.84,1.90
5584,0,55124707,5576,51.07,504892.06,2,55143026,18319,55124707,5576,51.07,90.42,504892.06,1,16.49,18.84,1.91
5585,0,55130391,5684,52.06,504944.12,2,55145868,15477,55130391,5684,52.06,90.41,504944.12,0,14.97,18.84,1.89
5586,0,55137239,6848,62.72,505006.84,2,55149292,12053,55137239,6848,62.72,90.41,505006.84,1,15.27,18.84,1.91
5587,0,55152675,15436,141.38,505148.22,2,55157010,4335,55152675,15436,141.38,90.41,505148.22,0,15.87,18.84,1.90
5588,0,55182767,30092,275.62,505423.84,2,55182767,0,55182767,30092,275.62,90.45,505423.84,1,16.00,18.84,1.92
5589,0,55214308,31541,288.88,505712.72,2,55214308,0,55214308,31541,288.89,90.48,505712.72,0,16.76,18.84,1.89
5590,0,55246401,32093,293.93,506006.66,2,55246401,0,55246401,32093,293.94,90.52,506006.66,1,17.19,18.84,1.91
5591,0,55278929,32528,297.93,506304.56,2,55278929,0,55278929,32528,297.93,90.56,506304.56,0,16.69,18.84,1.90
5592,0,55311731,32802,300.45,506605.03,2,55311731,0,55311731,32802,300.44,90.59,506605.03,1,18.34,18.84,1.92
5593,0,55344363,32632,298.88,506903.91,2,55344363,0,55344363,32632,298.88,90.63,506903.91,0,18.79,18.84,1.89
5594,0,55344363,0,0.00,506903.91,2,55355333,10970,55344363,0,0.00,90.62,506903.91,1,21.09,19.00,1.91
5595,0,55344363,0,0.00,506903.91,2,55361048,16685,55344363,0,0.00,90.60,506903.91,0,22.15,19.00,1.91
5596,0,55344363,0,0.00,506903.91,2,55365325,20962,55344363,0,0.00,90.58,506903.91,0,22.15,19.00,1.92
5597,0,55344363,0,0.00,506903.91,2,55369103,24740,55344363,0,0.00,90.57,506903.91,1,22.44,19.00,1.94
5598,0,55344363,0,0.00,506903.91,2,55372674,28311,55344363,0,0.00,90.55,506903.91,0,22.48,19.00,1.92
5599,0,55344363,0,0.00,506903.91,2,55375805,31442,55344363,0,0.00,90.53,506903.91,1,22.77,19.00,1.94
5600,0,55344363,0,0.00,506903.91,2,55378696,34333,55344363,0,0.00,90.52,506903.91,1,21.54,19.00,1.93
5601,0,55344363,0,0.00,506903.91,2,55381469,37106,55344363,0,0.00,90.50,506903.91,0,20.66,19.66,1.92
5602,0,55344363,0,0.00,506903.91,2,55384162,39799,55344363,0,0.00,90.49,506903.91,1,20.94,19.94,1.94
5603,0,55344363,0,0.00,506903.91,2,55386727,42364,55344363,0,0.00,90.47,506903.91,0,20.66,19.66,1.94
5604,0,55344363,0,0.00,506903.91,2,55389182,44819,55344363,0,0.00,90.45,506903.91,1,21.82,19.00,1.95
5605,0,55344363,0,0.00,506903.91,2,55391514,47151,55344363,0,0.00,90.44,506903.91,1,20.78,19.78,1.94
5606,0,55344363,0,0.00,506903.91,2,55393564,49201,55344363,0,0.00,90.42,506903.91,0,19.95,18.95,1.93
5607,0,55344363,0,0.00,506903.91,2,55395568,51205,55344363,0,0.00,90.41,506903.91,1,19.95,18.95,1.95
5608,0,55348579,4216,38.61,506942.53,2,55397676,49097,55348579,4216,38.61,90.40,506942.53,0,18.65,18.95,1.93
5609,0,55352729,4150,37.99,506980.50,2,55399751,47022,55352729,4150,38.01,90.39,506980.50,0,18.83,18.95,1.95
5610,0,55352729,0,0.00,506980.50,2,55401788,49059,55352729,0,0.00,90.37,506980.50,1,19.42,18.42,1.97
5611,0,55352729,0,0.00,506980.50,2,55403733,51004,55352729,0,0.00,90.35,506980.50,0,18.58,17.58,1.95
5612,0,55352729,0,0.00,506980.50,2,55405596,52867,55352729,0,0.00,90.34,506980.50,1,18.58,17.58,1.96
5613,0,55356381,3652,33.45,507013.97,2,55407422,51041,55356381,3652,33.45,90.33,507013.97,0,16.83,17.58,1.94
5614,0,55360021,3640,33.34,507047.31,2,55409242,49221,55360021,3640,33.34,90.32,507047.31,1,16.87,17.58,1.95
5615,0,55363549,3528,32.31,507079.62,2,55411006,47457,55363549,3528,32.31,90.31,507079.62,0,15.54,17.58,1.94
5616,0,55367093,3544,32.46,507112.06,2,55412778,45685,55367093,3544,32.46,90.30,507112.06,1,15.70,17.58,1.96
5617,0,55370667,3574,32.75,507144.84,2,55414565,43898,55370667,3574,32.73,90.29,507144.84,0,14.49,17.58,1.94
5618,0,55374099,3432,31.43,507176.25,2,55416281,42182,55374099,3432,31.43,90.28,507176.25,0,14.52,17.58,1.96
5619,0,55377455,3356,30.74,507207.00,2,55417959,40504,55377455,3356,30.74,90.27,507207.00,1,14.63,17.58,1.97
5620,0,55380953,3498,32.02,507239.03,2,55419708,38755,55380953,3498,32.04,90.26,507239.03,0,13.40,17.58,1.96
5621,0,55384355,3402,31.18,507270.19,2,55421409,37054,55384355,3402,31.16,90.25,507270.19,1,13.43,17.58,1.98
5622,0,55387687,3332,30.52,507300.72,2,55423075,35388,55387687,3332,30.52,90.23,507300.72,1,12.24,17.58,1.96
5623,0,55390933,3246,29.71,507330.44,2,55424698,33765,55390933,3246,29.73,90.22,507330.44,0,11.05,17.58,1.95
5624,0,55394135,3202,29.35,507359.78,2,55426299,32164,55394135,3202,29.33,90.21,507359.78,1,11.08,17.58,1.97
5625,0,55397409,3274,29.97,507389.75,2,55427936,30527,55397409,3274,29.99,90.20,507389.75,1,10.35,17.58,1.97
5626,0,55400823,3414,31.29,507421.03,2,55429643,28820,55400823,3414,31.27,90.19,507421.03,0,9.27,17.58,1.96
5627,0,55404301,3478,31.84,507452.88,2,55431382,27081,55404301,3478,31.86,90.18,507452.88,0,9.30,17.58,1.98
5628,0,55408013,3712,34.00,507486.88,2,55433238,25225,55408013,3712,34.00,90.17,507486.88,1,9.33,17.58,1.99
5629,0,55411923,3910,35.83,507522.69,2,55435193,23270,55411923,3910,35.81,90.16,507522.69,0,8.23,17.58,1.98
5630,0,55415981,4058,37.15,507559.84,2,55437222,21241,55415981,4058,37.17,90.15,507559.84,1,8.26,17.58,2.00
5631,0,55420329,4348,39.82,507599.66,2,55439396,19067,55420329,4348,39.82,90.14,507599.66,0,7.01,17.58,1.98
5632,0,55425315,4986,45.69,507645.34,2,55441889,16574,55425315,4986,45.67,90.14,507645.34,1,7.15,17.58,2.00
5633,0,55433209,7894,72.28,507717.62,2,55445836,12627,55433209,7894,72.30,90.13,507717.62,0,5.81,17.58,1.98
5634,0,55448621,15412,141.16,507858.81,2,55453542,4921,55448621,15412,141.16,90.14,507858.81,1,6.30,17.58,2.00
5635,0,55479006,30385,278.33,508137.12,2,55479006,0,55479006,30385,278.30,90.18,508137.12,0,6.42,17.58,1.99
5636,0,55512984,33978,311.19,508448.31,2,55512984,0,55512984,33978,311.21,90.21,508448.31,1,7.77,17.58,2.00
5637,0,55546919,33935,310.82,508759.12,2,55546919,0,55546919,33935,310.81,90.25,508759.12,0,7.06,17.58,2.00
5638,0,55580262,33343,305.40,509064.53,2,55580262,0,55580262,33343,305.39,90.29,509064.53,0,7.83,17.58,2.01
5639,0,55612495,32233,295.22,509359.75,2,55612495,0,55612495,32233,295.22,90.33,509359.75,1,10.97,17.58,2.03
5640,0,55643940,31445,288.00,509647.75,2,55643940,0,55643940,31445,288.01,90.36,509647.75,0,11.25,17.58,2.02
5641,0,55643940,0,0.00,509647.75,2,55654619,10679,55643940,0,0.00,90.35,509647.75,1,17.91,16.91,2.03
5642,0,55665480,21540,197.29,509845.03,2,55665480,0,55665480,21540,197.29,90.37,509845.03,0,16.89,16.91,2.01
5643,0,55665480,0,0.00,509845.03,2,55676727,11247,55665480,0,0.00,90.35,509845.03,1,18.24,17.24,2.03
5644,0,55684670,19190,175.78,510020.81,2,55686322,1652,55684670,19190,175.76,90.37,510020.81,0,16.82,17.24,2.01
5645,0,55717108,32438,297.08,510317.91,2,55717108,0,55717108,32438,297.10,90.40,510317.91,1,16.99,17.24,2.02
5646,0,55748612,31504,288.55,510606.44,2,55748612,0,55748612,31504,288.55,90.44,510606.44,0,16.32,17.24,2.02
5647,0,55779303,30691,281.11,510887.56,2,55779303,0,55779303,30691,281.10,90.47,510887.56,1,16.67,17.24,2.04
5648,0,55779303,0,0.00,510887.56,2,55789939,10636,55779303,0,0.00,90.45,510887.56,0,17.32,16.32,2.02
5649,0,55779303,0,0.00,510887.56,2,55796086,16783,55779303,0,0.00,90.44,510887.56,1,18.18,17.18,2.03
5650,0,55779303,0,0.00,510887.56,2,55800856,21553,55779303,0,0.00,90.42,510887.56,1,18.08,17.08,2.02
5651,0,55787995,8692,79.61,510967.19,2,55805202,17207,55787995,8692,79.61,90.42,510967.19,0,17.00,17.08,2.01
5652,0,55787995,0,0.00,510967.19,2,55808996,21001,55787995,0,0.00,90.40,510967.19,1,17.36,16.36,2.03
5653,0,55787995,0,0.00,510967.19,2,55812185,24190,55787995,0,0.00,90.39,510967.19,0,17.87,16.87,2.02
5654,0,55787995,0,0.00,510967.19,2,55815232,27237,55787995,0,0.00,90.37,510967.19,1,17.87,16.87,2.03
5655,0,55793677,5682,52.02,511019.19,2,55818073,24396,55793677,5682,52.04,90.37,511019.19,0,16.70,16.87,2.02
5656,0,55799325,5648,51.73,511070.94,2,55820897,21572,55799325,5648,51.73,90.36,511070.94,1,16.76,16.87,2.04
5657,0,55805011,5686,52.10,511123.03,2,55823740,18729,55805011,5686,52.08,90.35,511123.03,0,15.91,16.87,2.03
5658,0,55805011,0,0.00,511123.03,2,55826421,21410,55805011,0,0.00,90.34,511123.03,0,17.39,16.39,2.04
5659,0,55805011,0,0.00,511123.03,2,55828835,23824,55805011,0,0.00,90.32,511123.03,1,17.67,16.67,2.06
5660,0,55809799,4788,43.85,511166.88,2,55831229,21430,55809799,4788,43.85,90.31,511166.88,0,16.46,16.67,2.05
5661,0,55814707,4908,44.95,511211.84,2,55833683,18976,55814707,4908,44.95,90.30,511211.84,1,16.50,16.67,2.07
5662,0,55819893,5186,47.48,511259.31,2,55836276,16383,55819893,5186,47.50,90.30,511259.31,0,15.31,16.67,2.05
5663,0,55827623,7730,70.82,511330.12,2,55840141,12518,55827623,7730,70.80,90.29,511330.12,1,15.64,16.67,2.07
5664,0,55840941,13318,121.96,511452.09,2,55846800,5859,55840941,13318,121.98,90.30,511452.09,1,16.21,16.67,2.06
5665,0,55869006,28065,257.08,511709.16,2,55869006,0,55869006,28065,257.05,90.33,511709.16,0,15.54,16.67,2.06
5666,0,55869006,0,0.00,511709.16,2,55879380,10374,55869006,0,0.00,90.31,511709.16,1,17.80,16.80,2.07
5667,0,55869006,0,0.00,511709.16,2,55885524,16518,55869006,0,0.00,90.30,511709.16,0,18.35,17.35,2.06
5668,0,55869006,0,0.00,511709.16,2,55890139,21133,55869006,0,0.00,90.28,511709.16,1,18.63,17.63,2.08
5669,0,55877202,8196,75.03,511784.19,2,55894237,17035,55877202,8196,75.07,90.28,511784.19,0,17.58,17.63,2.07
5670,0,55877202,0,0.00,511784.19,2,55898091,20889,55877202,0,0.00,90.26,511784.19,1,18.51,17.51,2.09
5671,0,55877202,0,0.00,511784.19,2,55901391,24189,55877202,0,0.00,90.25,511784.19,0,18.46,17.46,2.08
5672,0,55877202,0,0.00,511784.19,2,55904333,27131,55877202,0,0.00,90.23,511784.19,1,18.46,17.46,2.09
5673,0,55882590,5388,49.39,511833.59,2,55907027,24437,55882590,5388,49.35,90.22,511833.59,0,17.02,17.46,2.07
5674,0,55888454,5864,53.71,511887.28,2,55909959,21505,55888454,5864,53.71,90.22,511887.28,1,17.07,17.46,2.09
5675,0,55894254,5800,53.12,511940.41,2,55912859,18605,55894254,5800,53.12,90.21,511940.41,0,16.98,17.46,2.08
5676,0,55894254,0,0.00,511940.41,2,55915633,21379,55894254,0,0.00,90.19,511940.41,1,18.30,17.30,2.10
5677,0,55894254,0,0.00,511940.41,2,55918096,23842,55894254,0,0.00,90.18,511940.41,0,17.31,16.31,2.09
5678,0,55894254,0,0.00,511940.41,2,55920327,26073,55894254,0,0.00,90.16,511940.41,0,17.31,16.31,2.11
5679,0,55894254,0,0.00,511940.41,2,55922382,28128,55894254,0,0.00,90.15,511940.41,1,17.43,16.43,2.13
5680,0,55898390,4136,37.88,511978.31,2,55924450,26060,55898390,4136,37.88,90.14,511978.31,0,16.01,16.43,2.11
5681,0,55902592,4202,38.47,512016.78,2,55926551,23959,55902592,4202,38.49,90.13,512016.78,1,16.04,16.43,2.13
5682,0,55906814,4222,38.69,512055.47,2,55928662,21848,55906814,4222,38.67,90.12,512055.47,1,15.36,16.43,2.13
5683,0,55911456,4642,42.50,512097.97,2,55930983,19527,55911456,4642,42.52,90.11,512097.97,0,14.71,16.43,2.13
5684,0,55916774,5318,48.73,512146.69,2,55933642,16868,55916774,5318,48.71,90.10,512146.69,1,14.75,16.43,2.14
5685,0,55923804,7030,64.37,512211.06,2,55937157,13353,55923804,7030,64.39,90.10,512211.06,0,14.27,16.43,2.15
5686,0,55936282,12478,114.27,512325.31,2,55943396,7114,55936282,12478,114.29,90.10,512325.31,1,14.34,16.43,2.17
5687,0,55962038,25756,235.94,512561.25,2,55962038,0,55962038,25756,235.90,90.13,512561.25,0,15.34,16.43,2.16
5688,0,55994045,32007,293.13,512854.38,2,55994045,0,55994045,32007,293.15,90.16,512854.38,1,15.80,16.43,2.18
5689,0,55994045,0,0.00,512854.38,2,56004489,10444,55994045,0,0.00,90.15,512854.38,0,17.15,16.15,2.18
5690,0,55994045,0,0.00,512854.38,2,56010607,16562,55994045,0,0.00,90.13,512854.38,1,19.16,18.16,2.20
5691,0,55994045,0,0.00,512854.38,2,56015286,21241,55994045,0,0.00,90.12,512854.38,0,18.27,17.27,2.19
5692,0,55994045,0,0.00,512854.38,2,56019328,25283,55994045,0,0.00,90.10,512854.38,1,18.55,17.55,2.21
5693,0,55994045,0,0.00,512854.38,2,56022943,28898,55994045,0,0.00,90.09,512854.38,0,19.05,18.05,2.20
5694,0,55994045,0,0.00,512854.38,2,56026230,32185,55994045,0,0.00,90.07,512854.38,1,19.34,18.34,2.22
5695,0,56000321,6276,57.48,512911.88,2,56029368,29047,56000321,6276,57.48,90.06,512911.88,0,18.17,18.34,2.21
5696,0,56006373,6052,55.43,512967.31,2,56032394,26021,56006373,6052,55.43,90.06,512967.31,1,18.22,18.34,2.23
5697,0,56012077,5704,52.24,513019.53,2,56035246,23169,56012077,5704,52.24,90.05,513019.53,0,17.46,18.34,2.22
5698,0,56017957,5880,53.86,513073.41,2,56038186,20229,56017957,5880,53.86,90.04,513073.41,0,17.51,18.34,2.24
5699,0,56023699,5742,52.61,513126.00,2,56041057,17358,56023699,5742,52.59,90.04,513126.00,1,17.57,18.34,2.26
5700,0,56029715,6016,55.10,513181.09,2,56044065,14350,56029715,6016,55.10,90.03,513181.09,1,16.20,18.34,2.24
5701,0,56037673,7958,72.87,513253.97,2,56048044,10371,56037673,7958,72.89,90.03,513253.97,0,15.60,18.34,2.24
5702,0,56056907,19234,176.18,513430.16,2,56057661,754,56056907,19234,176.17,90.04,513430.16,1,15.67,18.34,2.26
5703,0,56088317,31410,287.67,513717.84,2,56088317,0,56088317,31410,287.69,90.08,513717.84,0,15.41,18.34,2.25
5704,0,56119140,30823,282.32,514000.16,2,56119140,0,56119140,30823,282.31,90.11,514000.16,1,17.13,18.34,2.27
5705,0,56119140,0,0.00,514000.16,2,56129315,10175,56119140,0,0.00,90.10,514000.16,0,18.53,17.53,2.26
5706,0,56119140,0,0.00,514000.16,2,56134961,15821,56119140,0,0.00,90.08,514000.16,1,18.53,17.53,2.28
5707,0,56119140,0,0.00,514000.16,2,56139088,19948,56119140,0,0.00,90.06,514000.16,0,19.39,18.39,2.28
5708,0,56119140,0,0.00,514000.16,2,56142686,23546,56119140,0,0.00,90.05,514000.16,1,19.73,18.73,2.29
5709,0,56125836,6696,61.33,514061.47,2,56146034,20198,56125836,6696,61.33,90.04,514061.47,0,18.68,18.73,2.29
5710,0,56125836,0,0.00,514061.47,2,56149226,23390,56125836,0,0.00,90.03,514061.47,1,18.74,17.74,2.30
5711,0,56125836,0,0.00,514061.47,2,56152067,26231,56125836,0,0.00,90.01,514061.47,0,18.00,17.00,2.30
5712,0,56125836,0,0.00,514061.47,2,56154716,28880,56125836,0,0.00,90.00,514061.47,1,18.00,17.00,2.32
5713,0,56131204,5368,49.17,514110.66,2,56157400,26196,56131204,5368,49.17,89.99,514110.66,0,16.78,17.00,2.30
5714,0,56131204,0,0.00,514110.66,2,56159987,28783,56131204,0,0.00,89.97,514110.66,1,17.31,16.31,2.32
5715,0,56131204,0,0.00,514110.66,2,56162234,31030,56131204,0,0.00,89.96,514110.66,0,16.59,15.59,2.32
5716,0,56131204,0,0.00,514110.66,2,56164472,33268,56131204,0,0.00,89.94,514110.66,1,16.59,15.59,2.33
5717,0,56135444,4240,38.83,514149.47,2,56166592,31148,56135444,4240,38.83,89.93,514149.47,0,15.57,15.59,2.33
5718,0,56135444,0,0.00,514149.47,2,56168725,33281,56135444,0,0.00,89.92,514149.47,1,15.61,14.61,2.34
5719,0,56135444,0,0.00,514149.47,2,56170742,35298,56135444,0,0.00,89.90,514149.47,0,14.66,13.66,2.34
5720,0,56135444,0,0.00,514149.47,2,56172768,37324,56135444,0,0.00,89.89,514149.47,1,14.66,13.66,2.36
5721,0,56135444,0,0.00,514149.47,2,56174746,39302,56135444,0,0.00,89.87,514149.47,0,13.79,12.79,2.35
5722,0,56135444,0,0.00,514149.47,2,56176648,41204,56135444,0,0.00,89.85,514149.47,1,13.79,12.79,2.37
5723,0,56135444,0,0.00,514149.47,2,56178482,43038,56135444,0,0.00,89.84,514149.47,0,12.82,11.82,2.36
5724,0,56135444,0,0.00,514149.47,2,56180253,44809,56135444,0,0.00,89.82,514149.47,1,12.98,11.98,2.38
5725,0,56135444,0,0.00,514149.47,2,56181983,46539,56135444,0,0.00,89.81,514149.47,0,12.45,11.45,2.37
5726,0,56135444,0,0.00,514149.47,2,56183673,48229,56135444,0,0.00,89.79,514149.47,0,12.93,11.93,2.39
5727,0,56135444,0,0.00,514149.47,2,56185311,49867,56135444,0,0.00,89.78,514149.47,1,13.16,12.16,2.41
5728,0,56135444,0,0.00,514149.47,2,56186912,51468,56135444,0,0.00,89.76,514149.47,1,12.24,11.24,2.40
5729,0,56135444,0,0.00,514149.47,2,56188474,53030,56135444,0,0.00,89.75,514149.47,0,11.41,10.41,2.40
5730,0,56135444,0,0.00,514149.47,2,56190004,54560,56135444,0,0.00,89.73,514149.47,1,11.41,10.41,2.42
5731,0,56135444,0,0.00,514149.47,2,56191497,56053,56135444,0,0.00,89.71,514149.47,0,10.55,9.55,2.41
5732,0,56135444,0,0.00,514149.47,2,56192852,57408,56135444,0,0.00,89.70,514149.47,1,10.55,9.55,2.43
5733,0,56135444,0,0.00,514149.47,2,56194180,58736,56135444,0,0.00,89.68,514149.47,0,9.78,8.78,2.43
5734,0,56135444,0,0.00,514149.47,2,56195481,60037,56135444,0,0.00,89.67,514149.47,1,9.78,8.78,2.45
5735,0,56135444,0,0.00,514149.47,2,56196739,61295,56135444,0,0.00,89.65,514149.47,0,8.96,8.00,2.44
5736,0,56138096,2652,24.29,514173.78,2,56198065,59969,56138096,2652,24.29,89.64,514173.78,1,8.96,9.96,2.46
5737,0,56140856,2760,25.28,514199.06,2,56199445,58589,56140856,2760,25.28,89.63,514199.06,0,8.20,9.96,2.46
5738,0,56143568,2712,24.84,514223.88,2,56200801,57233,56143568,2712,24.84,89.62,514223.88,1,8.56,9.96,2.47
5739,0,56146356,2788,25.54,514249.44,2,56202195,55839,56146356,2788,25.54,89.61,514249.44,0,7.95,9.96,2.47
5740,0,56149228,2872,26.30,514275.72,2,56203631,54403,56149228,2872,26.30,89.60,514275.72,1,7.98,9.96,2.49
5741,0,56152128,2900,26.56,514302.28,2,56205081,52953,56152128,2900,26.56,89.58,514302.28,0,7.67,9.96,2.49
5742,0,56155068,2940,26.93,514329.22,2,56206551,51483,56155068,2940,26.93,89.57,514329.22,1,7.70,9.96,2.50
5743,0,56158002,2934,26.85,514356.06,2,56208018,50016,56158002,2934,26.87,89.56,514356.06,0,6.93,9.96,2.50
5744,0,56161006,3004,27.55,514383.62,2,56209520,48514,56161006,3004,27.51,89.55,514383.62,1,7.53,9.96,2.52
5745,0,56163976,2970,27.18,514410.81,2,56211005,47029,56163976,2970,27.20,89.54,514410.81,0,6.66,9.96,2.51
5746,0,56166988,3012,27.59,514438.41,2,56212511,45523,56166988,3012,27.59,89.53,514438.41,1,6.69,9.96,2.53
5747,0,56170074,3086,28.25,514466.62,2,56214054,43980,56170074,3086,28.26,89.52,514466.62,0,5.68,9.96,2.52
5748,0,56173086,3012,27.62,514494.25,2,56215560,42474,56173086,3012,27.59,89.51,514494.25,1,5.70,9.96,2.54
5749,0,56176160,3074,28.14,514522.41,2,56217097,40937,56176160,3074,28.16,89.50,514522.41,0,4.91,9.96,2.54
5750,0,56179252,3092,28.32,514550.72,2,56218643,39391,56179252,3092,28.32,89.49,514550.72,1,4.94,9.96,2.55
5751,0,56182298,3046,27.88,514578.59,2,56220166,37868,56182298,3046,27.90,89.48,514578.59,1,3.68,9.96,2.54
5752,0,56185456,3158,28.94,514607.53,2,56221745,36289,56185456,3158,28.92,89.47,514607.53,0,3.58,9.96,2.54
5753,0,56188624,3168,29.02,514636.56,2,56223329,34705,56188624,3168,29.02,89.46,514636.56,1,4.42,9.96,2.56
5754,0,56191582,2958,27.11,514663.66,2,56224808,33226,56191582,2958,27.09,89.44,514663.66,0,4.84,9.96,2.56
5755,0,56194586,3004,27.48,514691.16,2,56226310,31724,56194586,3004,27.51,89.43,514691.16,1,5.15,9.96,2.58
5756,0,56197768,3182,29.16,514720.31,2,56227901,30133,56197768,3182,29.14,89.42,514720.31,0,4.22,9.96,2.57
5757,0,56201042,3274,29.97,514750.28,2,56229538,28496,56201042,3274,29.99,89.41,514750.28,0,4.25,9.96,2.59
5758,0,56204398,3356,30.77,514781.06,2,56231216,26818,56204398,3356,30.74,89.40,514781.06,1,4.27,9.96,2.61
5759,0,56207996,3598,32.94,514814.00,2,56233015,25019,56207996,3598,32.95,89.39,514814.00,0,2.77,9.96,2.59
5760,0,56211780,3784,34.66,514848.66,2,56234907,23127,56211780,3784,34.66,89.38,514848.66,1,2.80,9.96,2.60
5761,0,56215818,4038,36.97,514885.62,2,56236926,21108,56215818,4038,36.98,89.37,514885.62,0,1.24,9.96,2.58
5762,0,56220132,4314,39.53,514925.16,2,56239083,18951,56220132,4314,39.51,89.37,514925.16,1,1.28,9.96,2.59
5763,0,56224904,4772,43.71,514968.84,2,56241469,16565,56224904,4772,43.71,89.36,514968.84,1,1.32,9.96,2.57
5764,0,56232192,7288,66.75,515035.59,2,56245113,12921,56232192,7288,66.75,89.35,515035.59,0,0.32,9.96,2.56
5765,0,56244772,12580,115.22,515150.81,2,56251403,6631,56244772,12580,115.22,89.36,515150.81,0,0.38,9.96,2.58
5766,0,56270438,25666,235.10,515385.91,2,56270438,0,56270438,25666,235.08,89.38,515385.91,1,0.50,9.96,2.59
5767,0,56302409,31971,292.80,515678.72,2,56302409,0,56302409,31971,292.83,89.42,515678.72,1,0.50,9.96,2.56
5768,0,56334544,32135,294.34,515973.06,2,56334544,0,56334544,32135,294.33,89.45,515973.06,0,0.50,9.96,2.56
5769,0,56367287,32743,299.91,516272.97,2,56367287,0,56367287,32743,299.90,89.49,516272.97,0,1.31,9.96,2.58
5770,0,56400030,32743,299.91,516572.88,2,56400030,0,56400030,32743,299.90,89.53,516572.88,1,2.60,9.96,2.59
5771,0,56432960,32930,301.59,516874.47,2,56432960,0,56432960,32930,301.61,89.56,516874.47,0,2.77,9.96,2.55
5772,0,56465560,32600,298.59,517173.03,2,56465560,0,56465560,32600,298.59,89.60,517173.03,1,5.07,9.96,2.57
5773,0,56498122,32562,298.22,517471.25,2,56498122,0,56498122,32562,298.24,89.64,517471.25,0,4.71,9.96,2.56
5774,0,56530493,32371,296.50,517767.75,2,56530493,0,56530493,32371,296.49,89.67,517767.75,1,5.05,9.96,2.58
5775,0,56563110,32617,298.77,518066.53,2,56563110,0,56563110,32617,298.74,89.71,518066.53,0,3.61,9.96,2.55
5776,0,56595137,32027,293.31,518359.84,2,56595137,0,56595137,32027,293.34,89.74,518359.84,1,4.34,9.96,2.57
5777,0,56627340,32203,294.96,518654.81,2,56627340,0,56627340,32203,294.95,89.78,518654.81,0,4.10,9.96,2.55
5778,0,56660407,33067,302.87,518957.66,2,56660407,0,56660407,33067,302.86,89.82,518957.66,0,6.37,9.96,2.56
5779,0,56692407,32000,293.09,519250.75,2,56692407,0,56692407,32000,293.09,89.85,519250.75,1,8.67,9.96,2.58
5780,0,56724643,32236,295.25,519546.00,2,56724643,0,56724643,32236,295.25,89.89,519546.00,0,9.58,9.96,2.56
5781,0,56724643,0,0.00,519546.00,2,56735092,10449,56724643,0,0.00,89.87,519546.00,1,11.87,10.87,2.58
5782,0,56724643,0,0.00,519546.00,2,56740713,16070,56724643,0,0.00,89.86,519546.00,1,12.39,11.39,2.56
5783,0,56735501,10858,99.43,519645.44,2,56746142,10641,56735501,10858,99.45,89.86,519645.44,0,11.02,11.39,2.55
5784,0,56735501,0,0.00,519645.44,2,56751241,15740,56735501,0,0.00,89.84,519645.44,1,11.41,10.41,2.56
5785,0,56735501,0,0.00,519645.44,2,56754896,19395,56735501,0,0.00,89.83,519645.44,0,11.92,10.92,2.55
5786,0,56735501,0,0.00,519645.44,2,56757998,22497,56735501,0,0.00,89.81,519645.44,1,11.92,10.92,2.57
5787,0,56741297,5796,53.09,519698.53,2,56760896,19599,56741297,5796,53.09,89.80,519698.53,0,10.75,10.92,2.55
5788,0,56747615,6318,57.89,519756.41,2,56764055,16440,56747615,6318,57.87,89.80,519756.41,1,10.80,10.92,2.57
5789,0,56756103,8488,77.74,519834.16,2,56768299,12196,56756103,8488,77.74,89.80,519834.16,0,10.84,10.92,2.56
5790,0,56756103,0,0.00,519834.16,2,56772324,16221,56756103,0,0.00,89.78,519834.16,1,11.64,10.64,2.57
5791,0,56756103,0,0.00,519834.16,2,56775517,19414,56756103,0,0.00,89.77,519834.16,0,10.66,9.66,2.56
5792,0,56756103,0,0.00,519834.16,2,56778228,22125,56756103,0,0.00,89.75,519834.16,1,10.78,9.78,2.58
5793,0,56761585,5482,50.19,519884.34,2,56780969,19384,56761585,5482,50.21,89.74,519884.34,0,9.40,9.78,2.56
5794,0,56761585,0,0.00,519884.34,2,56783789,22204,56761585,0,0.00,89.73,519884.34,1,10.02,9.02,2.58
5795,0,56761585,0,0.00,519884.34,2,56786148,24563,56761585,0,0.00,89.71,519884.34,0,9.80,8.80,2.57
5796,0,56761585,0,0.00,519884.34,2,56788270,26685,56761585,0,0.00,89.70,519884.34,1,9.80,8.80,2.58
5797,0,56765823,4238,38.83,519923.19,2,56790389,24566,56765823,4238,38.82,89.69,519923.19,0,8.30,8.80,2.56
5798,0,56770441,4618,42.28,519965.47,2,56792698,22257,56770441,4618,42.30,89.68,519965.47,0,8.34,8.80,2.58
5799,0,56775597,5156,47.22,520012.69,2,56795276,19679,56775597,5156,47.22,89.67,520012.69,1,8.38,8.80,2.59
5800,0,56782079,6482,59.39,520072.06,2,56798517,16438,56782079,6482,59.37,89.67,520072.06,0,7.49,8.80,2.59
5801,0,56782079,0,0.00,520072.06,2,56801689,19610,56782079,0,0.00,89.65,520072.06,1,8.97,8.00,2.60
5802,0,56788199,6120,56.05,520128.12,2,56804749,16550,56788199,6120,56.05,89.65,520128.12,0,7.87,8.00,2.59
5803,0,56796541,8342,76.39,520204.50,2,56808920,12379,56796541,8342,76.41,89.64,520204.50,1,8.19,9.19,2.60
5804,0,56811755,15214,139.36,520343.88,2,56816527,4772,56811755,15214,139.35,89.65,520343.88,1,7.28,9.19,2.60
5805,0,56842781,31026,284.15,520628.03,2,56842781,0,56842781,31026,284.17,89.69,520628.03,0,8.46,9.19,2.60
5806,0,56842781,0,0.00,520628.03,2,56853275,10494,56842781,0,0.00,89.67,520628.03,1,9.42,8.42,2.62
5807,0,56842781,0,0.00,520628.03,2,56859066,16285,56842781,0,0.00,89.66,520628.03,0,10.28,9.28,2.60
5808,0,56842781,0,0.00,520628.03,2,56863648,20867,56842781,0,0.00,89.64,520628.03,1,11.18,10.18,2.62
5809,0,56842781,0,0.00,520628.03,2,56867172,24391,56842781,0,0.00,89.62,520628.03,0,10.38,9.38,2.61
5810,0,56842781,0,0.00,520628.03,2,56870601,27820,56842781,0,0.00,89.61,520628.03,1,10.38,9.38,2.63
5811,0,56842781,0,0.00,520628.03,2,56873859,31078,56842781,0,0.00,89.59,520628.03,0,9.46,8.46,2.61
5812,0,56842781,0,0.00,520628.03,2,56876874,34093,56842781,0,0.00,89.58,520628.03,1,11.16,10.16,2.63
5813,0,56842781,0,0.00,520628.03,2,56879705,36924,56842781,0,0.00,89.56,520628.03,0,10.21,9.21,2.62
5814,0,56842781,0,0.00,520628.03,2,56882318,39537,56842781,0,0.00,89.55,520628.03,1,10.21,9.21,2.64
5815,0,56847913,5132,47.00,520675.03,2,56884884,36971,56847913,5132,47.00,89.54,520675.03,0,8.89,9.21,2.62
5816,0,56847913,0,0.00,520675.03,2,56887364,39451,56847913,0,0.00,89.52,520675.03,1,9.22,8.22,2.64
5817,0,56847913,0,0.00,520675.03,2,56889696,41783,56847913,0,0.00,89.51,520675.03,0,8.68,8.00,2.63
5818,0,56852315,4402,40.34,520715.38,2,56891897,39582,56852315,4402,40.32,89.50,520715.38,0,9.83,10.83,2.65
5819,0,56856839,4524,41.44,520756.81,2,56894159,37320,56856839,4524,41.44,89.49,520756.81,1,9.87,10.83,2.66
5820,0,56861203,4364,39.97,520796.78,2,56896341,35138,56861203,4364,39.97,89.48,520796.78,0,9.08,10.83,2.66
5821,0,56865333,4130,37.81,520834.59,2,56898406,33073,56865333,4130,37.83,89.48,520834.59,1,9.12,10.83,2.68
5822,0,56869641,4308,39.46,520874.03,2,56900560,30919,56869641,4308,39.46,89.47,520874.03,0,7.98,10.83,2.66
5823,0,56874003,4362,39.97,520914.00,2,56902741,28738,56874003,4362,39.95,89.46,520914.00,1,8.30,10.83,2.68
5824,0,56878423,4420,40.48,520954.50,2,56904951,26528,56878423,4420,40.48,89.45,520954.50,1,7.42,10.83,2.67
5825,0,56882823,4400,40.30,520994.81,2,56907151,24328,56882823,4400,40.30,89.44,520994.81,0,7.84,10.83,2.67
5826,0,56887273,4450,40.74,521035.53,2,56909376,22103,56887273,4450,40.76,89.43,521035.53,1,8.17,10.83,2.68
5827,0,56891851,4578,41.95,521077.50,2,56911665,19814,56891851,4578,41.93,89.42,521077.50,1,6.76,10.83,2.67
5828,0,56896807,4956,45.39,521122.88,2,56914143,17336,56896807,4956,45.39,89.42,521122.88,0,6.27,10.83,2.67
5829,0,56902657,5850,53.56,521176.44,2,56917068,14411,56902657,5850,53.58,89.41,521176.44,1,6.32,10.83,2.69
5830,0,56913861,11204,102.62,521279.06,2,56922670,8809,56913861,11204,102.62,89.41,521279.06,0,6.07,10.83,2.69
5831,0,56937158,23297,213.41,521492.47,2,56937158,0,56937158,23297,213.38,89.43,521492.47,1,7.89,10.83,2.71
5832,0,56969561,32403,296.75,521789.22,2,56969561,0,56969561,32403,296.78,89.47,521789.22,0,7.52,10.83,2.70
5833,0,57001518,31957,292.72,522081.94,2,57001518,0,57001518,31957,292.70,89.50,522081.94,1,9.82,10.83,2.72
5834,0,57001518,0,0.00,522081.94,2,57012160,10642,57001518,0,0.00,89.49,522081.94,0,11.29,10.29,2.71
5835,0,57001518,0,0.00,522081.94,2,57018051,16533,57001518,0,0.00,89.47,522081.94,1,11.48,10.48,2.72
5836,0,57011528,10010,91.66,522173.62,2,57023056,11528,57011528,10010,91.68,89.47,522173.62,0,10.26,10.48,2.71
5837,0,57027914,16386,150.06,522323.69,2,57031249,3335,57027914,16386,150.08,89.48,522323.69,0,10.34,10.48,2.73
5838,0,57027914,0,0.00,522323.69,2,57039627,11713,57027914,0,0.00,89.47,522323.69,1,11.14,10.14,2.74
5839,0,57027914,0,0.00,522323.69,2,57045338,17424,57027914,0,0.00,89.45,522323.69,0,10.24,9.24,2.72
5840,0,57027914,0,0.00,522323.69,2,57048626,20712,57027914,0,0.00,89.44,522323.69,1,10.69,9.69,2.74
5841,0,57033944,6030,55.25,522378.91,2,57051641,17697,57033944,6030,55.23,89.43,522378.91,0,9.37,9.69,2.72
5842,0,57042320,8376,76.72,522455.62,2,57055829,13509,57042320,8376,76.72,89.43,522455.62,1,9.43,9.69,2.74
5843,0,57056172,13852,126.87,522582.50,2,57062755,6583,57056172,13852,126.87,89.44,522582.50,0,7.99,9.69,2.72
5844,0,57083022,26850,245.94,522828.44,2,57083022,0,57083022,26850,245.92,89.46,522828.44,1,8.55,9.69,2.73
5845,0,57116525,33503,306.83,523135.28,2,57116525,0,57116525,33503,306.86,89.50,523135.28,0,7.79,9.69,2.71
5846,0,57116525,0,0.00,523135.28,2,57127197,10672,57116525,0,0.00,89.49,523135.28,1,10.11,9.11,2.73
5847,0,57116525,0,0.00,523135.28,2,57132964,16439,57116525,0,0.00,89.47,523135.28,0,10.31,9.31,2.70
5848,0,57116525,0,0.00,523135.28,2,57137261,20736,57116525,0,0.00,89.46,523135.28,1,10.40,9.40,2.72
5849,0,57124557,8032,73.57,523208.84,2,57141277,16720,57124557,8032,73.57,89.45,523208.84,0,9.11,9.40,2.70
5850,0,57132609,8052,73.75,523282.59,2,57145303,12694,57132609,8052,73.75,89.45,523282.59,1,9.21,9.40,2.72
5851,0,57143979,11370,104.16,523386.75,2,57150988,7009,57143979,11370,104.14,89.45,523386.75,0,8.11,9.40,2.71
5852,0,57170725,26746,244.95,523631.69,2,57170725,0,57170725,26746,244.97,89.48,523631.69,1,8.21,9.40,2.72
5853,0,57203370,32645,298.99,523930.69,2,57203370,0,57203370,32645,299.00,89.51,523930.69,0,7.07,9.40,2.71
5854,0,57236506,33136,303.50,524234.19,2,57236506,0,57236506,33136,303.50,89.55,524234.19,1,8.63,9.40,2.72
5855,0,57236506,0,0.00,524234.19,2,57247278,10772,57236506,0,0.00,89.54,524234.19,0,9.48,8.48,2.70
5856,0,57236506,0,0.00,524234.19,2,57252876,16370,57236506,0,0.00,89.52,524234.19,1,10.11,9.11,2.72
5857,0,57246172,9666,88.55,524322.75,2,57257709,11537,57246172,9666,88.53,89.52,524322.75,0,8.67,9.11,2.70
5858,0,57261962,15790,144.60,524467.31,2,57265604,3642,57261962,15790,144.62,89.53,524467.31,1,8.76,9.11,2.72
5859,0,57293631,31669,290.09,524757.44,2,57293631,0,57293631,31669,290.06,89.56,524757.44,0,7.25,9.11,2.69
5860,0,57327170,33539,307.16,525064.56,2,57327170,0,57327170,33539,307.19,89.60,525064.56,1,8.94,9.11,2.71
5861,0,57327170,0,0.00,525064.56,2,57337510,10340,57327170,0,0.00,89.59,525064.56,1,11.30,10.30,2.70
5862,0,57327170,0,0.00,525064.56,2,57343153,15983,57327170,0,0.00,89.57,525064.56,0,11.41,10.41,2.68
5863,0,57327170,0,0.00,525064.56,2,57347330,20160,57327170,0,0.00,89.56,525064.56,1,11.58,10.58,2.70
5864,0,57335030,7860,72.03,525136.62,2,57351260,16230,57335030,7860,71.99,89.55,525136.62,0,10.21,10.58,2.68
5865,0,57343612,8582,78.58,525215.19,2,57355551,11939,57343612,8582,78.60,89.55,525215.19,1,10.48,10.58,2.69
5866,0,57359476,15864,145.30,525360.50,2,57363483,4007,57359476,15864,145.30,89.56,525360.50,0,9.86,10.58,2.68
5867,0,57389972,30496,279.32,525639.81,2,57389972,0,57389972,30496,279.32,89.59,525639.81,0,10.08,10.58,2.69
5868,0,57389972,0,0.00,525639.81,2,57400671,10699,57389972,0,0.00,89.58,525639.81,1,11.23,10.23,2.71
5869,0,57410390,20418,187.03,525826.81,2,57410880,490,57410390,20418,187.01,89.59,525826.81,1,9.33,10.23,2.67
5870,0,57441711,31321,286.86,526113.69,2,57441711,0,57441711,31321,286.87,89.63,526113.69,0,9.52,10.23,2.66
5871,0,57441711,0,0.00,526113.69,2,57452055,10344,57441711,0,0.00,89.61,526113.69,0,11.07,10.07,2.67
5872,0,57441711,0,0.00,526113.69,2,57457760,16049,57441711,0,0.00,89.60,526113.69,1,12.43,11.43,2.69
5873,0,57451947,10236,93.75,526207.44,2,57462878,10931,57451947,10236,93.75,89.60,526207.44,0,10.30,11.43,2.65
5874,0,57471447,19500,178.60,526386.06,2,57472628,1181,57471447,19500,178.60,89.61,526386.06,1,11.06,11.43,2.66
5875,0,57502674,31227,285.98,526672.06,2,57502674,0,57502674,31227,286.01,89.65,526672.06,0,10.30,11.43,2.65
5876,0,57534430,31756,290.89,526962.94,2,57534430,0,57534430,31756,290.86,89.68,526962.94,1,11.32,11.43,2.66
5877,0,57565303,30873,282.76,527245.69,2,57565303,0,57565303,30873,282.77,89.71,527245.69,0,10.37,11.43,2.63
5878,0,57565303,0,0.00,527245.69,2,57575714,10411,57565303,0,0.00,89.70,527245.69,0,12.28,11.28,2.65
5879,0,57565303,0,0.00,527245.69,2,57581868,16565,57565303,0,0.00,89.68,527245.69,1,15.47,14.47,2.67
5880,0,57576155,10852,99.39,527345.06,2,57587294,11139,57576155,10852,99.39,89.68,527345.06,0,13.77,14.47,2.64
5881,0,57576155,0,0.00,527345.06,2,57592239,16084,57576155,0,0.00,89.67,527345.06,1,14.60,13.60,2.66
5882,0,57585659,9504,87.05,527432.12,2,57596991,11332,57585659,9504,87.05,89.67,527432.12,0,13.01,13.60,2.63
5883,0,57602821,17162,157.17,527589.31,2,57605572,2751,57602821,17162,157.19,89.68,527589.31,1,13.09,13.60,2.65
5884,0,57602821,0,0.00,527589.31,2,57614427,11606,57602821,0,0.00,89.67,527589.31,1,13.67,12.67,2.62
5885,0,57620805,17984,164.72,527754.00,2,57623419,2614,57620805,17984,164.72,89.68,527754.00,0,12.39,12.67,2.61
5886,0,57620805,0,0.00,527754.00,2,57632256,11451,57620805,0,0.00,89.66,527754.00,1,14.55,13.55,2.63
5887,0,57636171,15366,140.76,527894.75,2,57639939,3768,57636171,15366,140.74,89.67,527894.75,0,13.35,13.55,2.60
5888,0,57666172,30001,274.77,528169.56,2,57666172,0,57666172,30001,274.78,89.70,528169.56,1,13.48,13.55,2.62
5889,0,57697064,30892,282.94,528452.50,2,57697064,0,57697064,30892,282.94,89.74,528452.50,0,13.33,13.55,2.60
5890,0,57697064,0,0.00,528452.50,2,57707535,10471,57697064,0,0.00,89.72,528452.50,1,15.01,14.01,2.62
5891,0,57697064,0,0.00,528452.50,2,57713455,16391,57697064,0,0.00,89.71,528452.50,0,14.77,13.77,2.60
5892,0,57697064,0,0.00,528452.50,2,57717976,20912,57697064,0,0.00,89.69,528452.50,1,14.77,13.77,2.61
5893,0,57705296,8232,75.40,528527.88,2,57722092,16796,57705296,8232,75.40,89.69,528527.88,0,13.12,13.77,2.59
5894,0,57713976,8680,79.50,528607.38,2,57726432,12456,57713976,8680,79.50,89.69,528607.38,1,13.65,13.77,2.61
5895,0,57726358,12382,113.43,528720.81,2,57732623,6265,57726358,12382,113.41,89.69,528720.81,0,13.19,13.77,2.58
5896,0,57753357,26999,247.26,528968.06,2,57753357,0,57753357,26999,247.29,89.72,528968.06,1,13.30,13.77,2.60
5897,0,57784715,31358,287.23,529255.31,2,57784715,0,57784715,31358,287.21,89.75,529255.31,0,12.38,13.77,2.59
5898,0,57784715,0,0.00,529255.31,2,57795189,10474,57784715,0,0.00,89.73,529255.31,0,14.72,13.72,2.60
5899,0,57784715,0,0.00,529255.31,2,57801096,16381,57784715,0,0.00,89.72,529255.31,1,15.57,14.57,2.62
5900,0,57784715,0,0.00,529255.31,2,57805784,21069,57784715,0,0.00,89.70,529255.31,0,14.58,13.58,2.59
5901,0,57784715,0,0.00,529255.31,2,57809843,25128,57784715,0,0.00,89.69,529255.31,1,14.58,13.58,2.60
5902,0,57784715,0,0.00,529255.31,2,57813419,28704,57784715,0,0.00,89.67,529255.31,0,14.05,13.05,2.59
5903,0,57784715,0,0.00,529255.31,2,57816585,31870,57784715,0,0.00,89.66,529255.31,1,15.48,14.48,2.61
5904,0,57790637,5922,54.22,529309.50,2,57819546,28909,57790637,5922,54.24,89.65,529309.50,1,13.83,14.48,2.59
5905,0,57796515,5878,53.86,529363.38,2,57822485,25970,57796515,5878,53.84,89.65,529363.38,0,12.85,14.48,2.58
5906,0,57802139,5624,51.51,529414.88,2,57825297,23158,57802139,5624,51.51,89.64,529414.88,1,12.90,14.48,2.60
5907,0,57807751,5612,51.40,529466.31,2,57828103,20352,57807751,5612,51.40,89.63,529466.31,0,11.80,14.48,2.58
5908,0,57813675,5924,54.26,529520.56,2,57831065,17390,57813675,5924,54.26,89.63,529520.56,1,13.29,14.48,2.59
5909,0,57819783,6108,55.94,529576.50,2,57834119,14336,57819783,6108,55.94,89.62,529576.50,1,12.13,14.48,2.58
5910,0,57828149,8366,76.61,529653.12,2,57838302,10153,57828149,8366,76.62,89.62,529653.12,0,10.81,14.48,2.56
5911,0,57849629,21480,196.74,529849.81,2,57849629,0,57849629,21480,196.74,89.64,529849.81,0,10.88,14.48,2.58
5912,0,57881298,31669,290.05,530139.88,2,57881298,0,57881298,31669,290.06,89.67,530139.88,1,11.07,14.48,2.59
5913,0,57913013,31715,290.49,530430.38,2,57913013,0,57913013,31715,290.48,89.71,530430.38,0,11.40,14.48,2.56
5914,0,57943632,30619,280.45,530710.81,2,57943632,0,57943632,30619,280.44,89.74,530710.81,1,11.69,14.48,2.58
5915,0,57975162,31530,288.77,530999.62,2,57975162,0,57975162,31530,288.79,89.77,530999.62,0,12.35,14.48,2.55
5916,0,58006686,31524,288.77,531288.38,2,58006686,0,58006686,31524,288.73,89.81,531288.38,1,12.87,14.48,2.57
5917,0,58038193,31507,288.55,531576.94,2,58038193,0,58038193,31507,288.58,89.84,531576.94,0,13.36,14.48,2.55
5918,0,58038193,0,0.00,531576.94,2,58048584,10391,58038193,0,0.00,89.82,531576.94,0,15.36,14.36,2.56
5919,0,58038193,0,0.00,531576.94,2,58054331,16138,58038193,0,0.00,89.81,531576.94,1,15.36,14.36,2.58
5920,0,58048347,10154,93.02,531669.94,2,58059408,11061,58048347,10154,93.00,89.81,531669.94,0,13.32,14.36,2.55
5921,0,58066705,18358,168.12,531838.06,2,58068587,1882,58066705,18358,168.14,89.82,531838.06,0,13.70,14.36,2.57
5922,0,58066705,0,0.00,531838.06,2,58076966,10261,58066705,0,0.00,89.81,531838.06,1,15.58,14.58,2.58
5923,0,58066705,0,0.00,531838.06,2,58082334,15629,58066705,0,0.00,89.79,531838.06,0,14.80,13.80,2.56
5924,0,58066705,0,0.00,531838.06,2,58086010,19305,58066705,0,0.00,89.78,531838.06,1,16.03,15.03,2.58
5925,0,58073433,6728,61.62,531899.69,2,58089374,15941,58073433,6728,61.62,89.77,531899.69,0,14.37,15.03,2.55
5926,0,58084481,11048,101.19,532000.88,2,58094898,10417,58084481,11048,101.19,89.77,532000.88,1,14.43,15.03,2.57
5927,0,58084481,0,0.00,532000.88,2,58100721,16240,58084481,0,0.00,89.76,532000.88,1,15.27,14.27,2.56
5928,0,58084481,0,0.00,532000.88,2,58104488,20007,58084481,0,0.00,89.74,532000.88,0,14.42,13.42,2.55
5929,0,58084481,0,0.00,532000.88,2,58107230,22749,58084481,0,0.00,89.73,532000.88,1,14.42,13.42,2.57
5930,0,58089645,5164,47.30,532048.19,2,58109812,20167,58089645,5164,47.30,89.72,532048.19,1,12.98,13.42,2.55
5931,0,58095507,5862,53.71,532101.88,2,58112743,17236,58095507,5862,53.69,89.72,532101.88,0,12.22,13.42,2.55
5932,0,58103235,7728,70.78,532172.69,2,58116607,13372,58103235,7728,70.78,89.71,532172.69,1,12.58,13.42,2.57
5933,0,58116575,13340,122.18,532294.81,2,58123277,6702,58116575,13340,122.18,89.72,532294.81,1,11.97,13.42,2.55
5934,0,58144064,27489,251.77,532546.62,2,58144064,0,58144064,27489,251.77,89.74,532546.62,0,11.02,13.42,2.54
5935,0,58175750,31686,290.23,532836.81,2,58175750,0,58175750,31686,290.21,89.78,532836.81,0,11.43,13.42,2.56
5936,0,58175750,0,0.00,532836.81,2,58186264,10514,58175750,0,0.00,89.76,532836.81,1,13.61,12.61,2.57
5937,0,58197234,21484,196.74,533033.56,2,58197234,0,58197234,21484,196.77,89.78,533033.56,0,12.53,12.61,2.55
5938,0,58197234,0,0.00,533033.56,2,58208131,10897,58197234,0,0.00,89.77,533033.56,0,12.92,11.92,2.57
5939,0,58197234,0,0.00,533033.56,2,58213594,16360,58197234,0,0.00,89.75,533033.56,1,13.89,12.89,2.58
5940,0,58207058,9824,89.98,533123.56,2,58218506,11448,58207058,9824,89.98,89.75,533123.56,0,12.44,12.89,2.57
5941,0,58223778,16720,153.14,533276.69,2,58226866,3088,58223778,16720,153.14,89.76,533276.69,1,12.53,12.89,2.58
5942,0,58254228,30450,278.91,533555.62,2,58254228,0,58254228,30450,278.89,89.79,533555.62,0,11.92,12.89,2.56
5943,0,58254228,0,0.00,533555.62,2,58264623,10395,58254228,0,0.00,89.78,533555.62,1,13.97,12.97,2.58
5944,0,58274408,20180,184.83,533740.44,2,58274713,305,58274408,20180,184.83,89.79,533740.44,1,12.13,12.97,2.55
5945,0,58274408,0,0.00,533740.44,2,58284598,10190,58274408,0,0.00,89.78,533740.44,0,16.50,15.50,2.54
5946,0,58274408,0,0.00,533740.44,2,58290124,15716,58274408,0,0.00,89.76,533740.44,1,17.62,16.62,2.56
5947,0,58274408,0,0.00,533740.44,2,58293931,19523,58274408,0,0.00,89.75,533740.44,0,17.33,16.33,2.54
5948,0,58274408,0,0.00,533740.44,2,58297395,22987,58274408,0,0.00,89.73,533740.44,1,18.19,17.19,2.55
5949,0,58281384,6976,63.89,533804.31,2,58300883,19499,58281384,6976,63.89,89.73,533804.31,0,16.69,17.19,2.54
5950,0,58288540,7156,65.54,533869.88,2,58304461,15921,58288540,7156,65.54,89.73,533869.88,1,16.75,17.19,2.55
5951,0,58296374,7834,71.77,533941.62,2,58308378,12004,58296374,7834,71.75,89.72,533941.62,0,14.72,17.19,2.52
5952,0,58312146,15772,144.42,534086.06,2,58316264,4118,58312146,15772,144.46,89.73,534086.06,1,15.04,17.19,2.54
5953,0,58342714,30568,279.98,534366.06,2,58342714,0,58342714,30568,279.98,89.76,534366.06,0,14.37,17.19,2.52
5954,0,58374005,31291,286.61,534652.62,2,58374005,0,58374005,31291,286.60,89.80,534652.62,1,15.73,17.19,2.53
5955,0,58404923,30918,283.20,534935.88,2,58404923,0,58404923,30918,283.18,89.83,534935.88,0,14.32,17.19,2.49
5956,0,58436203,31280,286.50,535222.31,2,58436203,0,58436203,31280,286.50,89.86,535222.31,1,15.61,17.19,2.51
5957,0,58467517,31314,286.79,535509.12,2,58467517,0,58467517,31314,286.81,89.90,535509.12,0,15.69,17.19,2.49
5958,0,58498983,31466,288.22,535797.38,2,58498983,0,58498983,31466,288.20,89.93,535797.38,0,15.97,17.19,2.51
5959,0,58498983,0,0.00,535797.38,2,58509409,10426,58498983,0,0.00,89.91,535797.38,1,19.30,18.30,2.53
5960,0,58498983,0,0.00,535797.38,2,58515122,16139,58498983,0,0.00,89.90,535797.38,0,18.75,17.75,2.50
5961,0,58498983,0,0.00,535797.38,2,58519507,20524,58498983,0,0.00,89.88,535797.38,1,19.24,18.24,2.52
5962,0,58507087,8104,74.23,535871.56,2,58523559,16472,58507087,8104,74.23,89.88,535871.56,0,17.69,18.24,2.49
5963,0,58515611,8524,78.07,535949.62,2,58527821,12210,58515611,8524,78.07,89.88,535949.62,1,18.11,18.24,2.51
5964,0,58528337,12726,116.54,536066.19,2,58534184,5847,58528337,12726,116.56,89.88,536066.19,0,16.99,18.24,2.49
5965,0,58557129,28792,263.71,536329.88,2,58557129,0,58557129,28792,263.71,89.91,536329.88,1,17.23,18.24,2.50
5966,0,58588447,31318,286.86,536616.75,2,58588447,0,58588447,31318,286.84,89.95,536616.75,1,17.36,18.24,2.49
5967,0,58619489,31042,284.30,536901.06,2,58619489,0,58619489,31042,284.32,89.98,536901.06,0,17.98,18.24,2.47
5968,0,58619489,0,0.00,536901.06,2,58629743,10254,58619489,0,0.00,89.96,536901.06,1,18.88,17.88,2.49
5969,0,58639119,19630,179.81,537080.88,2,58639558,439,58639119,19630,179.79,89.98,537080.88,0,17.46,17.88,2.47
5970,0,58639119,0,0.00,537080.88,2,58649471,10352,58639119,0,0.00,89.96,537080.88,1,18.94,17.94,2.49
5971,0,58658881,19762,180.98,537261.88,2,58659352,471,58658881,19762,181.00,89.98,537261.88,0,17.55,17.94,2.47
5972,0,58658881,0,0.00,537261.88,2,58669110,10229,58658881,0,0.00,89.96,537261.88,1,18.76,17.76,2.49
5973,0,58678893,20012,183.29,537445.12,2,58679116,223,58678893,20012,183.29,89.98,537445.12,0,17.75,17.76,2.47
5974,0,58678893,0,0.00,537445.12,2,58689513,10620,58678893,0,0.00,89.96,537445.12,0,18.39,17.39,2.49
5975,0,58678893,0,0.00,537445.12,2,58694701,15808,58678893,0,0.00,89.95,537445.12,1,18.39,17.39,2.50
5976,0,58689629,10736,98.33,537543.50,2,58700069,10440,58689629,10736,98.33,89.95,537543.50,1,16.48,17.39,2.47
5977,0,58709611,19982,183.04,537726.50,2,58710060,449,58709611,19982,183.02,89.97,537726.50,0,15.28,17.39,2.46
5978,0,58740996,31385,287.45,538013.94,2,58740996,0,58740996,31385,287.46,90.00,538013.94,0,16.24,17.39,2.48
5979,0,58740996,0,0.00,538013.94,2,58751333,10337,58740996,0,0.00,89.98,538013.94,1,18.41,17.41,2.49
5980,0,58740996,0,0.00,538013.94,2,58756982,15986,58740996,0,0.00,89.97,538013.94,1,22.48,19.00,2.47
5981,0,58740996,0,0.00,538013.94,2,58761330,20334,58740996,0,0.00,89.95,538013.94,0,20.96,19.96,2.45
5982,0,58740996,0,0.00,538013.94,2,58765275,24279,58740996,0,0.00,89.94,538013.94,1,21.24,19.00,2.47
5983,0,58740996,0,0.00,538013.94,2,58768769,27773,58740996,0,0.00,89.92,538013.94,0,21.56,19.00,2.45
5984,0,58740996,0,0.00,538013.94,2,58771967,30971,58740996,0,0.00,89.91,538013.94,1,21.56,19.00,2.47
5985,0,58740996,0,0.00,538013.94,2,58774910,33914,58740996,0,0.00,89.89,538013.94,1,19.66,18.66,2.44
5986,0,58746652,5656,51.80,538065.75,2,58777738,31086,58746652,5656,51.80,89.89,538065.75,0,18.25,18.66,2.42
5987,0,58752096,5444,49.86,538115.62,2,58780460,28364,58752096,5444,49.86,89.88,538115.62,0,18.30,18.66,2.44
5988,0,58757610,5514,50.48,538166.12,2,58783217,25607,58757610,5514,50.50,89.87,538166.12,1,18.35,18.66,2.46
5989,0,58762900,5290,48.47,538214.56,2,58785862,22962,58762900,5290,48.45,89.87,538214.56,0,16.04,18.66,2.42
5990,0,58768238,5338,48.91,538263.50,2,58788531,20293,58768238,5338,48.89,89.86,538263.50,1,16.09,18.66,2.43
5991,0,58773586,5348,48.95,538312.44,2,58791205,17619,58773586,5348,48.98,89.85,538312.44,0,14.67,18.66,2.42
5992,0,58779350,5764,52.83,538365.25,2,58794087,14737,58779350,5764,52.79,89.85,538365.25,0,14.72,18.66,2.43
5993,0,58787124,7774,71.18,538436.44,2,58797974,10850,58787124,7774,71.20,89.84,538436.44,1,14.77,18.66,2.45
5994,0,58806058,18934,173.40,538609.88,2,58807441,1383,58806058,18934,173.42,89.86,538609.88,0,13.00,18.66,2.42
5995,0,58837618,31560,289.06,538898.94,2,58837618,0,58837618,31560,289.06,89.89,538898.94,1,14.89,18.66,2.43
5996,0,58868931,31313,286.83,539185.75,2,58868931,0,58868931,31313,286.80,89.92,539185.75,1,15.46,18.66,2.41
5997,0,58900154,31223,285.95,539471.69,2,58900154,0,58900154,31223,285.97,89.96,539471.69,0,16.24,18.66,2.39
5998,0,58900154,0,0.00,539471.69,2,58910628,10474,58900154,0,0.00,89.94,539471.69,0,18.91,17.91,2.41
5999,0,58900154,0,0.00,539471.69,2,58916436,16282,58900154,0,0.00,89.93,539471.69,1,19.06,18.06,2.42
6000,0,58910284,10130,92.80,539564.50,2,58921501,11217,58910284,10130,92.78,89.93,539564.50,0,17.83,18.06,2.41
6001,0,58910284,0,0.00,539564.50,2,58926274,15990,58910284,0,0.00,89.91,539564.50,1,19.23,18.23,2.42
6002,0,58919378,9094,83.27,539647.75,2,58930821,11443,58919378,9094,83.29,89.91,539647.75,0,17.75,18.23,2.40
6003,0,58936696,17318,158.64,539806.38,2,58939480,2784,58936696,17318,158.62,89.92,539806.38,1,17.83,18.23,2.42
6004,0,58967129,30433,278.73,540085.12,2,58967129,0,58967129,30433,278.74,89.95,540085.12,1,17.36,18.23,2.41
6005,0,58998527,31398,287.60,540372.69,2,58998527,0,58998527,31398,287.58,89.99,540372.69,0,17.23,18.23,2.40
6006,0,59029534,31007,284.01,540656.75,2,59029534,0,59029534,31007,284.00,90.02,540656.75,1,18.22,18.23,2.42
6007,0,59029534,0,0.00,540656.75,2,59039735,10201,59029534,0,0.00,90.00,540656.75,0,18.33,17.33,2.40
6008,0,59029534,0,0.00,540656.75,2,59045445,15911,59029534,0,0.00,89.99,540656.75,1,19.31,18.31,2.41
6009,0,59029534,0,0.00,540656.75,2,59049651,20117,59029534,0,0.00,89.97,540656.75,0,19.03,18.03,2.40
6010,0,59029534,0,0.00,540656.75,2,59053376,23842,59029534,0,0.00,89.96,540656.75,1,19.76,18.76,2.42
6011,0,59036670,7136,65.36,540722.06,2,59056944,20274,59036670,7136,65.36,89.96,540722.06,0,17.98,18.76,2.39
6012,0,59043824,7154,65.51,540787.56,2,59060521,16697,59043824,7154,65.52,89.95,540787.56,1,18.05,18.76,2.41
6013,0,59051306,7482,68.51,540856.12,2,59064262,12956,59051306,7482,68.53,89.95,540856.12,0,16.90,18.76,2.40
6014,0,59063648,12342,113.06,540969.19,2,59070433,6785,59063648,12342,113.04,89.95,540969.19,1,17.45,18.76,2.41
6015,0,59089749,26101,239.05,541208.19,2,59089749,0,59089749,26101,239.06,89.98,541208.19,0,16.33,18.76,2.39
6016,0,59121491,31742,290.75,541498.94,2,59121491,0,59121491,31742,290.73,90.01,541498.94,1,16.57,18.76,2.41
6017,0,59152549,31058,284.44,541783.38,2,59152549,0,59152549,31058,284.46,90.04,541783.38,0,16.72,18.76,2.39
6018,0,59183949,31400,287.60,542071.00,2,59183949,0,59183949,31400,287.60,90.07,542071.00,0,18.37,18.76,2.41
6019,0,59183949,0,0.00,542071.00,2,59194243,10294,59183949,0,0.00,90.06,542071.00,1,19.33,18.33,2.42
6020,0,59204121,20172,184.76,542255.75,2,59204329,208,59204121,20172,184.76,90.08,542255.75,0,17.82,18.33,2.40
6021,0,59204121,0,0.00,542255.75,2,59214433,10312,59204121,0,0.00,90.06,542255.75,1,19.29,18.29,2.42
6022,0,59204121,0,0.00,542255.75,2,59220229,16108,59204121,0,0.00,90.05,542255.75,1,19.41,18.41,2.40
6023,0,59215121,11000,100.75,542356.50,2,59225729,10608,59215121,11000,100.75,90.05,542356.50,0,17.97,18.41,2.38
6024,0,59235181,20060,183.73,542540.25,2,59235759,578,59235181,20060,183.73,90.06,542540.25,1,18.07,18.41,2.40
6025,0,59235181,0,0.00,542540.25,2,59245481,10300,59235181,0,0.00,90.05,542540.25,0,20.50,19.50,2.39
6026,0,59235181,0,0.00,542540.25,2,59251108,15927,59235181,0,0.00,90.03,542540.25,1,21.27,19.00,2.41
6027,0,59235181,0,0.00,542540.25,2,59254616,19435,59235181,0,0.00,90.02,542540.25,0,20.08,19.08,2.39
6028,0,59235181,0,0.00,542540.25,2,59257659,22478,59235181,0,0.00,90.00,542540.25,1,20.08,19.08,2.40
6029,0,59241443,6262,57.37,542597.62,2,59260790,19347,59241443,6262,57.35,90.00,542597.62,0,18.90,19.08,2.38
6030,0,59248529,7086,64.88,542662.50,2,59264333,15804,59248529,7086,64.90,89.99,542662.50,1,18.96,19.08,2.40
6031,0,59257353,8824,80.82,542743.31,2,59268745,11392,59257353,8824,80.82,89.99,542743.31,0,17.64,19.08,2.38
6032,0,59274155,16802,153.91,542897.25,2,59277146,2991,59274155,16802,153.89,90.00,542897.25,1,18.05,19.08,2.40
6033,0,59305702,31547,288.95,543186.19,2,59305702,0,59305702,31547,288.94,90.04,543186.19,0,16.52,19.08,2.36
6034,0,59305702,0,0.00,543186.19,2,59316080,10378,59305702,0,0.00,90.02,543186.19,1,19.81,18.81,2.38
6035,0,59305702,0,0.00,543186.19,2,59321958,16256,59305702,0,0.00,90.01,543186.19,0,20.54,19.54,2.37
6036,0,59305702,0,0.00,543186.19,2,59326506,20804,59305702,0,0.00,89.99,543186.19,1,20.54,19.54,2.38
6037,0,59313390,7688,70.42,543256.56,2,59330350,16960,59313390,7688,70.42,89.99,543256.56,0,19.13,19.54,2.36
6038,0,59313390,0,0.00,543256.56,2,59334081,20691,59313390,0,0.00,89.97,543256.56,1,19.70,18.70,2.37
6039,0,59320356,6966,63.78,543320.38,2,59337564,17208,59320356,6966,63.80,89.97,543320.38,0,18.19,18.70,2.35
6040,0,59327916,7560,69.24,543389.62,2,59341344,13428,59327916,7560,69.24,89.97,543389.62,1,18.25,18.70,2.37
6041,0,59340328,12412,113.68,543503.31,2,59347550,7222,59340328,12412,113.68,89.97,543503.31,0,16.99,18.70,2.35
6042,0,59365376,25048,229.42,543732.69,2,59365376,0,59365376,25048,229.42,89.99,543732.69,1,17.32,18.70,2.37
6043,0,59396451,31075,284.63,544017.31,2,59396451,0,59396451,31075,284.62,90.02,544017.31,0,17.35,18.70,2.35
6044,0,59427680,31229,286.02,544303.38,2,59427680,0,59427680,31229,286.03,90.06,544303.38,1,17.62,18.70,2.37
6045,0,59458878,31198,285.76,544589.12,2,59458878,0,59458878,31198,285.75,90.09,544589.12,0,17.20,18.70,2.35
6046,0,59458878,0,0.00,544589.12,2,59469257,10379,59458878,0,0.00,90.07,544589.12,1,22.36,19.00,2.37
6047,0,59458878,0,0.00,544589.12,2,59474954,16076,59458878,0,0.00,90.06,544589.12,0,22.91,19.00,2.35
6048,0,59458878,0,0.00,544589.12,2,59479391,20513,59458878,0,0.00,90.04,544589.12,1,22.92,19.00,2.37
6049,0,59458878,0,0.00,544589.12,2,59483186,24308,59458878,0,0.00,90.03,544589.12,0,21.35,19.00,2.35
6050,0,59458878,0,0.00,544589.12,2,59486752,27874,59458878,0,0.00,90.01,544589.12,1,21.35,19.00,2.36
6051,0,59458878,0,0.00,544589.12,2,59489725,30847,59458878,0,0.00,90.00,544589.12,0,20.28,19.28,2.35
6052,0,59458878,0,0.00,544589.12,2,59492554,33676,59458878,0,0.00,89.98,544589.12,1,21.03,19.00,2.36
6053,0,59458878,0,0.00,544589.12,2,59495331,36453,59458878,0,0.00,89.97,544589.12,0,19.78,18.78,2.35
6054,0,59458878,0,0.00,544589.12,2,59497945,39067,59458878,0,0.00,89.96,544589.12,1,19.78,18.78,2.36
6055,0,59463916,5038,46.13,544635.25,2,59500464,36548,59463916,5038,46.14,89.95,544635.25,0,18.05,18.78,2.34
6056,0,59468956,5040,46.16,544681.44,2,59502984,34028,59468956,5040,46.16,89.94,544681.44,1,18.09,18.78,2.36
6057,0,59473972,5016,45.94,544727.38,2,59505492,31520,59473972,5016,45.94,89.93,544727.38,0,16.89,18.78,2.34
6058,0,59478962,4990,45.69,544773.06,2,59507987,29025,59478962,4990,45.70,89.93,544773.06,1,16.94,18.78,2.36
6059,0,59483944,4982,45.65,544818.69,2,59510478,26534,59483944,4982,45.63,89.92,544818.69,0,15.32,18.78,2.34
6060,0,59488898,4954,45.36,544864.06,2,59512955,24057,59488898,4954,45.37,89.91,544864.06,1,15.99,18.78,2.35
6061,0,59493596,4698,43.05,544907.06,2,59515304,21708,59493596,4698,43.03,89.90,544907.06,0,14.70,18.78,2.33
6062,0,59498292,4696,43.01,544950.12,2,59517652,19360,59498292,4696,43.01,89.90,544950.12,1,14.74,18.78,2.35
6063,0,59503336,5044,46.20,544996.31,2,59520174,16838,59503336,5044,46.20,89.89,544996.31,0,13.75,18.78,2.34
6064,0,59508798,5462,50.05,545046.38,2,59522905,14107,59508798,5462,50.03,89.88,545046.38,1,13.97,18.78,2.35
6065,0,59518672,9874,90.42,545136.75,2,59527842,9170,59518672,9874,90.44,89.88,545136.75,0,13.19,18.78,2.34
6066,0,59541329,22657,207.51,545344.25,2,59541329,0,59541329,22657,207.52,89.90,545344.25,1,13.52,18.78,2.35
6067,0,59572998,31669,290.09,545634.38,2,59572998,0,59572998,31669,290.06,89.93,545634.38,0,12.06,18.78,2.33
6068,0,59605094,32096,293.97,545928.31,2,59605094,0,59605094,32096,293.97,89.97,545928.31,1,13.03,18.78,2.35
6069,0,59638225,33131,303.42,546231.75,2,59638225,0,59638225,33131,303.45,90.00,546231.75,0,14.29,18.78,2.33
6070,0,59671322,33097,303.13,546534.88,2,59671322,0,59671322,33097,303.14,90.04,546534.88,1,16.27,18.78,2.35
6071,0,59704254,32932,301.66,546836.56,2,59704254,0,59704254,32932,301.63,90.07,546836.56,0,14.66,18.78,2.31
6072,0,59736951,32697,299.47,547136.00,2,59736951,0,59736951,32697,299.47,90.11,547136.00,1,16.24,18.78,2.33
6073,0,59769908,32957,301.85,547437.88,2,59769908,0,59769908,32957,301.86,90.14,547437.88,0,16.08,18.78,2.32
6074,0,59769908,0,0.00,547437.88,2,59780461,10553,59769908,0,0.00,90.13,547437.88,1,19.54,18.54,2.33
6075,0,59790696,20788,190.40,547628.25,2,59790855,159,59790696,20788,190.40,90.14,547628.25,0,18.30,18.54,2.29
6076,0,59790696,0,0.00,547628.25,2,59801476,10780,59790696,0,0.00,90.13,547628.25,1,19.80,18.80,2.31
6077,0,59810822,20126,184.35,547812.62,2,59811539,717,59810822,20126,184.34,90.15,547812.62,0,18.60,18.80,2.30
6078,0,59843747,32925,301.55,548114.19,2,59843747,0,59843747,32925,301.56,90.18,548114.19,1,18.78,18.80,2.31
6079,0,59876096,32349,296.28,548410.44,2,59876096,0,59876096,32349,296.29,90.21,548410.44,0,17.64,18.80,2.29
6080,0,59876096,0,0.00,548410.44,2,59886460,10364,59876096,0,0.00,90.20,548410.44,0,19.43,18.43,2.30
6081,0,59876096,0,0.00,548410.44,2,59892696,16600,59876096,0,0.00,90.18,548410.44,1,20.00,19.00,2.32
6082,0,59876096,0,0.00,548410.44,2,59897279,21183,59876096,0,0.00,90.17,548410.44,1,19.81,18.81,2.30
6083,0,59884282,8186,74.96,548485.38,2,59901372,17090,59884282,8186,74.98,90.17,548485.38,0,18.43,18.81,2.28
6084,0,59892382,8100,74.23,548559.62,2,59905422,13040,59892382,8100,74.19,90.16,548559.62,1,18.79,18.81,2.30
6085,0,59892382,0,0.00,548559.62,2,59909089,16707,59892382,0,0.00,90.15,548559.62,0,19.09,18.09,2.28
6086,0,59892382,0,0.00,548559.62,2,59912260,19878,59892382,0,0.00,90.13,548559.62,1,19.09,18.09,2.29
6087,0,59898334,5952,54.51,548614.12,2,59915236,16902,59898334,5952,54.51,90.13,548614.12,0,17.64,18.09,2.28
6088,0,59906598,8264,75.69,548689.81,2,59919368,12770,59906598,8264,75.69,90.13,548689.81,1,17.70,18.09,2.29
6089,0,59923358,16760,153.51,548843.31,2,59927748,4390,59923358,16760,153.51,90.14,548843.31,0,17.45,18.09,2.28
6090,0,59923358,0,0.00,548843.31,2,59935989,12631,59923358,0,0.00,90.12,548843.31,1,18.46,17.46,2.29
6091,0,59923358,0,0.00,548843.31,2,59940610,17252,59923358,0,0.00,90.11,548843.31,0,18.13,17.13,2.27
6092,0,59923358,0,0.00,548843.31,2,59943908,20550,59923358,0,0.00,90.09,548843.31,1,18.99,17.99,2.29
6093,0,59929760,6402,58.62,548901.94,2,59947109,17349,59929760,6402,58.64,90.09,548901.94,0,17.50,17.99,2.27
6094,0,59938910,9150,83.82,548985.75,2,59951684,12774,59938910,9150,83.81,90.09,548985.75,1,17.56,17.99,2.29
6095,0,59953856,14946,136.87,549122.62,2,59959157,5301,59953856,14946,136.89,90.09,549122.62,0,17.26,17.99,2.27
6096,0,59953856,0,0.00,549122.62,2,59966610,12754,59953856,0,0.00,90.08,549122.62,1,18.25,17.25,2.29
6097,0,59953856,0,0.00,549122.62,2,59971162,17306,59953856,0,0.00,90.06,549122.62,0,17.30,16.30,2.27
6098,0,59953856,0,0.00,549122.62,2,59974483,20627,59953856,0,0.00,90.05,549122.62,1,18.73,17.73,2.28
6099,0,59960418,6562,60.08,549182.75,2,59977764,17346,59960418,6562,60.10,90.04,549182.75,0,17.16,17.73,2.26
6100,0,59969534,9116,83.53,549266.25,2,59982322,12788,59969534,9116,83.49,90.04,549266.25,1,17.22,17.73,2.28
6101,0,59984244,14710,134.71,549401.00,2,59989677,5433,59984244,14710,134.73,90.05,549401.00,0,16.03,17.73,2.26
6102,0,59984244,0,0.00,549401.00,2,59997183,12939,59984244,0,0.00,90.04,549401.00,1,17.88,16.88,2.28
6103,0,59997974,13730,125.77,549526.75,2,60004048,6074,59997974,13730,125.75,90.04,549526.75,0,16.75,16.88,2.26
6104,0,59997974,0,0.00,549526.75,2,60010696,12722,59997974,0,0.00,90.03,549526.75,1,18.59,17.59,2.28
6105,0,60011848,13874,127.05,549653.81,2,60017633,5785,60011848,13874,127.07,90.03,549653.81,0,17.35,17.59,2.25
6106,0,60011848,0,0.00,549653.81,2,60024922,13074,60011848,0,0.00,90.02,549653.81,1,19.19,18.19,2.27
6107,0,60026464,14616,133.87,549787.69,2,60032230,5766,60026464,14616,133.87,90.03,549787.69,0,17.70,18.19,2.25
6108,0,60053866,27402,250.96,550038.62,2,60053866,0,60053866,27402,250.98,90.05,550038.62,1,17.83,18.19,2.26
6109,0,60086457,32591,298.51,550337.12,2,60086457,0,60086457,32591,298.50,90.09,550337.12,1,17.13,18.19,2.24
6110,0,60118600,32143,294.41,550631.56,2,60118600,0,60118600,32143,294.40,90.12,550631.56,0,17.31,18.19,2.22
6111,0,60118600,0,0.00,550631.56,2,60129018,10418,60118600,0,0.00,90.10,550631.56,0,19.55,18.55,2.24
6112,0,60118600,0,0.00,550631.56,2,60134784,16184,60118600,0,0.00,90.09,550631.56,1,21.23,19.00,2.26
6113,0,60129708,11108,101.74,550733.31,2,60140338,10630,60129708,11108,101.74,90.09,550733.31,0,18.84,19.00,2.22
6114,0,60150674,20966,192.01,550925.31,2,60150821,147,60150674,20966,192.03,90.11,550925.31,1,18.94,19.00,2.23
6115,0,60184170,33496,306.79,551232.12,2,60184170,0,60184170,33496,306.79,90.14,551232.12,0,17.05,19.00,2.20
6116,0,60184170,0,0.00,551232.12,2,60194955,10785,60184170,0,0.00,90.13,551232.12,1,19.33,18.33,2.22
6117,0,60203588,19418,177.87,551409.94,2,60204664,1076,60203588,19418,177.85,90.14,551409.94,0,17.32,18.33,2.18
6118,0,60203588,0,0.00,551409.94,2,60214648,11060,60203588,0,0.00,90.13,551409.94,0,19.16,18.16,2.20
6119,0,60203588,0,0.00,551409.94,2,60220093,16505,60203588,0,0.00,90.11,551409.94,0,19.37,18.37,2.21
6120,0,60203588,0,0.00,551409.94,2,60223639,20051,60203588,0,0.00,90.10,551409.94,1,19.91,18.91,2.23
6121,0,60210006,6418,58.80,551468.75,2,60226848,16842,60210006,6418,58.78,90.09,551468.75,0,17.79,18.91,2.20
6122,0,60219016,9010,82.51,551551.25,2,60231353,12337,60219016,9010,82.52,90.09,551551.25,1,18.04,18.91,2.21
6123,0,60234816,15800,144.71,551696.00,2,60239253,4437,60234816,15800,144.71,90.10,551696.00,0,16.45,18.91,2.18
6124,0,60266360,31544,288.91,551984.88,2,60266360,0,60266360,31544,288.91,90.13,551984.88,1,17.44,18.91,2.20
6125,0,60298671,32311,295.95,552280.88,2,60298671,0,60298671,32311,295.94,90.17,552280.88,1,16.12,18.91,2.17
6126,0,60331212,32541,298.04,552578.88,2,60331212,0,60331212,32541,298.05,90.20,552578.88,0,16.64,18.91,2.16
6127,0,60363680,32468,297.38,552876.25,2,60363680,0,60363680,32468,297.38,90.24,552876.25,1,17.46,18.91,2.17
6128,0,60396061,32381,296.57,553172.81,2,60396061,0,60396061,32381,296.58,90.27,553172.81,0,17.64,18.91,2.16
6129,0,60396061,0,0.00,553172.81,2,60406838,10777,60396061,0,0.00,90.25,553172.81,1,19.80,18.80,2.17
6130,0,60396061,0,0.00,553172.81,2,60413002,16941,60396061,0,0.00,90.24,553172.81,1,19.04,18.04,2.16
6131,0,60396061,0,0.00,553172.81,2,60417526,21465,60396061,0,0.00,90.23,553172.81,0,19.57,18.57,2.15
6132,0,60396061,0,0.00,553172.81,2,60421398,25337,60396061,0,0.00,90.21,553172.81,1,19.57,18.57,2.16
6133,0,60403733,7672,70.27,553243.12,2,60425234,21501,60403733,7672,70.27,90.21,553243.12,0,18.15,18.57,2.14
6134,0,60411261,7528,68.95,553312.06,2,60428998,17737,60411261,7528,68.95,90.20,553312.06,1,18.51,18.57,2.16
6135,0,60411261,0,0.00,553312.06,2,60432402,21141,60411261,0,0.00,90.19,553312.06,0,18.93,17.93,2.15
6136,0,60411261,0,0.00,553312.06,2,60435346,24085,60411261,0,0.00,90.17,553312.06,1,18.93,17.93,2.16
6137,0,60416743,5482,50.23,553362.31,2,60438087,21344,60416743,5482,50.21,90.17,553362.31,0,17.52,17.93,2.15
6138,0,60416743,0,0.00,553362.31,2,60440693,23950,60416743,0,0.00,90.15,553362.31,1,17.97,16.97,2.16
6139,0,60421679,4936,45.21,553407.50,2,60443161,21482,60421679,4936,45.21,90.15,553407.50,0,16.77,16.97,2.14
6140,0,60426775,5096,46.67,553454.19,2,60445709,18934,60426775,5096,46.67,90.14,553454.19,1,16.95,16.97,2.16
6141,0,60432233,5458,49.97,553504.12,2,60448438,16205,60432233,5458,49.99,90.13,553504.12,0,15.57,16.97,2.14
6142,0,60440223,7990,73.20,553577.31,2,60452433,12210,60440223,7990,73.18,90.13,553577.31,1,15.62,16.97,2.16
6143,0,60456737,16514,151.23,553728.56,2,60460690,3953,60456737,16514,151.25,90.14,553728.56,0,14.45,16.97,2.14
6144,0,60488325,31588,289.32,554017.88,2,60488325,0,60488325,31588,289.32,90.17,554017.88,1,15.64,16.97,2.16
6145,0,60520329,32004,293.13,554311.00,2,60520329,0,60520329,32004,293.13,90.21,554311.00,0,15.94,16.97,2.14
6146,0,60520329,0,0.00,554311.00,2,60530868,10539,60520329,0,0.00,90.19,554311.00,1,17.55,16.55,2.15
6147,0,60541295,20966,192.05,554503.06,2,60541351,56,60541295,20966,192.03,90.21,554503.06,0,15.87,16.55,2.13
6148,0,60541295,0,0.00,554503.06,2,60551902,10607,60541295,0,0.00,90.19,554503.06,1,17.10,16.10,2.15
6149,0,60561699,20404,186.88,554689.94,2,60562104,405,60561699,20404,186.88,90.21,554689.94,0,15.65,16.10,2.13
6150,0,60561699,0,0.00,554689.94,2,60572279,10580,60561699,0,0.00,90.19,554689.94,1,16.63,15.63,2.14
6151,0,60581563,19864,181.94,554871.88,2,60582211,648,60581563,19864,181.94,90.21,554871.88,0,14.28,15.63,2.10
6152,0,60614319,32756,300.02,555171.88,2,60614319,0,60614319,32756,300.02,90.24,555171.88,1,14.46,15.63,2.12
6153,0,60614319,0,0.00,555171.88,2,60624915,10596,60614319,0,0.00,90.23,555171.88,0,17.18,16.18,2.11
6154,0,60614319,0,0.00,555171.88,2,60630808,16489,60614319,0,0.00,90.21,555171.88,1,18.49,17.49,2.13
6155,0,60614319,0,0.00,555171.88,2,60635275,20956,60614319,0,0.00,90.20,555171.88,0,19.04,18.04,2.11
6156,0,60614319,0,0.00,555171.88,2,60639022,24703,60614319,0,0.00,90.18,555171.88,1,19.31,18.31,2.12
6157,0,60621273,6954,63.67,555235.56,2,60642499,21226,60621273,6954,63.69,90.18,555235.56,0,18.11,18.31,2.11
6158,0,60621273,0,0.00,555235.56,2,60645834,24561,60621273,0,0.00,90.16,555235.56,0,18.34,17.34,2.12
6159,0,60621273,0,0.00,555235.56,2,60648978,27705,60621273,0,0.00,90.15,555235.56,1,19.58,18.58,2.14
6160,0,60627373,6100,55.87,555291.44,2,60652028,24655,60627373,6100,55.87,90.14,555291.44,0,17.62,18.58,2.11
6161,0,60633315,5942,54.44,555345.88,2,60654999,21684,60633315,5942,54.42,90.14,555345.88,1,17.68,18.58,2.12
6162,0,60639195,5880,53.86,555399.75,2,60657939,18744,60639195,5880,53.86,90.13,555399.75,1,16.63,18.58,2.11
6163,0,60645221,6026,55.17,555454.94,2,60660952,15731,60645221,6026,55.19,90.13,555454.94,0,15.60,18.58,2.10
6164,0,60652033,6812,62.39,555517.31,2,60664358,12325,60652033,6812,62.39,90.12,555517.31,1,17.07,18.58,2.11
6165,0,60667479,15446,141.49,555658.81,2,60672081,4602,60667479,15446,141.47,90.13,555658.81,0,16.30,18.58,2.10
6166,0,60697055,29576,270.89,555929.69,2,60697055,0,60697055,29576,270.89,90.16,555929.69,1,16.65,18.58,2.12
6167,0,60729829,32774,300.16,556229.88,2,60729829,0,60729829,32774,300.18,90.19,556229.88,0,15.49,18.58,2.10
6168,0,60762508,32679,299.32,556529.19,2,60762508,0,60762508,32679,299.31,90.23,556529.19,1,16.85,18.58,2.12
6169,0,60795449,32941,301.70,556830.88,2,60795449,0,60795449,32941,301.71,90.26,556830.88,0,16.88,18.58,2.09
6170,0,60828342,32893,301.30,557132.19,2,60828342,0,60828342,32893,301.27,90.30,557132.19,1,17.38,18.58,2.11
6171,0,60860809,32467,297.34,557429.50,2,60860809,0,60860809,32467,297.37,90.33,557429.50,0,18.40,18.58,2.10
6172,0,60860809,0,0.00,557429.50,2,60871627,10818,60860809,0,0.00,90.32,557429.50,1,20.04,19.04,2.11
6173,0,60883244,22435,205.49,557635.00,2,60883244,0,60883244,22435,205.48,90.33,557635.00,0,18.88,19.04,2.09
6174,0,60883244,0,0.00,557635.00,2,60894438,11194,60883244,0,0.00,90.32,557635.00,1,20.69,19.69,2.10
6175,0,60883244,0,0.00,557635.00,2,60900110,16866,60883244,0,0.00,90.31,557635.00,0,20.06,19.06,2.08
6176,0,60883244,0,0.00,557635.00,2,60904834,21590,60883244,0,0.00,90.29,557635.00,1,20.52,19.52,2.10
6177,0,60891788,8544,78.26,557713.25,2,60909106,17318,60891788,8544,78.26,90.29,557713.25,0,19.36,19.52,2.08
6178,0,60900178,8390,76.83,557790.06,2,60913301,13123,60900178,8390,76.84,90.29,557790.06,0,19.44,19.52,2.09
6179,0,60900178,0,0.00,557790.06,2,60917113,16935,60900178,0,0.00,90.27,557790.06,1,19.91,18.91,2.11
6180,0,60900178,0,0.00,557790.06,2,60920234,20056,60900178,0,0.00,90.26,557790.06,0,19.38,18.38,2.09
6181,0,60900178,0,0.00,557790.06,2,60922981,22803,60900178,0,0.00,90.24,557790.06,1,19.38,18.38,2.11
6182,0,60905384,5206,47.70,557837.75,2,60925584,20200,60905384,5206,47.68,90.24,557837.75,0,17.92,18.38,2.09
6183,0,60910798,5414,49.61,557887.38,2,60928291,17493,60910798,5414,49.59,90.23,557887.38,1,17.97,18.38,2.10
6184,0,60917254,6456,59.13,557946.50,2,60931519,14265,60917254,6456,59.13,90.22,557946.50,1,16.49,18.38,2.09
6185,0,60929348,12094,110.75,558057.25,2,60937566,8218,60929348,12094,110.77,90.23,558057.25,1,15.53,18.38,2.08
6186,0,60953822,24474,224.18,558281.44,2,60953822,0,60953822,24474,224.16,90.25,558281.44,0,14.47,18.38,2.07
6187,0,60986450,32628,298.81,558580.25,2,60986450,0,60986450,32628,298.84,90.28,558580.25,0,14.69,18.38,2.08
6188,0,61018660,32210,295.03,558875.31,2,61018660,0,61018660,32210,295.01,90.32,558875.31,1,16.95,18.38,2.10
6189,0,61051036,32376,296.53,559171.81,2,61051036,0,61051036,32376,296.53,90.35,559171.81,0,17.54,18.38,2.08
6190,0,61051036,0,0.00,559171.81,2,61061471,10435,61051036,0,0.00,90.33,559171.81,1,19.83,18.83,2.09
6191,0,61051036,0,0.00,559171.81,2,61067293,16257,61051036,0,0.00,90.32,559171.81,0,19.09,18.09,2.07
6192,0,61051036,0,0.00,559171.81,2,61071805,20769,61051036,0,0.00,90.31,559171.81,1,20.23,19.23,2.09
6193,0,61059198,8162,74.77,559246.62,2,61075886,16688,61059198,8162,74.76,90.30,559246.62,0,18.51,19.23,2.07
6194,0,61067410,8212,75.18,559321.75,2,61079992,12582,61067410,8212,75.21,90.30,559321.75,1,18.87,19.23,2.08
6195,0,61067410,0,0.00,559321.75,2,61083702,16292,61067410,0,0.00,90.29,559321.75,0,19.36,18.36,2.07
6196,0,61067410,0,0.00,559321.75,2,61086760,19350,61067410,0,0.00,90.27,559321.75,1,19.36,18.36,2.08
6197,0,61073182,5772,52.90,559374.69,2,61089646,16464,61073182,5772,52.87,90.27,559374.69,0,17.54,18.36,2.06
6198,0,61081042,7860,71.95,559446.62,2,61093576,12534,61081042,7860,71.99,90.26,559446.62,0,17.59,18.36,2.07
6199,0,61081042,0,0.00,559446.62,2,61097995,16953,61081042,0,0.00,90.25,559446.62,1,18.52,17.52,2.09
6200,0,61081042,0,0.00,559446.62,2,61101131,20089,61081042,0,0.00,90.23,559446.62,0,18.50,17.50,2.08
6201,0,61081042,0,0.00,559446.62,2,61103661,22619,61081042,0,0.00,90.22,559446.62,1,18.50,17.50,2.10
6202,0,61086130,5088,46.60,559493.25,2,61106205,20075,61086130,5088,46.60,90.21,559493.25,0,16.84,17.50,2.07
6203,0,61092562,6432,58.91,559552.12,2,61109421,16859,61092562,6432,58.91,90.21,559552.12,1,16.89,17.50,2.09
6204,0,61102426,9864,90.35,559642.50,2,61114353,11927,61102426,9864,90.35,90.21,559642.50,0,16.20,17.50,2.07
6205,0,61119020,16594,152.00,559794.50,2,61122650,3630,61119020,16594,151.99,90.22,559794.50,1,17.44,17.50,2.09
6206,0,61149274,30254,277.08,560071.56,2,61149274,0,61149274,30254,277.10,90.25,560071.56,1,16.67,17.50,2.08
6207,0,61149274,0,0.00,560071.56,2,61159652,10378,61149274,0,0.00,90.23,560071.56,0,17.51,16.51,2.06
6208,0,61149274,0,0.00,560071.56,2,61165652,16378,61149274,0,0.00,90.22,560071.56,1,17.88,16.88,2.08
6209,0,61149274,0,0.00,560071.56,2,61170395,21121,61149274,0,0.00,90.20,560071.56,0,17.97,16.97,2.07
6210,0,61149274,0,0.00,560071.56,2,61174478,25204,61149274,0,0.00,90.19,560071.56,1,18.26,17.26,2.08
6211,0,61156784,7510,68.80,560140.38,2,61178233,21449,61156784,7510,68.78,90.19,560140.38,0,16.94,17.26,2.07
6212,0,61164378,7594,69.54,560209.94,2,61182030,17652,61164378,7594,69.55,90.18,560209.94,1,17.00,17.26,2.09
6213,0,61171492,7114,65.18,560275.06,2,61185587,14095,61171492,7114,65.16,90.18,560275.06,0,15.97,17.26,2.07
6214,0,61179546,8054,73.75,560348.81,2,61189614,10068,61179546,8054,73.77,90.18,560348.81,1,16.46,17.26,2.09
6215,0,61200490,20944,191.83,560540.69,2,61200490,0,61200490,20944,191.83,90.19,560540.69,0,14.81,17.26,2.06
6216,0,61232986,32496,297.63,560838.31,2,61232986,0,61232986,32496,297.63,90.22,560838.31,1,15.77,17.26,2.08
6217,0,61264583,31597,289.43,561127.75,2,61264583,0,61264583,31597,289.40,90.26,561127.75,0,15.73,17.26,2.07
6218,0,61264583,0,0.00,561127.75,2,61275423,10840,61264583,0,0.00,90.24,561127.75,0,17.29,16.29,2.08
6219,0,61264583,0,0.00,561127.75,2,61281232,16649,61264583,0,0.00,90.23,561127.75,1,17.67,16.67,2.10
6220,0,61274581,9998,91.55,561219.25,2,61286231,11650,61274581,9998,91.57,90.23,561219.25,0,15.99,16.67,2.08
6221,0,61292769,18188,166.59,561385.88,2,61295325,2556,61292769,18188,166.59,90.24,561385.88,1,16.08,16.67,2.09
6222,0,61292769,0,0.00,561385.88,2,61304766,11997,61292769,0,0.00,90.23,561385.88,0,18.81,17.81,2.08
6223,0,61292769,0,0.00,561385.88,2,61310113,17344,61292769,0,0.00,90.21,561385.88,1,19.44,18.44,2.09
6224,0,61292769,0,0.00,561385.88,2,61313130,20361,61292769,0,0.00,90.20,561385.88,1,19.43,18.43,2.08
6225,0,61298403,5634,51.62,561437.50,2,61315947,17544,61298403,5634,51.60,90.19,561437.50,0,18.38,18.43,2.07
6226,0,61298403,0,0.00,561437.50,2,61318943,20540,61298403,0,0.00,90.18,561437.50,1,18.71,17.71,2.08
6227,0,61304357,5954,54.51,561492.00,2,61321920,17563,61304357,5954,54.53,90.17,561492.00,0,17.69,17.71,2.07
6228,0,61304357,0,0.00,561492.00,2,61324981,20624,61304357,0,0.00,90.16,561492.00,1,18.09,17.09,2.09
6229,0,61310445,6088,55.76,561547.75,2,61328025,17580,61310445,6088,55.76,90.15,561547.75,0,17.05,17.09,2.07
6230,0,61310445,0,0.00,561547.75,2,61331142,20697,61310445,0,0.00,90.14,561547.75,1,17.11,16.11,2.09
6231,0,61316629,6184,56.64,561604.38,2,61334234,17605,61316629,6184,56.64,90.13,561604.38,0,15.72,16.11,2.07
6232,0,61325091,8462,77.52,561681.94,2,61338465,13374,61325091,8462,77.50,90.13,561681.94,1,15.77,16.11,2.09
6233,0,61338075,12984,118.92,561800.88,2,61344957,6882,61338075,12984,118.92,90.13,561800.88,0,14.14,16.11,2.07
6234,0,61363757,25682,235.21,562036.06,2,61363757,0,61363757,25682,235.22,90.16,562036.06,1,14.77,16.11,2.08
6235,0,61397129,33372,305.66,562341.69,2,61397129,0,61397129,33372,305.66,90.19,562341.69,0,14.10,16.11,2.07
6236,0,61428962,31833,291.55,562633.25,2,61428962,0,61428962,31833,291.56,90.22,562633.25,1,15.65,16.11,2.09
6237,0,61461639,32677,299.32,562932.56,2,61461639,0,61461639,32677,299.29,90.26,562932.56,0,15.32,16.11,2.06
6238,0,61461639,0,0.00,562932.56,2,61472138,10499,61461639,0,0.00,90.24,562932.56,0,16.90,15.90,2.07
6239,0,61461639,0,0.00,562932.56,2,61477727,16088,61461639,0,0.00,90.23,562932.56,1,18.26,17.26,2.09
6240,0,61471803,10164,93.09,563025.69,2,61482809,11006,61471803,10164,93.09,90.23,563025.69,0,17.11,17.26,2.08
6241,0,61489429,17626,161.42,563187.06,2,61491622,2193,61489429,17626,161.44,90.24,563187.06,1,17.20,17.26,2.09
6242,0,61521679,32250,295.40,563482.50,2,61521679,0,61521679,32250,295.38,90.27,563482.50,0,15.59,17.26,2.07
6243,0,61521679,0,0.00,563482.50,2,61532186,10507,61521679,0,0.00,90.26,563482.50,1,18.60,17.60,2.09
6244,0,61541393,19714,180.54,563663.06,2,61542043,650,61541393,19714,180.56,90.27,563663.06,0,16.88,17.60,2.06
6245,0,61541393,0,0.00,563663.06,2,61551923,10530,61541393,0,0.00,90.26,563663.06,1,18.90,17.90,2.08
6246,0,61541393,0,0.00,563663.06,2,61557293,15900,61541393,0,0.00,90.24,563663.06,0,19.25,18.25,2.07
6247,0,61541393,0,0.00,563663.06,2,61560676,19283,61541393,0,0.00,90.23,563663.06,1,20.13,19.13,2.09
6248,0,61548315,6922,63.42,563726.44,2,61564137,15822,61548315,6922,63.40,90.23,563726.44,0,18.47,19.13,2.06
6249,0,61558751,10436,95.58,563822.06,2,61569355,10604,61558751,10436,95.58,90.23,563822.06,1,18.53,19.13,2.08
6250,0,61576925,18174,166.44,563988.50,2,61578442,1517,61576925,18174,166.46,90.24,563988.50,1,17.62,19.13,2.07
6251,0,61609095,32170,294.67,564283.12,2,61609095,0,61609095,32170,294.65,90.27,564283.12,0,17.30,19.13,2.07
6252,0,61641174,32079,293.82,564576.94,2,61641174,0,61641174,32079,293.81,90.30,564576.94,1,18.48,19.13,2.08
6253,0,61672423,31249,286.20,564863.19,2,61672423,0,61672423,31249,286.21,90.33,564863.19,0,18.48,19.13,2.07
6254,0,61672423,0,0.00,564863.19,2,61683485,11062,61672423,0,0.00,90.32,564863.19,1,19.79,18.79,2.08
6255,0,61672423,0,0.00,564863.19,2,61689520,17097,61672423,0,0.00,90.31,564863.19,0,19.85,18.85,2.07
6256,0,61672423,0,0.00,564863.19,2,61694215,21792,61672423,0,0.00,90.29,564863.19,1,19.85,18.85,2.09
6257,0,61680243,7820,71.62,564934.81,2,61698125,17882,61680243,7820,71.62,90.29,564934.81,0,18.54,18.85,2.08
6258,0,61680243,0,0.00,564934.81,2,61701693,21450,61680243,0,0.00,90.27,564934.81,0,18.95,17.95,2.09
6259,0,61680243,0,0.00,564934.81,2,61704982,24739,61680243,0,0.00,90.26,564934.81,1,18.95,17.95,2.11
6260,0,61686543,6300,57.70,564992.50,2,61708132,21589,61686543,6300,57.70,90.25,564992.50,1,17.43,17.95,2.09
6261,0,61692769,6226,57.01,565049.50,2,61711245,18476,61692769,6226,57.02,90.25,565049.50,0,16.85,17.95,2.08
6262,0,61699131,6362,58.29,565107.81,2,61714426,15295,61699131,6362,58.27,90.24,565107.81,1,16.90,17.95,2.10
6263,0,61707207,8076,73.97,565181.75,2,61718464,11257,61707207,8076,73.97,90.24,565181.75,0,15.59,17.95,2.08
6264,0,61726161,18954,173.58,565355.31,2,61727941,1780,61726161,18954,173.60,90.25,565355.31,1,15.67,17.95,2.10
6265,0,61758229,32068,293.71,565649.06,2,61758229,0,61758229,32068,293.71,90.29,565649.06,0,15.36,17.95,2.08
6266,0,61790372,32143,294.41,565943.44,2,61790372,0,61790372,32143,294.40,90.32,565943.44,1,15.65,17.95,2.10
6267,0,61790372,0,0.00,565943.44,2,61800828,10456,61790372,0,0.00,90.31,565943.44,0,20.95,19.95,2.08
6268,0,61790372,0,0.00,565943.44,2,61806678,16306,61790372,0,0.00,90.29,565943.44,1,21.94,19.00,2.10
6269,0,61790372,0,0.00,565943.44,2,61811159,20787,61790372,0,0.00,90.28,565943.44,0,20.71,19.71,2.08
6270,0,61790372,0,0.00,565943.44,2,61815024,24652,61790372,0,0.00,90.26,565943.44,1,20.84,19.84,2.09
6271,0,61790372,0,0.00,565943.44,2,61818461,28089,61790372,0,0.00,90.25,565943.44,0,20.11,19.11,2.08
6272,0,61790372,0,0.00,565943.44,2,61821607,31235,61790372,0,0.00,90.23,565943.44,1,21.26,19.00,2.10
6273,0,61790372,0,0.00,565943.44,2,61824491,34119,61790372,0,0.00,90.22,565943.44,0,19.80,18.80,2.08
6274,0,61790372,0,0.00,565943.44,2,61827216,36844,61790372,0,0.00,90.20,565943.44,1,19.99,18.99,2.09
6275,0,61796022,5650,51.77,565995.25,2,61830041,34019,61796022,5650,51.75,90.20,565995.25,0,18.74,18.99,2.08
6276,0,61801546,5524,50.56,566045.81,2,61832803,31257,61801546,5524,50.59,90.19,566045.81,1,18.88,18.99,2.09
6277,0,61807144,5598,51.29,566097.06,2,61835602,28458,61807144,5598,51.27,90.19,566097.06,0,16.76,18.99,2.06
6278,0,61812516,5372,49.20,566146.31,2,61838288,25772,61812516,5372,49.20,90.18,566146.31,0,16.81,18.99,2.08
6279,0,61817726,5210,47.74,566194.00,2,61840893,23167,61817726,5210,47.72,90.17,566194.00,1,16.85,18.99,2.09
6280,0,61822894,5168,47.33,566241.38,2,61843477,20583,61822894,5168,47.33,90.17,566241.38,0,15.59,18.99,2.08
6281,0,61828238,5344,48.95,566290.31,2,61846149,17911,61828238,5344,48.95,90.16,566290.31,1,15.63,18.99,2.09
6282,0,61833972,5734,52.50,566342.81,2,61849016,15044,61833972,5734,52.52,90.15,566342.81,0,13.81,18.99,2.07
6283,0,61841344,7372,67.52,566410.31,2,61852702,11358,61841344,7372,67.52,90.15,566410.31,1,13.86,18.99,2.08
6284,0,61857664,16320,149.48,566559.81,2,61860862,3198,61857664,16320,149.48,90.16,566559.81,0,12.09,18.99,2.06
6285,0,61888518,30854,282.61,566842.44,2,61888518,0,61888518,30854,282.59,90.19,566842.44,1,12.42,18.99,2.07
6286,0,61920567,32049,293.53,567135.94,2,61920567,0,61920567,32049,293.54,90.22,567135.94,1,13.64,18.99,2.07
6287,0,61953436,32869,301.04,567437.00,2,61953436,0,61953436,32869,301.05,90.26,567437.00,0,15.02,18.99,2.06
6288,0,61986050,32614,298.70,567735.69,2,61986050,0,61986050,32614,298.71,90.29,567735.69,1,17.64,18.99,2.07
6289,0,62018884,32834,300.75,568036.44,2,62018884,0,62018884,32834,300.73,90.32,568036.44,0,18.39,18.99,2.06
6290,0,62018884,0,0.00,568036.44,2,62029377,10493,62018884,0,0.00,90.31,568036.44,1,19.58,18.58,2.07
6291,0,62041112,22228,203.59,568240.00,2,62041112,0,62041112,22228,203.59,90.33,568240.00,0,18.47,18.58,2.06
6292,0,62041112,0,0.00,568240.00,2,62051881,10769,62041112,0,0.00,90.31,568240.00,1,19.41,18.41,2.08
6293,0,62041112,0,0.00,568240.00,2,62057747,16635,62041112,0,0.00,90.30,568240.00,0,18.89,17.89,2.06
6294,0,62041112,0,0.00,568240.00,2,62062481,21369,62041112,0,0.00,90.28,568240.00,1,19.07,18.07,2.08
6295,0,62049660,8548,78.29,568318.31,2,62066755,17095,62049660,8548,78.29,90.28,568318.31,0,17.62,18.07,2.05
6296,0,62049660,0,0.00,568318.31,2,62070621,20961,62049660,0,0.00,90.27,568318.31,1,19.34,18.34,2.07
6297,0,62056630,6970,63.86,568382.19,2,62074106,17476,62056630,6970,63.84,90.26,568382.19,0,18.04,18.34,2.05
6298,0,62063534,6904,63.23,568445.38,2,62077558,14024,62063534,6904,63.23,90.26,568445.38,0,18.11,18.34,2.07
6299,0,62063534,0,0.00,568445.38,2,62080739,17205,62063534,0,0.00,90.24,568445.38,0,18.45,17.45,2.09
6300,0,62063534,0,0.00,568445.38,2,62083429,19895,62063534,0,0.00,90.23,568445.38,1,19.87,18.87,2.10
6301,0,62069046,5512,50.48,568495.88,2,62086185,17139,62069046,5512,50.48,90.22,568495.88,1,18.42,18.87,2.08
6302,0,62076840,7794,71.37,568567.25,2,62090082,13242,62076840,7794,71.39,90.22,568567.25,0,17.02,18.87,2.06
6303,0,62091270,14430,132.18,568699.44,2,62097297,6027,62091270,14430,132.17,90.23,568699.44,1,17.09,18.87,2.08
6304,0,62119860,28590,261.84,568961.25,2,62119860,0,62119860,28590,261.86,90.25,568961.25,1,16.36,18.87,2.06
6305,0,62151490,31630,289.68,569250.94,2,62151490,0,62151490,31630,289.70,90.29,569250.94,0,16.66,18.87,2.06
6306,0,62183524,32034,293.42,569544.38,2,62183524,0,62183524,32034,293.40,90.32,569544.38,1,16.95,18.87,2.07
6307,0,62215908,32384,296.61,569841.00,2,62215908,0,62215908,32384,296.61,90.35,569841.00,0,16.37,18.87,2.06
6308,0,62248367,32459,297.30,570138.31,2,62248367,0,62248367,32459,297.29,90.38,570138.31,1,18.65,18.87,2.07
6309,0,62248367,0,0.00,570138.31,2,62258937,10570,62248367,0,0.00,90.37,570138.31,0,19.77,18.77,2.06
6310,0,62248367,0,0.00,570138.31,2,62265019,16652,62248367,0,0.00,90.35,570138.31,1,21.65,19.00,2.08
6311,0,62248367,0,0.00,570138.31,2,62269576,21209,62248367,0,0.00,90.34,570138.31,1,19.91,18.91,2.05
6312,0,62248367,0,0.00,570138.31,2,62273477,25110,62248367,0,0.00,90.33,570138.31,0,19.85,18.85,2.04
6313,0,62248367,0,0.00,570138.31,2,62276857,28490,62248367,0,0.00,90.31,570138.31,0,20.45,19.45,2.06
6314,0,62248367,0,0.00,570138.31,2,62280193,31826,62248367,0,0.00,90.30,570138.31,1,20.81,19.81,2.07
6315,0,62254597,6230,57.04,570195.31,2,62283308,28711,62254597,6230,57.06,90.29,570195.31,0,18.73,19.81,2.04
6316,0,62260855,6258,57.34,570252.69,2,62286437,25582,62260855,6258,57.32,90.29,570252.69,1,19.01,19.81,2.06
6317,0,62266945,6090,55.76,570308.44,2,62289482,22537,62266945,6090,55.78,90.28,570308.44,0,19.15,19.81,2.04
6318,0,62272903,5958,54.59,570363.00,2,62292461,19558,62272903,5958,54.57,90.28,570363.00,0,19.41,19.81,2.06
6319,0,62278889,5986,54.81,570417.81,2,62295454,16565,62278889,5986,54.83,90.27,570417.81,0,19.46,19.81,2.07
6320,0,62285077,6188,56.68,570474.50,2,62298548,13471,62285077,6188,56.68,90.26,570474.50,1,19.52,19.81,2.09
6321,0,62294803,9726,89.10,570563.62,2,62303411,8608,62294803,9726,89.08,90.26,570563.62,0,17.69,19.81,2.06
6322,0,62317628,22825,209.05,570772.62,2,62317628,0,62317628,22825,209.06,90.28,570772.62,1,19.52,19.81,2.07
6323,0,62350167,32539,298.04,571070.69,2,62350167,0,62350167,32539,298.03,90.32,571070.69,1,18.47,19.81,2.06
6324,0,62382081,31914,292.28,571363.00,2,62382081,0,62382081,31914,292.30,90.35,571363.00,0,19.17,19.81,2.04
6325,0,62382081,0,0.00,571363.00,2,62392601,10520,62382081,0,0.00,90.33,571363.00,1,20.48,19.48,2.06
6326,0,62402085,20004,183.22,571546.19,2,62402603,518,62402085,20004,183.22,90.35,571546.19,0,19.20,19.48,2.04
6327,0,62402085,0,0.00,571546.19,2,62412580,10495,62402085,0,0.00,90.33,571546.19,1,19.74,18.74,2.06
6328,0,62402085,0,0.00,571546.19,2,62417786,15701,62402085,0,0.00,90.32,571546.19,1,18.87,17.87,2.04
6329,0,62402085,0,0.00,571546.19,2,62421407,19322,62402085,0,0.00,90.31,571546.19,0,18.28,17.28,2.03
6330,0,62402085,0,0.00,571546.19,2,62424596,22511,62402085,0,0.00,90.29,571546.19,1,18.28,17.28,2.05
6331,0,62408687,6602,60.49,571606.69,2,62427897,19210,62408687,6602,60.47,90.29,571606.69,0,17.27,17.28,2.04
6332,0,62408687,0,0.00,571606.69,2,62431152,22465,62408687,0,0.00,90.27,571606.69,1,17.33,16.33,2.05
6333,0,62414481,5794,53.05,571659.75,2,62434049,19568,62414481,5794,53.07,90.27,571659.75,0,15.99,16.33,2.04
6334,0,62414481,0,0.00,571659.75,2,62436860,22379,62414481,0,0.00,90.25,571659.75,1,16.38,15.38,2.06
6335,0,62414481,0,0.00,571659.75,2,62439492,25011,62414481,0,0.00,90.24,571659.75,0,16.07,15.07,2.04
6336,0,62414481,0,0.00,571659.75,2,62441988,27507,62414481,0,0.00,90.22,571659.75,1,16.07,15.07,2.06
6337,0,62419293,4812,44.07,571703.81,2,62444394,25101,62419293,4812,44.07,90.22,571703.81,0,14.34,15.07,2.04
6338,0,62424047,4754,43.56,571747.38,2,62446771,22724,62424047,4754,43.54,90.21,571747.38,1,14.86,15.07,2.05
6339,0,62429031,4984,45.65,571793.00,2,62449263,20232,62429031,4984,45.65,90.20,571793.00,0,14.59,15.07,2.04
6340,0,62434647,5616,51.44,571844.44,2,62452071,17424,62434647,5616,51.44,90.20,571844.44,1,14.63,15.07,2.06
6341,0,62441071,6424,58.84,571903.31,2,62455283,14212,62441071,6424,58.84,90.19,571903.31,0,13.58,15.07,2.04
6342,0,62451925,10854,99.39,572002.69,2,62460710,8785,62451925,10854,99.41,90.19,572002.69,1,14.29,15.07,2.05
6343,0,62475475,23550,215.71,572218.38,2,62475475,0,62475475,23550,215.70,90.21,572218.38,1,13.30,15.07,2.04
6344,0,62507951,32476,297.45,572515.81,2,62507951,0,62507951,32476,297.45,90.25,572515.81,0,13.78,15.07,2.02
6345,0,62507951,0,0.00,572515.81,2,62518619,10668,62507951,0,0.00,90.23,572515.81,0,16.60,15.60,2.04
6346,0,62507951,0,0.00,572515.81,2,62524865,16914,62507951,0,0.00,90.22,572515.81,1,17.78,16.78,2.05
6347,0,62507951,0,0.00,572515.81,2,62529464,21513,62507951,0,0.00,90.20,572515.81,0,17.11,16.11,2.03
6348,0,62507951,0,0.00,572515.81,2,62533259,25308,62507951,0,0.00,90.19,572515.81,1,17.96,16.96,2.05
6349,0,62515307,7356,67.37,572583.19,2,62536937,21630,62515307,7356,67.37,90.18,572583.19,0,16.21,16.96,2.02
6350,0,62522509,7202,65.95,572649.19,2,62540538,18029,62522509,7202,65.96,90.18,572649.19,1,16.30,16.96,2.04
6351,0,62529471,6962,63.78,572712.94,2,62544019,14548,62529471,6962,63.77,90.18,572712.94,0,14.67,16.96,2.02
6352,0,62536879,7408,67.85,572780.81,2,62547723,10844,62536879,7408,67.85,90.17,572780.81,1,14.74,16.96,2.03
6353,0,62554771,17892,163.87,572944.69,2,62556669,1898,62554771,17892,163.87,90.18,572944.69,0,12.84,16.96,2.00
6354,0,62587553,32782,300.23,573244.88,2,62587553,0,62587553,32782,300.25,90.22,573244.88,1,13.00,16.96,2.02
6355,0,62620069,32516,297.82,573542.75,2,62620069,0,62620069,32516,297.82,90.25,573542.75,0,13.44,16.96,2.00
6356,0,62652584,32515,297.82,573840.56,2,62652584,0,62652584,32515,297.81,90.28,573840.56,1,14.66,16.96,2.01
6357,0,62685163,32579,298.40,574138.94,2,62685163,0,62685163,32579,298.39,90.32,574138.94,0,15.68,16.96,2.00
6358,0,62685163,0,0.00,574138.94,2,62695697,10534,62685163,0,0.00,90.30,574138.94,0,18.71,17.71,2.01
6359,0,62685163,0,0.00,574138.94,2,62701390,16227,62685163,0,0.00,90.29,574138.94,1,18.99,17.99,2.03
6360,0,62695097,9934,90.97,574229.94,2,62706357,11260,62695097,9934,90.99,90.29,574229.94,0,17.33,17.99,2.00
6361,0,62712649,17552,160.76,574390.69,2,62715133,2484,62712649,17552,160.76,90.30,574390.69,1,17.42,17.99,2.01
6362,0,62744430,31781,291.11,574681.81,2,62744430,0,62744430,31781,291.08,90.33,574681.81,0,16.44,17.99,2.00
6363,0,62776679,32249,295.36,574977.12,2,62776679,0,62776679,32249,295.37,90.36,574977.12,1,16.72,17.99,2.02
6364,0,62809578,32899,301.30,575278.44,2,62809578,0,62809578,32899,301.32,90.40,575278.44,1,17.13,17.99,2.00
6365,0,62809578,0,0.00,575278.44,2,62820322,10744,62809578,0,0.00,90.38,575278.44,0,18.01,17.01,1.98
6366,0,62809578,0,0.00,575278.44,2,62826279,16701,62809578,0,0.00,90.37,575278.44,1,18.39,17.39,2.00
6367,0,62809578,0,0.00,575278.44,2,62830965,21387,62809578,0,0.00,90.35,575278.44,0,18.36,17.36,1.98
6368,0,62809578,0,0.00,575278.44,2,62835003,25425,62809578,0,0.00,90.34,575278.44,1,18.36,17.36,2.00
6369,0,62817126,7548,69.17,575347.62,2,62838777,21651,62817126,7548,69.13,90.34,575347.62,0,17.05,17.36,1.98
6370,0,62817126,0,0.00,575347.62,2,62842274,25148,62817126,0,0.00,90.32,575347.62,1,18.55,17.55,1.99
6371,0,62823504,6378,58.40,575406.00,2,62845463,21959,62823504,6378,58.42,90.32,575406.00,0,17.30,17.55,1.97
6372,0,62829658,6154,56.35,575462.38,2,62848540,18882,62829658,6154,56.37,90.31,575462.38,1,17.36,17.55,1.99
6373,0,62835518,5860,53.71,575516.06,2,62851470,15952,62835518,5860,53.67,90.31,575516.06,0,15.87,17.55,1.97
6374,0,62842296,6778,62.06,575578.12,2,62854859,12563,62842296,6778,62.08,90.30,575578.12,1,15.92,17.55,1.99
6375,0,62856428,14132,129.44,575707.56,2,62861925,5497,62856428,14132,129.44,90.31,575707.56,0,14.19,17.55,1.96
6376,0,62886940,30512,279.46,575987.00,2,62886940,0,62886940,30512,279.46,90.34,575987.00,1,14.35,17.55,1.97
6377,0,62919502,32562,298.26,576285.31,2,62919502,0,62919502,32562,298.24,90.37,576285.31,0,14.28,17.55,1.96
6378,0,62952095,32593,298.51,576583.81,2,62952095,0,62952095,32593,298.52,90.40,576583.81,0,15.56,17.55,1.97
6379,0,62952095,0,0.00,576583.81,2,62962686,10591,62952095,0,0.00,90.39,576583.81,1,17.59,16.59,1.99
6380,0,62973844,21749,199.19,576783.00,2,62973844,0,62973844,21749,199.20,90.40,576783.00,0,15.15,16.59,1.95
6381,0,62973844,0,0.00,576783.00,2,62984308,10464,62973844,0,0.00,90.39,576783.00,1,19.27,18.27,1.96
6382,0,62994506,20662,189.23,576972.19,2,62994639,133,62994506,20662,189.25,90.41,576972.19,1,18.26,18.27,1.95
6383,0,62994506,0,0.00,576972.19,2,63005529,11023,62994506,0,0.00,90.39,576972.19,0,18.47,17.47,1.93
6384,0,62994506,0,0.00,576972.19,2,63010892,16386,62994506,0,0.00,90.38,576972.19,1,18.47,17.47,1.94
6385,0,63004974,10468,95.91,577068.12,2,63016126,11152,63004974,10468,95.88,90.38,577068.12,0,17.36,17.47,1.93
6386,0,63004974,0,0.00,577068.12,2,63021187,16213,63004974,0,0.00,90.36,577068.12,1,17.95,16.95,1.94
6387,0,63004974,0,0.00,577068.12,2,63024628,19654,63004974,0,0.00,90.35,577068.12,0,17.12,16.12,1.92
6388,0,63004974,0,0.00,577068.12,2,63027625,22651,63004974,0,0.00,90.34,577068.12,1,17.12,16.12,1.94
6389,0,63010670,5696,52.17,577120.31,2,63030473,19803,63010670,5696,52.17,90.33,577120.31,1,15.07,16.12,1.91
6390,0,63016636,5966,54.62,577174.94,2,63033456,16820,63016636,5966,54.64,90.32,577174.94,0,14.08,16.12,1.90
6391,0,63023852,7216,66.09,577241.00,2,63037064,13212,63023852,7216,66.09,90.32,577241.00,1,15.18,16.12,1.91
6392,0,63036936,13084,119.84,577360.88,2,63043606,6670,63036936,13084,119.84,90.33,577360.88,0,14.96,16.12,1.90
6393,0,63064027,27091,248.14,577609.00,2,63064027,0,63064027,27091,248.13,90.35,577609.00,1,15.07,16.12,1.91
6394,0,63064027,0,0.00,577609.00,2,63074641,10614,63064027,0,0.00,90.34,577609.00,0,16.14,15.14,1.90
6395,0,63064027,0,0.00,577609.00,2,63080246,16219,63064027,0,0.00,90.32,577609.00,1,18.12,17.12,1.92
6396,0,63074609,10582,96.90,577705.88,2,63085537,10928,63074609,10582,96.92,90.32,577705.88,0,16.53,17.12,1.89
6397,0,63093315,18706,171.35,577877.25,2,63094890,1575,63093315,18706,171.33,90.34,577877.25,0,17.09,17.12,1.91
6398,0,63093315,0,0.00,577877.25,2,63104465,11150,63093315,0,0.00,90.32,577877.25,0,17.42,16.42,1.92
6399,0,63093315,0,0.00,577877.25,2,63109473,16158,63093315,0,0.00,90.31,577877.25,1,17.42,16.42,1.94
6400,0,63104287,10972,100.49,577977.75,2,63114959,10672,63104287,10972,100.49,90.31,577977.75,0,15.16,16.42,1.90
6401,0,63124429,20142,184.46,578162.19,2,63125030,601,63124429,20142,184.48,90.32,578162.19,1,15.25,16.42,1.92
6402,0,63157568,33139,303.53,578465.75,2,63157568,0,63157568,33139,303.52,90.36,578465.75,0,15.04,16.42,1.90
6403,0,63189755,32187,294.81,578760.56,2,63189755,0,63189755,32187,294.80,90.39,578760.56,1,15.33,16.42,1.91
6404,0,63189755,0,0.00,578760.56,2,63200321,10566,63189755,0,0.00,90.37,578760.56,0,17.46,16.46,1.89
6405,0,63189755,0,0.00,578760.56,2,63206043,16288,63189755,0,0.00,90.36,578760.56,1,19.46,18.46,1.90
6406,0,63200555,10800,98.92,578859.44,2,63211443,10888,63200555,10800,98.92,90.36,578859.44,0,18.05,18.46,1.88
6407,0,63220815,20260,185.56,579045.00,2,63221573,758,63220815,20260,185.56,90.38,579045.00,1,18.43,18.46,1.90
6408,0,63220815,0,0.00,579045.00,2,63231841,11026,63220815,0,0.00,90.36,579045.00,1,18.65,17.65,1.88
6409,0,63238529,17714,162.23,579207.25,2,63240698,2169,63238529,17714,162.24,90.37,579207.25,0,16.98,17.65,1.86
6410,0,63271611,33082,303.02,579510.25,2,63271611,0,63271611,33082,303.00,90.41,579510.25,1,17.34,17.65,1.87
6411,0,63271611,0,0.00,579510.25,2,63282168,10557,63271611,0,0.00,90.39,579510.25,0,17.95,16.95,1.86
6412,0,63271611,0,0.00,579510.25,2,63288053,16442,63271611,0,0.00,90.38,579510.25,1,18.64,17.64,1.87
6413,0,63282419,10808,98.99,579609.25,2,63293457,11038,63282419,10808,98.99,90.38,579609.25,0,17.07,17.64,1.85
6414,0,63300137,17718,162.26,579771.50,2,63302316,2179,63300137,17718,162.28,90.39,579771.50,1,17.29,17.64,1.87
6415,0,63332641,32504,297.71,580069.25,2,63332641,0,63332641,32504,297.71,90.42,580069.25,0,15.79,17.64,1.85
6416,0,63365546,32905,301.37,580370.62,2,63365546,0,63365546,32905,301.38,90.46,580370.62,1,17.22,17.64,1.86
6417,0,63365546,0,0.00,580370.62,2,63376137,10591,63365546,0,0.00,90.44,580370.62,0,17.77,16.77,1.84
6418,0,63365546,0,0.00,580370.62,2,63382164,16618,63365546,0,0.00,90.43,580370.62,0,18.66,17.66,1.85
6419,0,63365546,0,0.00,580370.62,2,63386834,21288,63365546,0,0.00,90.41,580370.62,1,18.81,17.81,1.87
6420,0,63374200,8654,79.28,580449.88,2,63391161,16961,63374200,8654,79.26,90.41,580449.88,0,16.76,17.81,1.84
6421,0,63382276,8076,73.97,580523.88,2,63395199,12923,63382276,8076,73.97,90.41,580523.88,1,17.02,17.81,1.86
6422,0,63393610,11334,103.79,580627.62,2,63400866,7256,63393610,11334,103.81,90.41,580627.62,1,15.84,17.81,1.84
6423,0,63420815,27205,249.20,580876.81,2,63420815,0,63420815,27205,249.17,90.44,580876.81,0,14.79,17.81,1.82
6424,0,63453721,32906,301.37,581178.19,2,63453721,0,63453721,32906,301.39,90.47,581178.19,1,16.29,17.81,1.84
6425,0,63486904,33183,303.94,581482.12,2,63486904,0,63486904,33183,303.93,90.50,581482.12,0,16.16,17.81,1.83
6426,0,63486904,0,0.00,581482.12,2,63497344,10440,63486904,0,0.00,90.49,581482.12,1,18.99,17.99,1.84
6427,0,63486904,0,0.00,581482.12,2,63503345,16441,63486904,0,0.00,90.47,581482.12,1,18.93,17.93,1.81
6428,0,63497768,10864,99.50,581581.62,2,63508777,11009,63497768,10864,99.50,90.48,581581.62,0,17.70,17.93,1.79
6429,0,63517202,19434,177.98,581759.62,2,63518494,1292,63517202,19434,178.00,90.49,581759.62,0,17.80,17.93,1.81
6430,0,63517202,0,0.00,581759.62,2,63527884,10682,63517202,0,0.00,90.48,581759.62,1,18.22,17.22,1.82
6431,0,63535890,18688,171.17,581930.81,2,63537228,1338,63535890,18688,171.17,90.49,581930.81,0,17.17,17.22,1.79
6432,0,63535890,0,0.00,581930.81,2,63546992,11102,63535890,0,0.00,90.47,581930.81,1,17.48,16.48,1.81
6433,0,63554336,18446,168.97,582099.75,2,63556215,1879,63554336,18446,168.95,90.49,582099.75,0,15.94,16.48,1.77
6434,0,63554336,0,0.00,582099.75,2,63565327,10991,63554336,0,0.00,90.47,582099.75,1,17.35,16.35,1.79
6435,0,63573902,19566,179.23,582279.00,2,63575110,1208,63573902,19566,179.21,90.49,582279.00,0,15.77,16.35,1.76
6436,0,63606577,32675,299.25,582578.25,2,63606577,0,63606577,32675,299.27,90.52,582578.25,1,16.20,16.35,1.78
6437,0,63638821,32244,295.33,582873.56,2,63638821,0,63638821,32244,295.33,90.55,582873.56,0,15.39,16.35,1.74
6438,0,63638821,0,0.00,582873.56,2,63649340,10519,63638821,0,0.00,90.54,582873.56,1,17.42,16.42,1.75
6439,0,63638821,0,0.00,582873.56,2,63654899,16078,63638821,0,0.00,90.52,582873.56,0,17.88,16.88,1.73
6440,0,63638821,0,0.00,582873.56,2,63659408,20587,63638821,0,0.00,90.51,582873.56,0,17.88,16.88,1.75
6441,0,63638821,0,0.00,582873.56,2,63663330,24509,63638821,0,0.00,90.49,582873.56,1,17.88,16.88,1.76
6442,0,63646581,7760,71.07,582944.62,2,63667210,20629,63646581,7760,71.07,90.49,582944.62,0,15.52,16.88,1.73
6443,0,63654187,7606,69.68,583014.31,2,63671013,16826,63654187,7606,69.66,90.49,583014.31,1,15.59,16.88,1.74
6444,0,63661771,7584,69.46,583083.75,2,63674805,13034,63661771,7584,69.46,90.48,583083.75,0,13.67,16.88,1.71
6445,0,63672893,11122,101.85,583185.62,2,63680366,7473,63672893,11122,101.87,90.49,583185.62,1,13.74,16.88,1.73
6446,0,63697804,24911,228.17,583413.81,2,63697804,0,63697804,24911,228.16,90.51,583413.81,0,12.79,16.88,1.71
6447,0,63729669,31865,291.85,583705.62,2,63729669,0,63729669,31865,291.85,90.54,583705.62,1,14.45,16.88,1.73
6448,0,63762088,32419,296.94,584002.56,2,63762088,0,63762088,32419,296.93,90.57,584002.56,1,14.81,16.88,1.70
6449,0,63794748,32660,299.14,584301.75,2,63794748,0,63794748,32660,299.14,90.60,584301.75,0,15.59,16.88,1.68
6450,0,63794748,0,0.00,584301.75,2,63805325,10577,63794748,0,0.00,90.59,584301.75,0,17.88,16.88,1.70
6451,0,63794748,0,0.00,584301.75,2,63811041,16293,63794748,0,0.00,90.58,584301.75,0,19.35,18.35,1.71
6452,0,63794748,0,0.00,584301.75,2,63815307,20559,63794748,0,0.00,90.56,584301.75,1,19.35,18.35,1.73
6453,0,63803156,8408,77.01,584378.75,2,63819511,16355,63803156,8408,77.01,90.56,584378.75,1,18.01,18.35,1.71
6454,0,63811862,8706,79.76,584458.50,2,63823864,12002,63811862,8706,79.74,90.56,584458.50,0,16.60,18.35,1.69
6455,0,63825764,13902,127.31,584585.81,2,63830815,5051,63825764,13902,127.33,90.56,584585.81,1,16.68,18.35,1.70
6456,0,63857427,31663,290.01,584875.81,2,63857427,0,63857427,31663,290.00,90.59,584875.81,0,15.06,18.35,1.68
6457,0,63892561,35134,321.78,585197.56,2,63892561,0,63892561,35134,321.80,90.63,585197.56,1,16.94,18.35,1.69
6458,0,63927851,35290,323.24,585520.81,2,63927851,0,63927851,35290,323.22,90.67,585520.81,0,17.20,18.35,1.68
6459,0,63927851,0,0.00,585520.81,2,63939139,11288,63927851,0,0.00,90.65,585520.81,0,18.94,17.94,1.70
6460,0,63927851,0,0.00,585520.81,2,63945394,17543,63927851,0,0.00,90.64,585520.81,1,20.72,19.72,1.71
6461,0,63938415,10564,96.76,585617.56,2,63950676,12261,63938415,10564,96.76,90.64,585617.56,1,19.39,19.72,1.70
6462,0,63954949,16534,151.42,585769.00,2,63958943,3994,63954949,16534,151.44,90.65,585769.00,0,18.61,19.72,1.69
6463,0,63954949,0,0.00,585769.00,2,63967791,12842,63954949,0,0.00,90.63,585769.00,1,20.45,19.45,1.70
6464,0,63973637,18688,171.17,585940.19,2,63977135,3498,63973637,18688,171.17,90.65,585940.19,1,19.18,19.45,1.69
6465,0,64005920,32283,295.69,586235.88,2,64005920,0,64005920,32283,295.68,90.68,586235.88,0,19.29,19.45,1.68
6466,0,64005920,0,0.00,586235.88,2,64016532,10612,64005920,0,0.00,90.66,586235.88,1,20.22,19.22,1.70
6467,0,64005920,0,0.00,586235.88,2,64022495,16575,64005920,0,0.00,90.65,586235.88,0,19.67,18.67,1.68
6468,0,64005920,0,0.00,586235.88,2,64027019,21099,64005920,0,0.00,90.64,586235.88,1,19.67,18.67,1.70
6469,0,64014284,8364,76.61,586312.50,2,64031201,16917,64014284,8364,76.61,90.63,586312.50,0,18.19,18.67,1.67
6470,0,64022188,7904,72.39,586384.88,2,64035153,12965,64022188,7904,72.39,90.63,586384.88,1,18.26,18.67,1.69
6471,0,64032770,10582,96.90,586481.75,2,64040444,7674,64032770,10582,96.92,90.63,586481.75,1,16.67,18.67,1.67
6472,0,64060206,27436,251.33,586733.06,2,64060206,0,64060206,27436,251.29,90.66,586733.06,0,15.50,18.67,1.66
6473,0,64060206,0,0.00,586733.06,2,64070685,10479,64060206,0,0.00,90.64,586733.06,0,19.98,18.98,1.67
6474,0,64060206,0,0.00,586733.06,2,64076775,16569,64060206,0,0.00,90.63,586733.06,1,20.96,19.96,1.69
6475,0,64070732,10526,96.39,586829.50,2,64082038,11306,64070732,10526,96.41,90.63,586829.50,0,19.82,19.96,1.65
6476,0,64070732,0,0.00,586829.50,2,64086865,16133,64070732,0,0.00,90.62,586829.50,1,20.78,19.78,1.67
6477,0,64079974,9242,84.67,586914.12,2,64091486,11512,64079974,9242,84.65,90.62,586914.12,0,19.30,19.78,1.65
6478,0,64097314,17340,158.78,587072.94,2,64100156,2842,64097314,17340,158.82,90.63,587072.94,0,19.68,19.78,1.67
6479,0,64097314,0,0.00,587072.94,2,64108915,11601,64097314,0,0.00,90.61,587072.94,1,20.24,19.24,1.68
6480,0,64115554,18240,167.06,587240.00,2,64118035,2481,64115554,18240,167.06,90.62,587240.00,1,18.42,19.24,1.65
6481,0,64148206,32652,299.10,587539.06,2,64148206,0,64148206,32652,299.06,90.66,587539.06,0,18.11,19.24,1.65
6482,0,64148206,0,0.00,587539.06,2,64159120,10914,64148206,0,0.00,90.64,587539.06,1,19.91,18.91,1.66
6483,0,64148206,0,0.00,587539.06,2,64164600,16394,64148206,0,0.00,90.63,587539.06,0,20.40,19.40,1.64
6484,0,64148206,0,0.00,587539.06,2,64169119,20913,64148206,0,0.00,90.61,587539.06,1,21.23,19.00,1.66
6485,0,64148206,0,0.00,587539.06,2,64173049,24843,64148206,0,0.00,90.60,587539.06,0,19.79,18.79,1.64
6486,0,64148206,0,0.00,587539.06,2,64176604,28398,64148206,0,0.00,90.59,587539.06,1,20.07,19.07,1.65
6487,0,64148206,0,0.00,587539.06,2,64179843,31637,64148206,0,0.00,90.57,587539.06,0,19.48,18.48,1.63
6488,0,64148206,0,0.00,587539.06,2,64182867,34661,64148206,0,0.00,90.56,587539.06,1,20.03,19.03,1.64
6489,0,64154040,5834,53.42,587592.50,2,64185784,31744,64154040,5834,53.43,90.55,587592.50,0,18.83,19.03,1.63
6490,0,64154040,0,0.00,587592.50,2,64188578,34538,64154040,0,0.00,90.54,587592.50,0,19.03,18.03,1.64
6491,0,64154040,0,0.00,587592.50,2,64191147,37107,64154040,0,0.00,90.52,587592.50,1,19.03,18.03,1.66
6492,0,64158696,4656,42.64,587635.12,2,64193475,34779,64158696,4656,42.64,90.52,587635.12,1,16.99,18.03,1.63
6493,0,64163376,4680,42.86,587678.00,2,64195815,32439,64163376,4680,42.86,90.51,587678.00,0,15.96,18.03,1.62
6494,0,64168238,4862,44.55,587722.56,2,64198246,30008,64168238,4862,44.53,90.50,587722.56,1,16.00,18.03,1.64
6495,0,64173020,4782,43.78,587766.38,2,64200637,27617,64173020,4782,43.80,90.50,587766.38,0,14.94,18.03,1.62
6496,0,64177722,4702,43.05,587809.38,2,64202988,25266,64177722,4702,43.07,90.49,587809.38,1,15.05,18.03,1.64
6497,0,64182384,4662,42.72,587852.12,2,64205319,22935,64182384,4662,42.70,90.48,587852.12,0,13.70,18.03,1.62
6498,0,64187062,4678,42.86,587895.00,2,64207658,20596,64187062,4678,42.85,90.47,587895.00,0,13.99,18.03,1.64
6499,0,64191994,4932,45.14,587940.12,2,64210124,18130,64191994,4932,45.17,90.47,587940.12,1,14.17,18.03,1.65
6500,0,64197280,5286,48.43,587988.56,2,64212767,15487,64197280,5286,48.41,90.46,587988.56,0,13.54,18.03,1.64
6501,0,64204236,6956,63.71,588052.25,2,64216245,12009,64204236,6956,63.71,90.46,588052.25,1,13.73,18.03,1.66
6502,0,64219956,15720,143.98,588196.25,2,64224105,4149,64219956,15720,143.98,90.46,588196.25,1,12.40,18.03,1.64
6503,0,64250451,30495,279.32,588475.56,2,64250451,0,64250451,30495,279.31,90.49,588475.56,0,11.53,18.03,1.63
6504,0,64283063,32612,298.70,588774.25,2,64283063,0,64283063,32612,298.70,90.52,588774.25,1,13.44,18.03,1.64
6505,0,64316033,32970,301.96,589076.19,2,64316033,0,64316033,32970,301.98,90.56,589076.19,0,12.72,18.03,1.64
6506,0,64348830,32797,300.42,589376.62,2,64348830,0,64348830,32797,300.39,90.59,589376.62,1,14.73,18.03,1.65
6507,0,64381641,32811,300.49,589677.12,2,64381641,0,64381641,32811,300.52,90.62,589677.12,0,15.96,18.03,1.64
6508,0,64414169,32528,297.93,589975.06,2,64414169,0,64414169,32528,297.93,90.65,589975.06,1,16.63,18.03,1.65
6509,0,64446795,32626,298.84,590273.88,2,64446795,0,64446795,32626,298.82,90.69,590273.88,0,16.60,18.03,1.64
6510,0,64479692,32897,301.30,590575.19,2,64479692,0,64479692,32897,301.31,90.72,590575.19,1,17.40,18.03,1.65
6511,0,64479692,0,0.00,590575.19,2,64490105,10413,64479692,0,0.00,90.70,590575.19,0,18.41,17.41,1.64
6512,0,64479692,0,0.00,590575.19,2,64495819,16127,64479692,0,0.00,90.69,590575.19,1,19.57,18.57,1.65
6513,0,64479692,0,0.00,590575.19,2,64500452,20760,64479692,0,0.00,90.68,590575.19,0,18.90,17.90,1.64
6514,0,64479692,0,0.00,590575.19,2,64504302,24610,64479692,0,0.00,90.66,590575.19,1,18.90,17.90,1.65
6515,0,64486994,7302,66.86,590642.06,2,64507953,20959,64486994,7302,66.88,90.66,590642.06,0,16.76,17.90,1.62
6516,0,64494034,7040,64.48,590706.50,2,64511473,17439,64494034,7040,64.48,90.65,590706.50,1,16.82,17.90,1.64
6517,0,64500824,6790,62.21,590768.75,2,64514868,14044,64500824,6790,62.19,90.65,590768.75,0,16.10,17.90,1.63
6518,0,64507976,7152,65.51,590834.25,2,64518444,10468,64507976,7152,65.51,90.65,590834.25,0,16.59,17.90,1.64
6519,0,64525320,17344,158.86,590993.06,2,64527116,1796,64525320,17344,158.86,90.66,590993.06,1,16.65,17.90,1.66
6520,0,64557145,31825,291.48,591284.56,2,64557145,0,64557145,31825,291.49,90.69,591284.56,0,15.47,17.90,1.64
6521,0,64589314,32169,294.63,591579.19,2,64589314,0,64589314,32169,294.64,90.72,591579.19,1,16.37,17.90,1.66
6522,0,64621694,32380,296.61,591875.81,2,64621694,0,64621694,32380,296.57,90.75,591875.81,1,17.51,17.90,1.65
6523,0,64654523,32829,300.67,592176.50,2,64654523,0,64654523,32829,300.68,90.78,592176.50,0,17.83,17.90,1.64
6524,0,64654523,0,0.00,592176.50,2,64665578,11055,64654523,0,0.00,90.77,592176.50,1,18.55,17.55,1.65
6525,0,64674837,20314,186.04,592362.50,2,64675735,898,64674837,20314,186.06,90.78,592362.50,0,17.51,17.55,1.65
6526,0,64674837,0,0.00,592362.50,2,64685510,10673,64674837,0,0.00,90.77,592362.50,1,19.27,18.27,1.66
6527,0,64694657,19820,181.53,592544.06,2,64695420,763,64694657,19820,181.53,90.78,592544.06,0,18.06,18.27,1.65
6528,0,64694657,0,0.00,592544.06,2,64705085,10428,64694657,0,0.00,90.77,592544.06,1,20.35,19.35,1.67
6529,0,64715103,20446,187.29,592731.31,2,64715308,205,64715103,20446,187.27,90.78,592731.31,0,18.88,19.35,1.65
6530,0,64748458,33355,305.47,593036.81,2,64748458,0,64748458,33355,305.50,90.82,593036.81,1,19.06,19.35,1.66
6531,0,64748458,0,0.00,593036.81,2,64759086,10628,64748458,0,0.00,90.80,593036.81,0,19.81,18.81,1.66
6532,0,64748458,0,0.00,593036.81,2,64764970,16512,64748458,0,0.00,90.79,593036.81,1,26.53,19.00,1.67
6533,0,64748458,0,0.00,593036.81,2,64769449,20991,64748458,0,0.00,90.78,593036.81,0,24.67,19.00,1.65
6534,0,64748458,0,0.00,593036.81,2,64773247,24789,64748458,0,0.00,90.76,593036.81,1,26.89,19.00,1.66
6535,0,64748458,0,0.00,593036.81,2,64776829,28371,64748458,0,0.00,90.75,593036.81,0,26.44,19.00,1.65
6536,0,64748458,0,0.00,593036.81,2,64780135,31677,64748458,0,0.00,90.73,593036.81,1,26.44,19.00,1.67
6537,0,64748458,0,0.00,593036.81,2,64783186,34728,64748458,0,0.00,90.72,593036.81,0,24.97,19.00,1.65
6538,0,64748458,0,0.00,593036.81,2,64786037,37579,64748458,0,0.00,90.71,593036.81,0,25.40,19.00,1.67
6539,0,64748458,0,0.00,593036.81,2,64788721,40263,64748458,0,0.00,90.69,593036.81,1,25.84,19.00,1.68
6540,0,64748458,0,0.00,593036.81,2,64791268,42810,64748458,0,0.00,90.68,593036.81,1,25.16,19.00,1.67
6541,0,64748458,0,0.00,593036.81,2,64793694,45236,64748458,0,0.00,90.66,593036.81,0,24.24,19.00,1.66
6542,0,64748458,0,0.00,593036.81,2,64796008,47550,64748458,0,0.00,90.65,593036.81,1,24.24,19.00,1.68
6543,0,64748458,0,0.00,593036.81,2,64798226,49768,64748458,0,0.00,90.64,593036.81,0,22.95,19.00,1.66
6544,0,64748458,0,0.00,593036.81,2,64800264,51806,64748458,0,0.00,90.62,593036.81,1,22.95,19.00,1.68
6545,0,64748458,0,0.00,593036.81,2,64802208,53750,64748458,0,0.00,90.61,593036.81,0,21.75,19.00,1.67
6546,0,64748458,0,0.00,593036.81,2,64804153,55695,64748458,0,0.00,90.60,593036.81,1,21.75,19.00,1.68
6547,0,64748458,0,0.00,593036.81,2,64806077,57619,64748458,0,0.00,90.58,593036.81,0,20.44,19.44,1.67
6548,0,64748458,0,0.00,593036.81,2,64807945,59487,64748458,0,0.00,90.57,593036.81,1,20.44,19.44,1.68
6549,0,64752152,3694,33.85,593070.69,2,64809792,57640,64752152,3694,33.83,90.56,593070.69,0,18.76,19.44,1.66
6550,0,64755826,3674,33.63,593104.31,2,64811629,55803,64755826,3674,33.65,90.55,593104.31,1,18.79,19.44,1.68
6551,0,64759382,3556,32.61,593136.88,2,64813407,54025,64759382,3556,32.57,90.54,593136.88,0,17.64,19.44,1.67
6552,0,64762998,3616,33.12,593170.00,2,64815215,52217,64762998,3616,33.12,90.53,593170.00,1,17.67,19.44,1.68
6553,0,64766600,3602,32.97,593203.00,2,64817016,50416,64766600,3602,32.99,90.52,593203.00,0,15.68,19.44,1.66
6554,0,64770142,3542,32.46,593235.44,2,64818787,48645,64770142,3542,32.44,90.52,593235.44,1,15.71,19.44,1.67
6555,0,64773712,3570,32.68,593268.12,2,64820572,46860,64773712,3570,32.70,90.51,593268.12,0,14.61,19.44,1.66
6556,0,64777256,3544,32.46,593300.62,2,64822344,45088,64777256,3544,32.46,90.50,593300.62,1,14.64,19.44,1.68
6557,0,64780706,3450,31.58,593332.19,2,64824069,43363,64780706,3450,31.60,90.49,593332.19,0,12.95,19.44,1.66
6558,0,64784202,3496,32.02,593364.19,2,64825817,41615,64784202,3496,32.02,90.48,593364.19,1,13.34,19.44,1.67
6559,0,64787676,3474,31.84,593396.06,2,64827554,39878,64787676,3474,31.82,90.47,593396.06,0,12.77,19.44,1.66
6560,0,64791068,3392,31.07,593427.12,2,64829250,38182,64791068,3392,31.07,90.46,593427.12,1,13.86,19.44,1.67
6561,0,64794508,3440,31.51,593458.62,2,64830970,36462,64794508,3440,31.51,90.45,593458.62,0,13.03,19.44,1.66
6562,0,64797726,3218,29.49,593488.12,2,64832579,34853,64797726,3218,29.47,90.44,593488.12,1,13.06,19.44,1.68
6563,0,64800978,3252,29.75,593517.88,2,64834205,33227,64800978,3252,29.79,90.43,593517.88,0,11.92,19.44,1.67
6564,0,64804254,3276,30.04,593547.88,2,64835843,31589,64804254,3276,30.01,90.42,593547.88,1,11.95,19.44,1.68
6565,0,64807586,3332,30.48,593578.38,2,64837509,29923,64807586,3332,30.52,90.42,593578.38,0,10.84,19.44,1.67
6566,0,64810894,3308,30.33,593608.69,2,64839163,28269,64810894,3308,30.30,90.41,593608.69,1,10.87,19.44,1.69
6567,0,64814446,3552,32.53,593641.25,2,64840939,26493,64814446,3552,32.53,90.40,593641.25,0,10.43,19.44,1.69
6568,0,64818132,3686,33.74,593675.00,2,64842782,24650,64818132,3686,33.76,90.39,593675.00,1,10.46,19.44,1.70
6569,0,64821994,3862,35.35,593710.31,2,64844713,22719,64821994,3862,35.37,90.38,593710.31,0,10.53,19.44,1.70
6570,0,64826040,4046,37.08,593747.44,2,64846736,20696,64826040,4046,37.06,90.37,593747.44,1,11.43,19.44,1.71
6571,0,64830276,4236,38.80,593786.19,2,64848854,18578,64830276,4236,38.80,90.36,593786.19,0,10.55,19.44,1.71
6572,0,64834972,4696,43.01,593829.25,2,64851202,16230,64834972,4696,43.01,90.36,593829.25,1,10.58,19.44,1.72
6573,0,64841548,6576,60.23,593889.44,2,64854490,12942,64841548,6576,60.23,90.35,593889.44,0,9.58,19.44,1.72
6574,0,64853888,12340,113.02,594002.50,2,64860660,6772,64853888,12340,113.02,90.36,594002.50,1,9.64,19.44,1.73
6575,0,64878285,24397,223.45,594225.94,2,64878285,0,64878285,24397,223.45,90.38,594225.94,0,11.19,19.44,1.73
6576,0,64911629,33344,305.40,594531.31,2,64911629,0,64911629,33344,305.40,90.41,594531.31,1,12.35,19.44,1.75
6577,0,64944292,32663,299.17,594830.50,2,64944292,0,64944292,32663,299.16,90.44,594830.50,0,13.58,19.44,1.74
6578,0,64976689,32397,296.72,595127.19,2,64976689,0,64976689,32397,296.73,90.47,595127.19,1,15.32,19.44,1.76
6579,0,65009563,32874,301.11,595428.31,2,65009563,0,65009563,32874,301.10,90.50,595428.31,0,15.00,19.44,1.76
6580,0,65041938,32375,296.50,595724.81,2,65041938,0,65041938,32375,296.53,90.54,595724.81,1,17.22,19.44,1.77
6581,0,65074530,32592,298.51,596023.31,2,65074530,0,65074530,32592,298.51,90.57,596023.31,1,18.07,19.44,1.76
6582,0,65074530,0,0.00,596023.31,2,65085091,10561,65074530,0,0.00,90.55,596023.31,0,19.54,18.54,1.76
6583,0,65074530,0,0.00,596023.31,2,65090927,16397,65074530,0,0.00,90.54,596023.31,0,19.71,18.71,1.78
6584,0,65074530,0,0.00,596023.31,2,65095538,21008,65074530,0,0.00,90.53,596023.31,1,19.83,18.83,1.79
6585,0,65083042,8512,77.96,596101.31,2,65099794,16752,65083042,8512,77.96,90.52,596101.31,0,18.56,18.83,1.78
6586,0,65091632,8590,78.69,596180.00,2,65104089,12457,65091632,8590,78.68,90.52,596180.00,1,18.63,18.83,1.79
6587,0,65103714,12082,110.64,596290.62,2,65110130,6416,65103714,12082,110.66,90.53,596290.62,0,17.93,18.83,1.79
6588,0,65132375,28661,262.54,596553.19,2,65132375,0,65132375,28661,262.51,90.55,596553.19,1,18.04,18.83,1.81
6589,0,65164531,32156,294.52,596847.69,2,65164531,0,65164531,32156,294.52,90.58,596847.69,0,16.79,18.83,1.79
6590,0,65196808,32277,295.62,597143.31,2,65196808,0,65196808,32277,295.63,90.61,597143.31,1,17.07,18.83,1.81
6591,0,65229059,32251,295.40,597438.69,2,65229059,0,65229059,32251,295.39,90.64,597438.69,0,18.37,18.83,1.81
6592,0,65229059,0,0.00,597438.69,2,65239801,10742,65229059,0,0.00,90.63,597438.69,1,20.66,19.66,1.82
6593,0,65229059,0,0.00,597438.69,2,65245529,16470,65229059,0,0.00,90.62,597438.69,0,21.45,19.00,1.81
6594,0,65229059,0,0.00,597438.69,2,65249779,20720,65229059,0,0.00,90.60,597438.69,1,21.45,19.00,1.82
6595,0,65229059,0,0.00,597438.69,2,65253433,24374,65229059,0,0.00,90.59,597438.69,0,20.60,19.60,1.82
6596,0,65229059,0,0.00,597438.69,2,65256940,27881,65229059,0,0.00,90.58,597438.69,1,22.04,19.00,1.83
6597,0,65229059,0,0.00,597438.69,2,65260198,31139,65229059,0,0.00,90.56,597438.69,0,21.32,19.00,1.82
6598,0,65229059,0,0.00,597438.69,2,65263188,34129,65229059,0,0.00,90.55,597438.69,0,21.32,19.00,1.84
6599,0,65229059,0,0.00,597438.69,2,65265987,36928,65229059,0,0.00,90.53,597438.69,1,21.32,19.00,1.85
6600,0,65229059,0,0.00,597438.69,2,65268630,39571,65229059,0,0.00,90.52,597438.69,1,20.10,19.10,1.84
6601,0,65229059,0,0.00,597438.69,2,65271137,42078,65229059,0,0.00,90.51,597438.69,0,20.06,19.06,1.83
6602,0,65229059,0,0.00,597438.69,2,65273529,44470,65229059,0,0.00,90.49,597438.69,0,20.92,19.92,1.85
6603,0,65229059,0,0.00,597438.69,2,65275822,46763,65229059,0,0.00,90.48,597438.69,1,20.92,19.92,1.86
6604,0,65233547,4488,41.11,597479.81,2,65278066,44519,65233547,4488,41.11,90.47,597479.81,1,19.78,19.92,1.85
6605,0,65237863,4316,39.53,597519.38,2,65280224,42361,65237863,4316,39.53,90.46,597519.38,0,18.75,19.92,1.85
6606,0,65242009,4146,37.96,597557.31,2,65282297,40288,65242009,4146,37.97,90.46,597557.31,1,18.79,19.92,1.86
6607,0,65246277,4268,39.09,597596.38,2,65284431,38154,65246277,4268,39.09,90.45,597596.38,0,18.15,19.92,1.86
6608,0,65250673,4396,40.26,597636.62,2,65286629,35956,65250673,4396,40.26,90.44,597636.62,1,19.05,19.92,1.87
6609,0,65255039,4366,40.01,597676.69,2,65288812,33773,65255039,4366,39.99,90.43,597676.69,0,18.92,19.92,1.86
6610,0,65259359,4320,39.57,597716.25,2,65290972,31613,65259359,4320,39.57,90.43,597716.25,1,18.95,19.92,1.88
6611,0,65263647,4288,39.27,597755.50,2,65293116,29469,65263647,4288,39.27,90.42,597755.50,0,17.94,19.92,1.87
6612,0,65267887,4240,38.83,597794.31,2,65295236,27349,65267887,4240,38.83,90.41,597794.31,1,17.97,19.92,1.89
6613,0,65272093,4206,38.50,597832.81,2,65297339,25246,65272093,4206,38.52,90.40,597832.81,0,16.95,19.92,1.88
6614,0,65276269,4176,38.25,597871.06,2,65299427,23158,65276269,4176,38.25,90.39,597871.06,1,17.27,19.92,1.89
6615,0,65280613,4344,39.79,597910.88,2,65301599,20986,65280613,4344,39.79,90.39,597910.88,0,16.56,19.92,1.88
6616,0,65285245,4632,42.42,597953.31,2,65303915,18670,65285245,4632,42.42,90.38,597953.31,1,17.46,19.92,1.89
6617,0,65290237,4992,45.72,597999.00,2,65306411,16174,65290237,4992,45.72,90.37,597999.00,0,16.90,19.92,1.89
6618,0,65296415,6178,56.60,598055.62,2,65309500,13085,65296415,6178,56.58,90.37,598055.62,0,16.95,19.92,1.91
6619,0,65309241,12826,117.46,598173.06,2,65315913,6672,65309241,12826,117.47,90.37,598173.06,1,17.00,19.92,1.92
6620,0,65335787,26546,243.16,598416.25,2,65335787,0,65335787,26546,243.14,90.40,598416.25,1,17.47,19.92,1.92
6621,0,65368224,32437,297.08,598713.31,2,65368224,0,65368224,32437,297.09,90.43,598713.31,1,18.16,19.92,1.92
6622,0,65368224,0,0.00,598713.31,2,65378723,10499,65368224,0,0.00,90.41,598713.31,0,20.44,19.44,1.92
6623,0,65368224,0,0.00,598713.31,2,65384486,16262,65368224,0,0.00,90.40,598713.31,1,20.97,19.97,1.93
6624,0,65368224,0,0.00,598713.31,2,65388871,20647,65368224,0,0.00,90.39,598713.31,0,20.74,19.74,1.93
6625,0,65368224,0,0.00,598713.31,2,65392733,24509,65368224,0,0.00,90.37,598713.31,1,21.13,19.00,1.94
6626,0,65368224,0,0.00,598713.31,2,65396149,27925,65368224,0,0.00,90.36,598713.31,0,19.59,18.59,1.92
6627,0,65368224,0,0.00,598713.31,2,65399348,31124,65368224,0,0.00,90.34,598713.31,0,19.59,18.59,1.94
6628,0,65368224,0,0.00,598713.31,2,65402293,34069,65368224,0,0.00,90.33,598713.31,1,19.73,18.73,1.95
6629,0,65373808,5584,51.14,598764.50,2,65405085,31277,65373808,5584,51.14,90.33,598764.50,0,18.23,18.73,1.93
6630,0,65379332,5524,50.59,598815.06,2,65407847,28515,65379332,5524,50.59,90.32,598815.06,1,18.36,18.73,1.95
6631,0,65384720,5388,49.35,598864.44,2,65410541,25821,65384720,5388,49.35,90.31,598864.44,0,16.35,18.73,1.91
6632,0,65390164,5444,49.86,598914.25,2,65413263,23099,65390164,5444,49.86,90.31,598914.25,1,16.65,18.73,1.92
6633,0,65395564,5400,49.46,598963.75,2,65415963,20399,65395564,5400,49.46,90.30,598963.75,0,15.26,18.73,1.90
6634,0,65400828,5264,48.21,599011.94,2,65418595,17767,65400828,5264,48.21,90.29,599011.94,1,15.31,18.73,1.92
6635,0,65406222,5394,49.42,599061.38,2,65421292,15070,65406222,5394,49.40,90.29,599061.38,0,13.14,18.73,1.89
6636,0,65412814,6592,60.38,599121.75,2,65424588,11774,65412814,6592,60.38,90.28,599121.75,1,13.19,18.73,1.90
6637,0,65428320,15506,142.00,599263.75,2,65432341,4021,65428320,15506,142.02,90.29,599263.75,0,11.24,18.73,1.87
6638,0,65458983,30663,280.85,599544.62,2,65458983,0,65458983,30663,280.85,90.32,599544.62,0,11.38,18.73,1.89
6639,0,65491386,32403,296.75,599841.38,2,65491386,0,65491386,32403,296.78,90.35,599841.38,1,16.05,18.73,1.90
6640,0,65523825,32439,297.12,600138.50,2,65523825,0,65523825,32439,297.11,90.38,600138.50,0,15.96,18.73,1.88
6641,0,65556239,32414,296.90,600435.38,2,65556239,0,65556239,32414,296.88,90.41,600435.38,1,18.23,18.73,1.89
6642,0,65588436,32197,294.89,600730.25,2,65588436,0,65588436,32197,294.90,90.44,600730.25,0,16.87,18.73,1.86
6643,0,65620870,32434,297.08,601027.38,2,65620870,0,65620870,32434,297.07,90.48,601027.38,1,17.16,18.73,1.88
6644,0,65653543,32673,299.25,601326.62,2,65653543,0,65653543,32673,299.25,90.51,601326.62,0,16.11,18.73,1.85
6645,0,65686083,32540,298.04,601624.62,2,65686083,0,65686083,32540,298.04,90.54,601624.62,1,18.53,18.73,1.87
6646,0,65686083,0,0.00,601624.62,2,65696678,10595,65686083,0,0.00,90.52,601624.62,0,19.26,18.26,1.86
6647,0,65686083,0,0.00,601624.62,2,65702375,16292,65686083,0,0.00,90.51,601624.62,1,19.63,18.63,1.87
6648,0,65696067,9984,91.44,601716.06,2,65707367,11300,65696067,9984,91.44,90.51,601716.06,0,17.70,18.63,1.85
6649,0,65712871,16804,153.91,601870.00,2,65715769,2898,65712871,16804,153.91,90.52,601870.00,1,18.21,18.63,1.86
6650,0,65744455,31584,289.28,602159.25,2,65744455,0,65744455,31584,289.28,90.55,602159.25,0,18.15,18.63,1.84
6651,0,65744455,0,0.00,602159.25,2,65755085,10630,65744455,0,0.00,90.54,602159.25,1,20.64,19.64,1.86
6652,0,65744455,0,0.00,602159.25,2,65760913,16458,65744455,0,0.00,90.52,602159.25,1,19.66,18.66,1.85
6653,0,65753999,9544,87.41,602246.69,2,65765685,11686,65753999,9544,87.41,90.52,602246.69,0,18.33,18.66,1.84
6654,0,65770323,16324,149.51,602396.19,2,65773847,3524,65770323,16324,149.51,90.53,602396.19,1,18.64,18.66,1.85
6655,0,65801451,31128,285.10,602681.31,2,65801451,0,65801451,31128,285.10,90.56,602681.31,0,18.43,18.66,1.84
6656,0,65801451,0,0.00,602681.31,2,65812158,10707,65801451,0,0.00,90.55,602681.31,1,20.14,19.14,1.86
6657,0,65801451,0,0.00,602681.31,2,65818098,16647,65801451,0,0.00,90.53,602681.31,0,19.64,18.64,1.84
6658,0,65801451,0,0.00,602681.31,2,65822581,21130,65801451,0,0.00,90.52,602681.31,1,19.64,18.64,1.86
6659,0,65809201,7750,70.96,602752.25,2,65826456,17255,65809201,7750,70.98,90.52,602752.25,1,18.13,18.64,1.84
6660,0,65817061,7860,71.99,602824.25,2,65830386,13325,65817061,7860,71.99,90.51,602824.25,0,16.82,18.64,1.83
6661,0,65826851,9790,89.69,602913.94,2,65835281,8430,65826851,9790,89.67,90.51,602913.94,1,17.48,18.64,1.84
6662,0,65851208,24357,223.08,603137.00,2,65851208,0,65851208,24357,223.09,90.53,603137.00,0,15.82,18.64,1.82
6663,0,65883998,32790,300.34,603437.38,2,65883998,0,65883998,32790,300.33,90.57,603437.38,0,16.04,18.64,1.84
6664,0,65916342,32344,296.24,603733.62,2,65916342,0,65916342,32344,296.24,90.60,603733.62,1,18.32,18.64,1.85
6665,0,65948605,32263,295.47,604029.06,2,65948605,0,65948605,32263,295.50,90.63,604029.06,0,17.86,18.64,1.82
6666,0,65948605,0,0.00,604029.06,2,65959271,10666,65948605,0,0.00,90.61,604029.06,1,21.11,19.00,1.84
6667,0,65948605,0,0.00,604029.06,2,65964955,16350,65948605,0,0.00,90.60,604029.06,0,21.15,19.00,1.82
6668,0,65948605,0,0.00,604029.06,2,65969276,20671,65948605,0,0.00,90.59,604029.06,1,21.15,19.00,1.83
6669,0,65948605,0,0.00,604029.06,2,65973108,24503,65948605,0,0.00,90.57,604029.06,0,19.13,18.13,1.81
6670,0,65948605,0,0.00,604029.06,2,65976577,27972,65948605,0,0.00,90.56,604029.06,1,19.13,18.13,1.82
6671,0,65955021,6416,58.76,604087.81,2,65979785,24764,65955021,6416,58.76,90.55,604087.81,0,17.69,18.13,1.79
6672,0,65955021,0,0.00,604087.81,2,65982895,27874,65955021,0,0.00,90.54,604087.81,1,23.78,19.00,1.81
6673,0,65955021,0,0.00,604087.81,2,65985500,30479,65955021,0,0.00,90.53,604087.81,0,22.50,19.00,1.78
6674,0,65955021,0,0.00,604087.81,2,65987940,32919,65955021,0,0.00,90.51,604087.81,1,22.50,19.00,1.80
6675,0,65955021,0,0.00,604087.81,2,65990399,35378,65955021,0,0.00,90.50,604087.81,0,20.03,19.03,1.76
6676,0,65955021,0,0.00,604087.81,2,65992754,37733,65955021,0,0.00,90.49,604087.81,1,20.03,19.03,1.78
6677,0,65959523,4502,41.25,604129.06,2,65995005,35482,65959523,4502,41.23,90.48,604129.06,0,18.50,19.03,1.76
6678,0,65963987,4464,40.89,604170.00,2,65997237,33250,65963987,4464,40.89,90.47,604170.00,0,18.54,19.03,1.77
6679,0,65968353,4366,39.97,604209.94,2,65999420,31067,65968353,4366,39.99,90.46,604209.94,1,18.58,19.03,1.79
6680,0,65972765,4412,40.41,604250.38,2,66001626,28861,65972765,4412,40.41,90.46,604250.38,1,16.70,19.03,1.76
6681,0,65977185,4420,40.48,604290.81,2,66003836,26651,65977185,4420,40.48,90.45,604290.81,0,15.63,19.03,1.75
6682,0,65981781,4596,42.10,604332.94,2,66006134,24353,65981781,4596,42.10,90.44,604332.94,1,16.19,19.03,1.76
6683,0,65986661,4880,44.70,604377.62,2,66008574,21913,65986661,4880,44.70,90.44,604377.62,1,15.39,19.03,1.76
6684,0,65991305,4644,42.53,604420.19,2,66010896,19591,65991305,4644,42.53,90.43,604420.19,0,14.60,19.03,1.75
6685,0,65996049,4744,43.45,604463.62,2,66013268,17219,65996049,4744,43.45,90.42,604463.62,1,15.10,19.03,1.77
6686,0,66001331,5282,48.40,604512.00,2,66015909,14578,66001331,5282,48.38,90.41,604512.00,0,14.45,19.03,1.76
6687,0,66009137,7806,71.48,604583.50,2,66019812,10675,66009137,7806,71.50,90.41,604583.50,1,14.50,19.03,1.77
6688,0,66027367,18230,166.99,604750.50,2,66028927,1560,66027367,18230,166.97,90.42,604750.50,0,13.45,19.03,1.76
6689,0,66060607,33240,304.45,605054.94,2,66060607,0,66060607,33240,304.45,90.46,605054.94,0,15.34,19.03,1.77
6690,0,66093137,32530,297.93,605352.88,2,66093137,0,66093137,32530,297.95,90.49,605352.88,1,16.22,19.03,1.79
6691,0,66126404,33267,304.70,605657.56,2,66126404,0,66126404,33267,304.70,90.52,605657.56,0,15.68,19.03,1.75
6692,0,66159286,32882,301.19,605958.75,2,66159286,0,66159286,32882,301.17,90.55,605958.75,1,17.99,19.03,1.77
6693,0,66192418,33132,303.42,606262.19,2,66192418,0,66192418,33132,303.46,90.58,606262.19,0,16.86,19.03,1.75
6694,0,66225340,32922,301.55,606563.75,2,66225340,0,66225340,32922,301.54,90.61,606563.75,0,18.05,19.03,1.77
6695,0,66225340,0,0.00,606563.75,2,66236136,10796,66225340,0,0.00,90.60,606563.75,1,19.92,18.92,1.78
6696,0,66245292,19952,182.74,606746.44,2,66246112,820,66245292,19952,182.74,90.61,606746.44,1,17.48,18.92,1.74
6697,0,66245292,0,0.00,606746.44,2,66256406,11114,66245292,0,0.00,90.60,606746.44,0,19.40,18.40,1.72
6698,0,66245292,0,0.00,606746.44,2,66261948,16656,66245292,0,0.00,90.59,606746.44,0,19.77,18.77,1.74
6699,0,66245292,0,0.00,606746.44,2,66265303,20011,66245292,0,0.00,90.57,606746.44,0,21.27,19.00,1.75
6700,0,66245292,0,0.00,606746.44,2,66268281,22989,66245292,0,0.00,90.56,606746.44,1,21.27,19.00,1.77
6701,0,66245292,0,0.00,606746.44,2,66271039,25747,66245292,0,0.00,90.55,606746.44,1,19.34,18.34,1.74
6702,0,66250524,5232,47.92,606794.38,2,66273655,23131,66250524,5232,47.92,90.54,606794.38,0,17.44,18.34,1.72
6703,0,66256560,6036,55.28,606849.69,2,66276673,20113,66256560,6036,55.28,90.53,606849.69,1,17.48,18.34,1.73
6704,0,66263046,6486,59.42,606909.12,2,66279916,16870,66263046,6486,59.41,90.53,606909.12,0,15.82,18.34,1.71
6705,0,66269936,6890,63.09,606972.19,2,66283361,13425,66269936,6890,63.11,90.53,606972.19,1,16.44,18.34,1.72
6706,0,66280686,10750,98.48,607070.69,2,66288736,8050,66280686,10750,98.46,90.53,607070.69,1,15.67,18.34,1.71
6707,0,66306543,25857,236.82,607307.50,2,66306543,0,66306543,25857,236.83,90.55,607307.50,0,14.56,18.34,1.70
6708,0,66339050,32507,297.71,607605.19,2,66339050,0,66339050,32507,297.73,90.58,607605.19,1,14.97,18.34,1.71
6709,0,66371866,32816,300.56,607905.75,2,66371866,0,66371866,32816,300.56,90.61,607905.75,1,14.50,18.34,1.70
6710,0,66404374,32508,297.78,608203.56,2,66404374,0,66404374,32508,297.74,90.64,608203.56,0,15.38,18.34,1.69
6711,0,66436853,32479,297.45,608501.00,2,66436853,0,66436853,32479,297.48,90.67,608501.00,0,17.81,18.34,1.70
6712,0,66436853,0,0.00,608501.00,2,66447602,10749,66436853,0,0.00,90.66,608501.00,1,20.10,19.10,1.72
6713,0,66457103,20250,185.49,608686.50,2,66457727,624,66457103,20250,185.47,90.67,608686.50,0,18.42,19.10,1.69
6714,0,66457103,0,0.00,608686.50,2,66467730,10627,66457103,0,0.00,90.66,608686.50,1,20.31,19.31,1.70
6715,0,66457103,0,0.00,608686.50,2,66473021,15918,66457103,0,0.00,90.65,608686.50,0,21.04,19.00,1.69
6716,0,66457103,0,0.00,608686.50,2,66476438,19335,66457103,0,0.00,90.63,608686.50,1,21.04,19.00,1.71
6717,0,66457103,0,0.00,608686.50,2,66479357,22254,66457103,0,0.00,90.62,608686.50,0,19.28,18.28,1.68
6718,0,66457103,0,0.00,608686.50,2,66482037,24934,66457103,0,0.00,90.61,608686.50,0,19.57,18.57,1.70
6719,0,66457103,0,0.00,608686.50,2,66484628,27525,66457103,0,0.00,90.59,608686.50,1,21.00,20.00,1.71
6720,0,66462563,5460,50.01,608736.50,2,66487358,24795,66462563,5460,50.01,90.59,608736.50,0,19.46,20.00,1.69
6721,0,66468491,5928,54.30,608790.75,2,66490322,21831,66468491,5928,54.30,90.58,608790.75,1,19.50,20.00,1.71
6722,0,66474563,6072,55.61,608846.38,2,66493358,18795,66474563,6072,55.61,90.58,608846.38,0,18.11,20.00,1.69
6723,0,66480501,5938,54.37,608900.75,2,66496327,15826,66480501,5938,54.39,90.57,608900.75,1,18.17,20.00,1.70
6724,0,66486891,6390,58.54,608959.31,2,66499522,12631,66486891,6390,58.53,90.57,608959.31,1,17.03,20.00,1.68
6725,0,66500345,13454,123.21,609082.50,2,66506249,5904,66500345,13454,123.23,90.57,609082.50,0,17.32,20.00,1.67
6726,0,66530371,30026,275.03,609357.56,2,66530371,0,66530371,30026,275.01,90.60,609357.56,1,17.91,20.00,1.69
6727,0,66562768,32397,296.72,609654.25,2,66562768,0,66562768,32397,296.73,90.63,609654.25,0,18.17,20.00,1.67
6728,0,66594921,32153,294.48,609948.75,2,66594921,0,66594921,32153,294.49,90.66,609948.75,1,19.38,20.00,1.68
6729,0,66627404,32483,297.52,610246.25,2,66627404,0,66627404,32483,297.51,90.69,610246.25,0,19.07,20.00,1.67
6730,0,66659712,32308,295.91,610542.19,2,66659712,0,66659712,32308,295.91,90.72,610542.19,1,19.97,20.00,1.68
6731,0,66659712,0,0.00,610542.19,2,66670378,10666,66659712,0,0.00,90.71,610542.19,0,20.30,19.30,1.67
6732,0,66659712,0,0.00,610542.19,2,66676205,16493,66659712,0,0.00,90.69,610542.19,1,21.12,19.00,1.68
6733,0,66659712,0,0.00,610542.19,2,66680597,20885,66659712,0,0.00,90.68,610542.19,0,19.65,18.65,1.67
6734,0,66659712,0,0.00,610542.19,2,66684401,24689,66659712,0,0.00,90.67,610542.19,1,20.15,19.15,1.68
6735,0,66666818,7106,65.07,610607.25,2,66687954,21136,66666818,7106,65.08,90.66,610607.25,0,19.02,19.15,1.67
6736,0,66673744,6926,63.45,610670.69,2,66691417,17673,66673744,6926,63.44,90.66,610670.69,1,19.09,19.15,1.69
6737,0,66680728,6984,63.97,610734.69,2,66694909,14181,66680728,6984,63.97,90.65,610734.69,0,17.38,19.15,1.67
6738,0,66688376,7648,70.05,610804.69,2,66698733,10357,66688376,7648,70.05,90.65,610804.69,1,17.44,19.15,1.68
6739,0,66707400,19024,174.24,610978.94,2,66708245,845,66707400,19024,174.24,90.66,610978.94,0,16.03,19.15,1.66
6740,0,66740031,32631,298.88,611277.81,2,66740031,0,66740031,32631,298.87,90.69,611277.81,1,16.20,19.15,1.68
6741,0,66740031,0,0.00,611277.81,2,66750715,10684,66740031,0,0.00,90.68,611277.81,0,22.18,19.00,1.67
6742,0,66740031,0,0.00,611277.81,2,66756573,16542,66740031,0,0.00,90.67,611277.81,1,22.18,19.00,1.68
6743,0,66740031,0,0.00,611277.81,2,66761280,21249,66740031,0,0.00,90.65,611277.81,0,20.67,19.67,1.67
6744,0,66740031,0,0.00,611277.81,2,66765399,25368,66740031,0,0.00,90.64,611277.81,1,22.10,19.00,1.68
6745,0,66740031,0,0.00,611277.81,2,66769057,29026,66740031,0,0.00,90.63,611277.81,1,20.79,19.79,1.66
6746,0,66746879,6848,62.72,611340.56,2,66772481,25602,66746879,6848,62.72,90.62,611340.56,0,19.43,19.79,1.64
6747,0,66753607,6728,61.62,611402.19,2,66775845,22238,66753607,6728,61.62,90.62,611402.19,0,19.49,19.79,1.66
6748,0,66759987,6380,58.43,611460.62,2,66779035,19048,66759987,6380,58.43,90.61,611460.62,1,19.55,19.79,1.67
6749,0,66766291,6304,57.74,611518.38,2,66782187,15896,66766291,6304,57.74,90.61,611518.38,1,17.18,19.79,1.64
6750,0,66772615,6324,57.92,611576.25,2,66785349,12734,66772615,6324,57.92,90.60,611576.25,0,16.02,19.79,1.62
6751,0,66783389,10774,98.66,611674.94,2,66790736,7347,66783389,10774,98.68,90.61,611674.94,0,16.70,19.79,1.64
6752,0,66811726,28337,259.57,611934.50,2,66811726,0,66811726,28337,259.54,90.63,611934.50,1,16.95,19.79,1.65
6753,0,66844576,32850,300.86,612235.38,2,66844576,0,66844576,32850,300.88,90.66,612235.38,0,15.55,19.79,1.61
6754,0,66876973,32397,296.72,612532.06,2,66876973,0,66876973,32397,296.73,90.69,612532.06,1,16.69,19.79,1.63
6755,0,66909401,32428,297.01,612829.06,2,66909401,0,66909401,32428,297.01,90.72,612829.06,0,16.29,19.79,1.61
6756,0,66942134,32733,299.83,613128.94,2,66942134,0,66942134,32733,299.80,90.75,613128.94,1,18.51,19.79,1.63
6757,0,66942134,0,0.00,613128.94,2,66952792,10658,66942134,0,0.00,90.74,613128.94,0,21.25,19.00,1.60
6758,0,66942134,0,0.00,613128.94,2,66958520,16386,66942134,0,0.00,90.73,613128.94,1,21.54,19.00,1.61
6759,0,66942134,0,0.00,613128.94,2,66962890,20756,66942134,0,0.00,90.71,613128.94,0,21.71,19.00,1.59
6760,0,66942134,0,0.00,613128.94,2,66966654,24520,66942134,0,0.00,90.70,613128.94,1,21.71,19.00,1.61
6761,0,66942134,0,0.00,613128.94,2,66970026,27892,66942134,0,0.00,90.69,613128.94,0,20.00,19.00,1.59
6762,0,66942134,0,0.00,613128.94,2,66973268,31134,66942134,0,0.00,90.67,613128.94,1,20.00,19.00,1.60
6763,0,66948186,6052,55.39,613184.31,2,66976294,28108,66948186,6052,55.43,90.67,613184.31,0,18.36,19.00,1.58
6764,0,66954058,5872,53.78,613238.12,2,66979230,25172,66954058,5872,53.78,90.66,613238.12,1,18.41,19.00,1.60
6765,0,66960074,6016,55.10,613293.19,2,66982238,22164,66960074,6016,55.10,90.66,613293.19,0,16.89,19.00,1.58
6766,0,66966010,5936,54.37,613347.56,2,66985206,19196,66966010,5936,54.37,90.65,613347.56,1,16.94,19.00,1.59
6767,0,66971666,5656,51.80,613399.38,2,66988034,16368,66971666,5656,51.80,90.65,613399.38,0,15.29,19.00,1.57
6768,0,66977682,6016,55.10,613454.50,2,66991042,13360,66977682,6016,55.10,90.64,613454.50,1,15.34,19.00,1.59
6769,0,66988040,10358,94.89,613549.38,2,66996221,8181,66988040,10358,94.87,90.64,613549.38,0,13.94,19.00,1.57
6770,0,67014345,26305,240.92,613790.31,2,67014345,0,67014345,26305,240.93,90.66,613790.31,1,14.92,19.00,1.58
6771,0,67046963,32618,298.77,614089.06,2,67046963,0,67046963,32618,298.75,90.69,614089.06,0,14.65,19.00,1.56
6772,0,67079706,32743,299.87,614388.94,2,67079706,0,67079706,32743,299.90,90.72,614388.94,1,17.06,19.00,1.58
6773,0,67112143,32437,297.12,614686.06,2,67112143,0,67112143,32437,297.09,90.76,614686.06,0,17.24,19.00,1.56
6774,0,67144697,32554,298.15,614984.19,2,67144697,0,67144697,32554,298.16,90.79,614984.19,1,18.34,19.00,1.57
6775,0,67177248,32551,298.15,615282.31,2,67177248,0,67177248,32551,298.14,90.82,615282.31,0,17.74,19.00,1.54
6776,0,67177248,0,0.00,615282.31,2,67187801,10553,67177248,0,0.00,90.80,615282.31,1,19.33,18.33,1.56
6777,0,67197776,20528,188.02,615470.38,2,67198065,289,67197776,20528,188.02,90.82,615470.38,0,17.93,18.33,1.54
6778,0,67197776,0,0.00,615470.38,2,67208334,10558,67197776,0,0.00,90.80,615470.38,0,20.10,19.10,1.56
6779,0,67197776,0,0.00,615470.38,2,67213859,16083,67197776,0,0.00,90.79,615470.38,1,20.10,19.10,1.57
6780,0,67208572,10796,98.92,615569.25,2,67219257,10685,67208572,10796,98.88,90.79,615569.25,0,18.30,19.10,1.55
6781,0,67230351,21779,199.45,615768.75,2,67230351,0,67230351,21779,199.48,90.81,615768.75,1,18.40,19.10,1.56
6782,0,67230351,0,0.00,615768.75,2,67241090,10739,67230351,0,0.00,90.79,615768.75,1,21.73,19.00,1.55
6783,0,67230351,0,0.00,615768.75,2,67247213,16862,67230351,0,0.00,90.78,615768.75,0,21.97,19.00,1.53
6784,0,67230351,0,0.00,615768.75,2,67251903,21552,67230351,0,0.00,90.77,615768.75,1,22.64,19.00,1.54
6785,0,67230351,0,0.00,615768.75,2,67255955,25604,67230351,0,0.00,90.75,615768.75,0,21.51,19.00,1.53
6786,0,67230351,0,0.00,615768.75,2,67259596,29245,67230351,0,0.00,90.74,615768.75,1,21.51,19.00,1.55
6787,0,67230351,0,0.00,615768.75,2,67262897,32546,67230351,0,0.00,90.73,615768.75,0,19.90,18.90,1.53
6788,0,67230351,0,0.00,615768.75,2,67265744,35393,67230351,0,0.00,90.71,615768.75,0,19.90,18.90,1.54
6789,0,67230351,0,0.00,615768.75,2,67268394,38043,67230351,0,0.00,90.70,615768.75,1,19.90,18.90,1.56
6790,0,67235657,5306,48.58,615817.31,2,67271047,35390,67235657,5306,48.60,90.69,615817.31,1,17.99,18.90,1.53
6791,0,67241091,5434,49.75,615867.06,2,67273764,32673,67241091,5434,49.77,90.69,615867.06,0,16.62,18.90,1.52
6792,0,67246443,5352,49.02,615916.06,2,67276440,29997,67246443,5352,49.02,90.68,615916.06,1,16.67,18.90,1.53
6793,0,67251729,5286,48.43,615964.50,2,67279083,27354,67251729,5286,48.41,90.68,615964.50,0,15.31,18.90,1.52
6794,0,67256895,5166,47.33,616011.81,2,67281666,24771,67256895,5166,47.32,90.67,616011.81,1,15.36,18.90,1.53
6795,0,67262003,5108,46.75,616058.56,2,67284220,22217,67262003,5108,46.78,90.66,616058.56,0,14.05,18.90,1.52
6796,0,67266977,4974,45.58,616104.19,2,67286707,19730,67266977,4974,45.56,90.66,616104.19,1,14.10,18.90,1.53
6797,0,67271903,4926,45.14,616149.31,2,67289170,17267,67271903,4926,45.12,90.65,616149.31,0,12.36,18.90,1.51
6798,0,67277519,5616,51.44,616200.75,2,67291978,14459,67277519,5616,51.44,90.64,616200.75,0,12.98,18.90,1.53
6799,0,67285665,8146,74.59,616275.31,2,67296051,10386,67285665,8146,74.61,90.64,616275.31,1,13.90,18.90,1.54
6800,0,67304357,18692,171.24,616446.56,2,67305397,1040,67304357,18692,171.20,90.65,616446.56,0,12.98,18.90,1.53
6801,0,67337200,32843,300.78,616747.38,2,67337200,0,67337200,32843,300.81,90.68,616747.38,1,14.68,18.90,1.54
6802,0,67370440,33240,304.45,617051.81,2,67370440,0,67370440,33240,304.45,90.72,617051.81,0,13.93,18.90,1.53
6803,0,67402804,32364,296.39,617348.19,2,67402804,0,67402804,32364,296.42,90.75,617348.19,1,17.97,18.90,1.54
6804,0,67435191,32387,296.68,617644.88,2,67435191,0,67435191,32387,296.64,90.78,617644.88,1,18.85,18.90,1.53
6805,0,67435191,0,0.00,617644.88,2,67446209,11018,67435191,0,0.00,90.76,617644.88,0,20.03,19.03,1.52
6806,0,67435191,0,0.00,617644.88,2,67452270,17079,67435191,0,0.00,90.75,617644.88,1,20.31,19.31,1.53
6807,0,67435191,0,0.00,617644.88,2,67456797,21606,67435191,0,0.00,90.74,617644.88,0,20.50,19.50,1.52
6808,0,67435191,0,0.00,617644.88,2,67460654,25463,67435191,0,0.00,90.72,617644.88,1,20.50,19.50,1.53
6809,0,67442655,7464,68.36,617713.25,2,67464386,21731,67442655,7464,68.36,90.72,617713.25,0,19.43,19.50,1.52
6810,0,67442655,0,0.00,617713.25,2,67467815,25160,67442655,0,0.00,90.71,617713.25,1,20.64,19.64,1.53
6811,0,67442655,0,0.00,617713.25,2,67470856,28201,67442655,0,0.00,90.69,617713.25,0,19.94,18.94,1.52
6812,0,67442655,0,0.00,617713.25,2,67473650,30995,67442655,0,0.00,90.68,617713.25,1,20.01,19.01,1.53
6813,0,67447957,5302,48.58,617761.81,2,67476301,28344,67447957,5302,48.56,90.67,617761.81,0,18.63,19.01,1.52
6814,0,67453183,5226,47.85,617809.69,2,67478914,25731,67453183,5226,47.87,90.67,617809.69,1,18.68,19.01,1.53
6815,0,67458287,5104,46.75,617856.38,2,67481466,23179,67458287,5104,46.75,90.66,617856.38,0,17.40,19.01,1.52
6816,0,67463435,5148,47.11,617903.50,2,67484040,20605,67463435,5148,47.15,90.65,617903.50,1,17.44,19.01,1.54
6817,0,67468781,5346,49.02,617952.56,2,67486713,17932,67468781,5346,48.96,90.65,617952.56,0,15.51,19.01,1.51
6818,0,67474203,5422,49.61,618002.12,2,67489424,15221,67474203,5422,49.66,90.64,618002.12,0,15.56,19.01,1.52
6819,0,67481031,6828,62.57,618064.75,2,67492838,11807,67481031,6828,62.54,90.64,618064.75,1,15.61,19.01,1.54
6820,0,67498107,17076,156.36,618221.06,2,67501376,3269,67498107,17076,156.40,90.65,618221.06,0,15.49,19.01,1.53
6821,0,67531313,33206,304.15,618525.25,2,67531313,0,67531313,33206,304.14,90.68,618525.25,1,16.01,19.01,1.55
6822,0,67564021,32708,299.61,618824.88,2,67564021,0,67564021,32708,299.58,90.71,618824.88,0,15.36,19.01,1.53
6823,0,67597057,33036,302.54,619127.38,2,67597057,0,67597057,33036,302.58,90.74,619127.38,1,15.66,19.01,1.54
6824,0,67630119,33062,302.84,619430.25,2,67630119,0,67630119,33062,302.82,90.77,619430.25,1,14.17,19.01,1.52
6825,0,67663088,32969,301.96,619732.19,2,67663088,0,67663088,32969,301.97,90.80,619732.19,0,15.94,19.01,1.52
6826,0,67695910,32822,300.64,620032.81,2,67695910,0,67695910,32822,300.62,90.83,620032.81,1,17.27,19.01,1.53
6827,0,67728740,32830,300.64,620333.44,2,67728740,0,67728740,32830,300.69,90.86,620333.44,0,18.44,19.01,1.52
6828,0,67728740,0,0.00,620333.44,2,67739362,10622,67728740,0,0.00,90.85,620333.44,1,20.80,19.80,1.53
6829,0,67728740,0,0.00,620333.44,2,67745130,16390,67728740,0,0.00,90.84,620333.44,0,21.80,19.00,1.52
6830,0,67728740,0,0.00,620333.44,2,67749482,20742,67728740,0,0.00,90.82,620333.44,1,21.80,19.00,1.53
6831,0,67728740,0,0.00,620333.44,2,67753405,24665,67728740,0,0.00,90.81,620333.44,0,20.79,19.79,1.52
6832,0,67728740,0,0.00,620333.44,2,67756910,28170,67728740,0,0.00,90.80,620333.44,1,22.30,19.00,1.54
6833,0,67728740,0,0.00,620333.44,2,67760081,31341,67728740,0,0.00,90.78,620333.44,0,21.21,19.00,1.52
6834,0,67728740,0,0.00,620333.44,2,67762989,34249,67728740,0,0.00,90.77,620333.44,1,21.30,19.00,1.54
6835,0,67728740,0,0.00,620333.44,2,67765708,36968,67728740,0,0.00,90.76,620333.44,0,19.58,18.58,1.52
6836,0,67728740,0,0.00,620333.44,2,67768291,39551,67728740,0,0.00,90.75,620333.44,1,19.79,18.79,1.53
6837,0,67728740,0,0.00,620333.44,2,67770749,42009,67728740,0,0.00,90.73,620333.44,0,19.66,18.66,1.52
6838,0,67728740,0,0.00,620333.44,2,67773104,44364,67728740,0,0.00,90.72,620333.44,0,20.11,19.11,1.53
6839,0,67728740,0,0.00,620333.44,2,67775365,46625,67728740,0,0.00,90.71,620333.44,1,20.11,19.11,1.55
6840,0,67732828,4088,37.52,620371.00,2,67777409,44581,67732828,4088,37.44,90.70,620371.00,0,18.08,19.11,1.52
6841,0,67737014,4186,38.32,620409.31,2,67779502,42488,67737014,4186,38.34,90.69,620409.31,1,18.20,19.11,1.53
6842,0,67741480,4466,40.89,620450.19,2,67781735,40255,67741480,4466,40.90,90.68,620450.19,0,17.11,19.11,1.52
6843,0,67745824,4344,39.79,620490.00,2,67783907,38083,67745824,4344,39.79,90.68,620490.00,1,17.18,19.11,1.54
6844,0,67750214,4390,40.23,620530.19,2,67786102,35888,67750214,4390,40.21,90.67,620530.19,0,15.51,19.11,1.52
6845,0,67754552,4338,39.71,620569.94,2,67788271,33719,67754552,4338,39.73,90.66,620569.94,1,15.55,19.11,1.53
6846,0,67758852,4300,39.35,620609.25,2,67790421,31569,67758852,4300,39.38,90.65,620609.25,1,14.59,19.11,1.53
6847,0,67763150,4298,39.42,620648.69,2,67792570,29420,67763150,4298,39.37,90.65,620648.69,0,13.40,19.11,1.51
6848,0,67767414,4264,39.05,620687.75,2,67794702,27288,67767414,4264,39.05,90.64,620687.75,1,13.43,19.11,1.53
6849,0,67771642,4228,38.69,620726.44,2,67796816,25174,67771642,4228,38.72,90.63,620726.44,0,12.12,19.11,1.52
6850,0,67775834,4192,38.39,620764.81,2,67798912,23078,67775834,4192,38.39,90.62,620764.81,1,12.23,19.11,1.53
6851,0,67780196,4362,39.93,620804.75,2,67801093,20897,67780196,4362,39.95,90.62,620804.75,0,11.16,19.11,1.52
6852,0,67784834,4638,42.50,620847.25,2,67803412,18578,67784834,4638,42.48,90.61,620847.25,1,11.40,19.11,1.53
6853,0,67789862,5028,46.09,620893.31,2,67805926,16064,67789862,5028,46.05,90.60,620893.31,0,10.20,19.11,1.52
6854,0,67795920,6058,55.47,620948.81,2,67808955,13035,67795920,6058,55.49,90.60,620948.81,1,10.25,19.11,1.54
6855,0,67809238,13318,122.00,621070.81,2,67815614,6376,67809238,13318,121.98,90.60,621070.81,0,9.13,19.11,1.53
6856,0,67839669,30431,278.73,621349.56,2,67839669,0,67839669,30431,278.72,90.63,621349.56,1,9.90,19.11,1.54
6857,0,67872865,33196,304.01,621653.56,2,67872865,0,67872865,33196,304.05,90.66,621653.56,0,10.37,19.11,1.53
6858,0,67906200,33335,305.33,621958.88,2,67906200,0,67906200,33335,305.32,90.69,621958.88,0,11.43,19.11,1.54
6859,0,67939533,33333,305.33,622264.19,2,67939533,0,67939533,33333,305.30,90.72,622264.19,1,12.92,19.11,1.56
6860,0,67973526,33993,311.34,622575.56,2,67973526,0,67973526,33993,311.34,90.75,622575.56,0,11.57,19.11,1.54
6861,0,68007070,33544,307.23,622882.75,2,68007070,0,68007070,33544,307.23,90.79,622882.75,1,13.07,19.11,1.55
6862,0,68040912,33842,309.94,623192.69,2,68040912,0,68040912,33842,309.96,90.82,623192.69,0,12.21,19.11,1.54
6863,0,68040912,0,0.00,623192.69,2,68051536,10624,68040912,0,0.00,90.80,623192.69,1,20.26,19.26,1.56
6864,0,68040912,0,0.00,623192.69,2,68057577,16665,68040912,0,0.00,90.79,623192.69,1,21.15,19.00,1.54
6865,0,68040912,0,0.00,623192.69,2,68062073,21161,68040912,0,0.00,90.78,623192.69,0,21.73,19.00,1.53
6866,0,68040912,0,0.00,623192.69,2,68065860,24948,68040912,0,0.00,90.77,623192.69,1,21.97,19.00,1.55
6867,0,68040912,0,0.00,623192.69,2,68069266,28354,68040912,0,0.00,90.75,623192.69,0,20.61,19.61,1.54
6868,0,68040912,0,0.00,623192.69,2,68072423,31511,68040912,0,0.00,90.74,623192.69,1,20.61,19.61,1.55
6869,0,68046986,6074,55.61,623248.31,2,68075460,28474,68046986,6074,55.63,90.73,623248.31,0,19.23,19.61,1.54
6870,0,68052890,5904,54.08,623302.38,2,68078412,25522,68052890,5904,54.08,90.73,623302.38,1,19.53,19.61,1.55
6871,0,68058686,5796,53.12,623355.50,2,68081310,22624,68058686,5796,53.09,90.72,623355.50,0,18.18,19.61,1.53
6872,0,68064392,5706,52.24,623407.75,2,68084163,19771,68064392,5706,52.26,90.72,623407.75,1,18.23,19.61,1.54
6873,0,68070034,5642,51.66,623459.44,2,68086984,16950,68070034,5642,51.68,90.71,623459.44,0,17.02,19.61,1.53
6874,0,68075798,5764,52.83,623512.25,2,68089866,14068,68075798,5764,52.79,90.71,623512.25,1,17.07,19.61,1.55
6875,0,68083330,7532,68.95,623581.19,2,68093632,10302,68083330,7532,68.99,90.70,623581.19,0,15.49,19.61,1.53
6876,0,68102412,19082,174.83,623756.00,2,68103173,761,68102412,19082,174.77,90.71,623756.00,1,15.56,19.61,1.54
6877,0,68135355,32943,301.66,624057.69,2,68135355,0,68135355,32943,301.73,90.75,624057.69,0,14.49,19.61,1.53
6878,0,68168230,32875,301.15,624358.88,2,68168230,0,68168230,32875,301.11,90.78,624358.88,0,16.13,19.61,1.55
6879,0,68201326,33096,303.13,624662.00,2,68201326,0,68201326,33096,303.13,90.81,624662.00,1,18.40,19.61,1.56
6880,0,68234255,32929,301.59,624963.56,2,68234255,0,68234255,32929,301.60,90.84,624963.56,0,17.31,19.61,1.53
6881,0,68266841,32586,298.44,625262.00,2,68266841,0,68266841,32586,298.46,90.87,625262.00,1,17.61,19.61,1.55
6882,0,68299112,32271,295.58,625557.56,2,68299112,0,68299112,32271,295.57,90.90,625557.56,0,19.09,19.61,1.54
6883,0,68299112,0,0.00,625557.56,2,68309770,10658,68299112,0,0.00,90.88,625557.56,1,21.75,19.00,1.55
6884,0,68299112,0,0.00,625557.56,2,68315487,16375,68299112,0,0.00,90.87,625557.56,1,21.78,19.00,1.54
6885,0,68299112,0,0.00,625557.56,2,68319900,20788,68299112,0,0.00,90.86,625557.56,0,20.77,19.77,1.53
6886,0,68299112,0,0.00,625557.56,2,68323702,24590,68299112,0,0.00,90.84,625557.56,1,20.77,19.77,1.54
6887,0,68306334,7222,66.17,625623.75,2,68327313,20979,68306334,7222,66.15,90.84,625623.75,0,19.59,19.77,1.53
6888,0,68306334,0,0.00,625623.75,2,68330673,24339,68306334,0,0.00,90.83,625623.75,1,19.93,18.93,1.54
6889,0,68312760,6426,58.84,625682.56,2,68333886,21126,68312760,6426,58.86,90.82,625682.56,0,18.86,18.93,1.53
6890,0,68319060,6300,57.67,625740.25,2,68337036,17976,68319060,6300,57.70,90.82,625740.25,1,18.92,18.93,1.55
6891,0,68325378,6318,57.89,625798.12,2,68340195,14817,68325378,6318,57.87,90.81,625798.12,0,17.80,18.93,1.53
6892,0,68332294,6916,63.38,625861.50,2,68343653,11359,68332294,6916,63.34,90.81,625861.50,1,18.08,18.93,1.55
6893,0,68349318,17024,155.92,626017.44,2,68352165,2847,68349318,17024,155.92,90.82,626017.44,0,18.12,18.93,1.54
6894,0,68349318,0,0.00,626017.44,2,68360803,11485,68349318,0,0.00,90.81,626017.44,1,23.10,19.00,1.55
6895,0,68349318,0,0.00,626017.44,2,68366094,16776,68349318,0,0.00,90.79,626017.44,0,23.36,19.00,1.54
6896,0,68349318,0,0.00,626017.44,2,68369358,20040,68349318,0,0.00,90.78,626017.44,1,24.02,19.00,1.56
6897,0,68349318,0,0.00,626017.44,2,68371801,22483,68349318,0,0.00,90.77,626017.44,0,22.77,19.00,1.54
6898,0,68349318,0,0.00,626017.44,2,68373879,24561,68349318,0,0.00,90.75,626017.44,0,22.77,19.00,1.56
6899,0,68349318,0,0.00,626017.44,2,68375785,26467,68349318,0,0.00,90.74,626017.44,1,22.77,19.00,1.57
6900,0,68349318,0,0.00,626017.44,2,68377609,28291,68349318,0,0.00,90.73,626017.44,0,21.17,19.00,1.55
6901,0,68349318,0,0.00,626017.44,2,68379372,30054,68349318,0,0.00,90.71,626017.44,1,21.17,19.00,1.57
6902,0,68349318,0,0.00,626017.44,2,68381077,31759,68349318,0,0.00,90.70,626017.44,1,20.06,19.06,1.56
6903,0,68352754,3436,31.43,626048.88,2,68382795,30041,68352754,3436,31.47,90.69,626048.88,0,18.68,19.06,1.55
6904,0,68356260,3506,32.09,626081.00,2,68384548,28288,68356260,3506,32.11,90.68,626081.00,1,18.71,19.06,1.56
6905,0,68359942,3682,33.78,626114.75,2,68386389,26447,68359942,3682,33.72,90.68,626114.75,0,17.64,19.06,1.55
6906,0,68363846,3904,35.76,626150.50,2,68388341,24495,68363846,3904,35.76,90.67,626150.50,1,17.67,19.06,1.57
6907,0,68368062,4216,38.61,626189.12,2,68390449,22387,68368062,4216,38.61,90.66,626189.12,0,16.34,19.06,1.55
6908,0,68372850,4788,43.82,626232.94,2,68392843,19993,68372850,4788,43.85,90.65,626232.94,1,16.38,19.06,1.57
6909,0,68378292,5442,49.83,626282.75,2,68395564,17272,68378292,5442,49.84,90.65,626282.75,0,14.81,19.06,1.55
6910,0,68384528,6236,57.15,626339.94,2,68398682,14154,68384528,6236,57.12,90.64,626339.94,1,14.97,19.06,1.56
6911,0,68394348,9820,89.98,626429.88,2,68403592,9244,68394348,9820,89.94,90.64,626429.88,0,14.12,19.06,1.55
6912,0,68415055,20707,189.63,626619.50,2,68415055,0,68415055,20707,189.66,90.66,626619.50,1,14.93,19.06,1.57
6913,0,68444937,29882,273.67,626893.19,2,68444937,0,68444937,29882,273.69,90.68,626893.19,0,14.46,19.06,1.55
6914,0,68475148,30211,276.75,627169.94,2,68475148,0,68475148,30211,276.71,90.71,627169.94,1,15.61,19.06,1.56
6915,0,68505377,30229,276.82,627446.75,2,68505377,0,68505377,30229,276.87,90.74,627446.75,0,14.99,19.06,1.54
6916,0,68536388,31011,284.01,627730.81,2,68536388,0,68536388,31011,284.03,90.77,627730.81,1,15.26,19.06,1.56
6917,0,68567422,31034,284.30,628015.06,2,68567422,0,68567422,31034,284.24,90.79,628015.06,0,14.16,19.06,1.54
6918,0,68597606,30184,276.46,628291.56,2,68597606,0,68597606,30184,276.46,90.82,628291.56,0,15.55,19.06,1.56
6919,0,68597606,0,0.00,628291.56,2,68608719,11113,68597606,0,0.00,90.81,628291.56,1,24.20,19.00,1.57
6920,0,68597606,0,0.00,628291.56,2,68614353,16747,68597606,0,0.00,90.79,628291.56,1,23.02,19.00,1.55
6921,0,68597606,0,0.00,628291.56,2,68618994,21388,68597606,0,0.00,90.78,628291.56,0,23.48,19.00,1.53
6922,0,68597606,0,0.00,628291.56,2,68623100,25494,68597606,0,0.00,90.77,628291.56,1,23.48,19.00,1.55
6923,0,68597606,0,0.00,628291.56,2,68626724,29118,68597606,0,0.00,90.75,628291.56,0,22.15,19.00,1.54
6924,0,68597606,0,0.00,628291.56,2,68630045,32439,68597606,0,0.00,90.74,628291.56,1,22.31,19.00,1.55
6925,0,68597606,0,0.00,628291.56,2,68633091,35485,68597606,0,0.00,90.73,628291.56,0,20.96,19.96,1.54
6926,0,68597606,0,0.00,628291.56,2,68635934,38328,68597606,0,0.00,90.71,628291.56,1,20.96,19.96,1.55
6927,0,68603056,5450,49.90,628341.44,2,68638659,35603,68603056,5450,49.92,90.71,628341.44,0,19.50,19.96,1.53
6928,0,68608030,4974,45.58,628387.00,2,68641146,33116,68608030,4974,45.56,90.70,628387.00,1,19.58,19.96,1.55
6929,0,68612962,4932,45.14,628432.12,2,68643612,30650,68612962,4932,45.17,90.70,628432.12,0,18.29,19.96,1.53
6930,0,68618004,5042,46.16,628478.31,2,68646133,28129,68618004,5042,46.18,90.69,628478.31,1,18.40,19.96,1.55
6931,0,68623138,5134,47.04,628525.38,2,68648700,25562,68623138,5134,47.02,90.68,628525.38,0,17.10,19.96,1.54
6932,0,68628100,4962,45.43,628570.75,2,68651181,23081,68628100,4962,45.45,90.68,628570.75,1,17.15,19.96,1.55
6933,0,68633116,5016,46.02,628616.81,2,68653689,20573,68633116,5016,45.94,90.67,628616.81,0,15.85,19.96,1.54
6934,0,68638018,4902,44.84,628661.62,2,68656140,18122,68638018,4902,44.90,90.66,628661.62,1,16.13,19.96,1.55
6935,0,68643420,5402,49.53,628711.19,2,68658841,15421,68643420,5402,49.48,90.66,628711.19,0,15.69,19.96,1.54
6936,0,68649918,6498,59.50,628770.69,2,68662090,12172,68649918,6498,59.52,90.65,628770.69,1,16.18,19.96,1.55
6937,0,68664490,14572,133.43,628904.12,2,68669376,4886,68664490,14572,133.47,90.66,628904.12,0,14.86,19.96,1.54
6938,0,68691156,26666,244.22,629148.31,2,68691156,0,68691156,26666,244.24,90.68,629148.31,1,14.99,19.96,1.55
6939,0,68721388,30232,276.97,629425.31,2,68721388,0,68721388,30232,276.90,90.71,629425.31,0,14.04,19.96,1.54
6940,0,68749359,27971,256.16,629681.44,2,68749359,0,68749359,27971,256.19,90.73,629681.44,1,14.59,19.96,1.56
6941,0,68776707,27348,250.45,629931.88,2,68776707,0,68776707,27348,250.48,90.76,629931.88,0,15.42,19.96,1.55
6942,0,68804120,27413,251.11,630183.00,2,68804120,0,68804120,27413,251.08,90.78,630183.00,1,17.67,19.96,1.56
6943,0,68831138,27018,247.44,630430.44,2,68831138,0,68831138,27018,247.46,90.80,630430.44,0,18.49,19.96,1.55
6944,0,68831138,0,0.00,630430.44,2,68840530,9392,68831138,0,0.00,90.79,630430.44,1,20.73,19.73,1.56
6945,0,68831138,0,0.00,630430.44,2,68846155,15017,68831138,0,0.00,90.77,630430.44,0,20.00,19.00,1.56
6946,0,68831138,0,0.00,630430.44,2,68850416,19278,68831138,0,0.00,90.76,630430.44,1,21.71,19.00,1.57
6947,0,68831138,0,0.00,630430.44,2,68854070,22932,68831138,0,0.00,90.75,630430.44,0,20.57,19.57,1.56
6948,0,68831138,0,0.00,630430.44,2,68857369,26231,68831138,0,0.00,90.74,630430.44,1,20.57,19.57,1.58
6949,0,68837442,6304,57.74,630488.19,2,68860521,23079,68837442,6304,57.74,90.73,630488.19,1,19.37,19.57,1.56
6950,0,68843704,6262,57.37,630545.56,2,68863652,19948,68843704,6262,57.35,90.73,630545.56,0,19.33,19.57,1.55
6951,0,68843704,0,0.00,630545.56,2,68866463,22759,68843704,0,0.00,90.71,630545.56,0,19.99,18.99,1.56
6952,0,68843704,0,0.00,630545.56,2,68869001,25297,68843704,0,0.00,90.70,630545.56,1,19.99,18.99,1.58
6953,0,68849152,5448,49.90,630595.44,2,68871725,22573,68849152,5448,49.90,90.69,630595.44,0,18.41,18.99,1.56
6954,0,68854606,5454,49.97,630645.44,2,68874452,19846,68854606,5454,49.95,90.69,630645.44,1,18.46,18.99,1.57
6955,0,68860002,5396,49.39,630694.81,2,68877150,17148,68860002,5396,49.42,90.68,630694.81,0,17.36,18.99,1.56
6956,0,68865852,5850,53.64,630748.44,2,68880075,14223,68865852,5850,53.58,90.68,630748.44,1,18.84,18.99,1.57
6957,0,68873796,7944,72.69,630821.12,2,68884047,10251,68873796,7944,72.76,90.67,630821.12,0,17.64,18.99,1.56
6958,0,68891940,18144,166.18,630987.31,2,68893119,1179,68891940,18144,166.18,90.69,630987.31,1,17.72,18.99,1.57
6959,0,68925181,33241,304.52,631291.81,2,68925181,0,68925181,33241,304.46,90.72,631291.81,0,18.02,18.99,1.55
6960,0,68957701,32520,297.85,631589.69,2,68957701,0,68957701,32520,297.85,90.75,631589.69,1,18.98,18.99,1.57
6961,0,68990502,32801,300.42,631890.12,2,68990502,0,68990502,32801,300.43,90.78,631890.12,0,18.12,18.99,1.55
6962,0,69023068,32566,298.29,632188.38,2,69023068,0,69023068,32566,298.27,90.81,632188.38,1,18.92,18.99,1.56
6963,0,69023068,0,0.00,632188.38,2,69033548,10480,69023068,0,0.00,90.79,632188.38,0,19.75,18.75,1.55
6964,0,69023068,0,0.00,632188.38,2,69039604,16536,69023068,0,0.00,90.78,632188.38,1,20.54,19.54,1.56
6965,0,69033694,10626,97.31,632285.69,2,69044917,11223,69033694,10626,97.32,90.78,632285.69,0,18.57,19.54,1.54
6966,0,69052544,18850,172.63,632458.31,2,69054342,1798,69052544,18850,172.65,90.79,632458.31,1,18.98,19.54,1.55
6967,0,69084566,32022,293.31,632751.62,2,69084566,0,69084566,32022,293.29,90.82,632751.62,0,18.24,19.54,1.54
6968,0,69084566,0,0.00,632751.62,2,69094964,10398,69084566,0,0.00,90.81,632751.62,1,20.04,19.04,1.55
6969,0,69105949,21383,195.86,632947.50,2,69105949,0,69105949,21383,195.85,90.82,632947.50,0,18.48,19.04,1.52
6970,0,69138240,32291,295.73,633243.25,2,69138240,0,69138240,32291,295.76,90.85,633243.25,1,18.67,19.04,1.53
6971,0,69138240,0,0.00,633243.25,2,69149073,10833,69138240,0,0.00,90.84,633243.25,0,23.78,19.00,1.52
6972,0,69138240,0,0.00,633243.25,2,69154729,16489,69138240,0,0.00,90.83,633243.25,1,24.34,19.00,1.53
6973,0,69138240,0,0.00,633243.25,2,69159085,20845,69138240,0,0.00,90.81,633243.25,0,22.46,19.00,1.51
6974,0,69138240,0,0.00,633243.25,2,69163037,24797,69138240,0,0.00,90.80,633243.25,0,22.46,19.00,1.52
6975,0,69138240,0,0.00,633243.25,2,69166568,28328,69138240,0,0.00,90.79,633243.25,1,22.46,19.00,1.54
6976,0,69138240,0,0.00,633243.25,2,69169803,31563,69138240,0,0.00,90.77,633243.25,0,20.76,19.76,1.52
6977,0,69138240,0,0.00,633243.25,2,69172796,34556,69138240,0,0.00,90.76,633243.25,1,20.76,19.76,1.53
6978,0,69144002,5762,52.76,633296.00,2,69175677,31675,69144002,5762,52.77,90.76,633296.00,0,19.14,19.76,1.51
6979,0,69149692,5690,52.17,633348.19,2,69178522,28830,69149692,5690,52.12,90.75,633348.19,0,19.19,19.76,1.53
6980,0,69149692,0,0.00,633348.19,2,69181228,31536,69149692,0,0.00,90.74,633348.19,1,20.10,19.10,1.54
6981,0,69149692,0,0.00,633348.19,2,69183683,33991,69149692,0,0.00,90.72,633348.19,1,19.67,18.67,1.53
6982,0,69154040,4348,39.79,633387.94,2,69185857,31817,69154040,4348,39.82,90.72,633387.94,0,18.53,18.67,1.52
6983,0,69158378,4338,39.71,633427.69,2,69188026,29648,69158378,4338,39.73,90.71,633427.69,1,18.57,18.67,1.53
6984,0,69162986,4608,42.21,633469.88,2,69190330,27344,69162986,4608,42.21,90.70,633469.88,1,16.80,18.67,1.51
6985,0,69167550,4564,41.84,633511.69,2,69192612,25062,69167550,4564,41.80,90.70,633511.69,0,16.31,18.67,1.51
6986,0,69172110,4560,41.77,633553.50,2,69194892,22782,69172110,4560,41.77,90.69,633553.50,1,16.35,18.67,1.53
6987,0,69176700,4590,42.06,633595.50,2,69197187,20487,69176700,4590,42.04,90.68,633595.50,1,14.82,18.67,1.51
6988,0,69181410,4710,43.08,633638.62,2,69199542,18132,69181410,4710,43.14,90.68,633638.62,0,13.82,18.67,1.50
6989,0,69186678,5268,48.29,633686.88,2,69202176,15498,69186678,5268,48.25,90.67,633686.88,1,14.15,18.67,1.51
6990,0,69193804,7126,65.29,633752.19,2,69205739,11935,69193804,7126,65.27,90.67,633752.19,0,13.94,18.67,1.50
6991,0,69209838,16034,146.84,633899.00,2,69213756,3918,69209838,16034,146.86,90.67,633899.00,1,14.29,18.67,1.51
6992,0,69239966,30128,275.95,634175.00,2,69239966,0,69239966,30128,275.95,90.70,634175.00,0,13.11,18.67,1.49
6993,0,69272152,32186,294.78,634469.75,2,69272152,0,69272152,32186,294.79,90.73,634469.75,0,15.10,18.67,1.51
6994,0,69303930,31778,291.04,634760.81,2,69303930,0,69303930,31778,291.06,90.76,634760.81,1,17.40,18.67,1.52
6995,0,69335944,32014,293.24,635054.00,2,69335944,0,69335944,32014,293.22,90.79,635054.00,0,17.83,18.67,1.50
6996,0,69335944,0,0.00,635054.00,2,69346594,10650,69335944,0,0.00,90.77,635054.00,1,20.12,19.12,1.51
6997,0,69356026,20082,183.91,635237.94,2,69356635,609,69356026,20082,183.93,90.79,635237.94,0,17.55,19.12,1.48
6998,0,69356026,0,0.00,635237.94,2,69366796,10770,69356026,0,0.00,90.77,635237.94,0,19.16,18.16,1.49
6999,0,69356026,0,0.00,635237.94,2,69372090,16064,69356026,0,0.00,90.76,635237.94,1,19.74,18.74,1.50
7000,0,69356026,0,0.00,635237.94,2,69375467,19441,69356026,0,0.00,90.75,635237.94,0,19.55,18.55,1.49
7001,0,69356026,0,0.00,635237.94,2,69378247,22221,69356026,0,0.00,90.74,635237.94,1,20.12,19.12,1.50
7002,0,69361938,5912,54.15,635292.06,2,69381203,19265,69361938,5912,54.15,90.73,635292.06,0,18.16,19.12,1.47
7003,0,69368836,6898,63.16,635355.25,2,69384652,15816,69368836,6898,63.18,90.73,635355.25,1,18.21,19.12,1.49
7004,0,69377148,8312,76.20,635431.44,2,69388808,11660,69377148,8312,76.13,90.72,635431.44,0,15.95,19.12,1.46
7005,0,69393618,16470,150.80,635582.25,2,69397043,3425,69393618,16470,150.85,90.73,635582.25,1,16.99,19.12,1.47
7006,0,69423808,30190,276.53,635858.75,2,69423808,0,69423808,30190,276.51,90.76,635858.75,0,16.33,19.12,1.46
7007,0,69454545,30737,281.51,636140.31,2,69454545,0,69454545,30737,281.52,90.79,636140.31,1,18.13,19.12,1.47
7008,0,69485693,31148,285.32,636425.62,2,69485693,0,69485693,31148,285.29,90.81,636425.62,0,17.74,19.12,1.45
7009,0,69517466,31773,290.97,636716.56,2,69517466,0,69517466,31773,291.01,90.84,636716.56,1,18.73,19.12,1.47
7010,0,69549445,31979,292.94,637009.50,2,69549445,0,69549445,31979,292.90,90.87,637009.50,0,17.73,19.12,1.45
7011,0,69549445,0,0.00,637009.50,2,69559797,10352,69549445,0,0.00,90.86,637009.50,1,19.39,18.39,1.46
7012,0,69549445,0,0.00,637009.50,2,69565542,16097,69549445,0,0.00,90.85,637009.50,1,19.19,18.19,1.45
7013,0,69559297,9852,90.20,637099.75,2,69570468,11171,69559297,9852,90.24,90.85,637099.75,0,18.01,18.19,1.43
7014,0,69559297,0,0.00,637099.75,2,69575025,15728,69559297,0,0.00,90.83,637099.75,1,18.30,17.30,1.45
7015,0,69568637,9340,85.58,637185.31,2,69579695,11058,69568637,9340,85.55,90.83,637185.31,0,16.80,17.30,1.43
7016,0,69588233,19596,179.44,637364.75,2,69589493,1260,69588233,19596,179.48,90.84,637364.75,1,17.19,17.30,1.44
7017,0,69620125,31892,292.14,637656.88,2,69620125,0,69620125,31892,292.10,90.87,637656.88,0,16.31,17.30,1.43
7018,0,69651600,31475,288.25,637945.12,2,69651600,0,69651600,31475,288.28,90.90,637945.12,0,17.12,17.30,1.44
7019,0,69651600,0,0.00,637945.12,2,69662197,10597,69651600,0,0.00,90.89,637945.12,1,20.15,19.15,1.46
7020,0,69670552,18952,173.58,638118.75,2,69671673,1121,69670552,18952,173.58,90.90,638118.75,1,18.63,19.15,1.44
7021,0,69702781,32229,295.22,638413.94,2,69702781,0,69702781,32229,295.19,90.93,638413.94,0,18.51,19.15,1.43
7022,0,69702781,0,0.00,638413.94,2,69713188,10407,69702781,0,0.00,90.92,638413.94,1,22.63,19.00,1.44
7023,0,69702781,0,0.00,638413.94,2,69719139,16358,69702781,0,0.00,90.90,638413.94,0,22.54,19.00,1.43
7024,0,69702781,0,0.00,638413.94,2,69723808,21027,69702781,0,0.00,90.89,638413.94,1,22.56,19.00,1.44
7025,0,69702781,0,0.00,638413.94,2,69727830,25049,69702781,0,0.00,90.88,638413.94,1,20.95,19.95,1.42
7026,0,69702781,0,0.00,638413.94,2,69731046,28265,69702781,0,0.00,90.86,638413.94,0,20.15,19.15,1.41
7027,0,69702781,0,0.00,638413.94,2,69734153,31372,69702781,0,0.00,90.85,638413.94,0,20.33,19.33,1.42
7028,0,69702781,0,0.00,638413.94,2,69737218,34437,69702781,0,0.00,90.84,638413.94,1,20.64,19.64,1.44
7029,0,69708663,5882,53.86,638467.81,2,69740159,31496,69708663,5882,53.87,90.83,638467.81,0,18.72,19.64,1.41
7030,0,69714429,5766,52.83,638520.62,2,69743042,28613,69714429,5766,52.81,90.83,638520.62,1,18.77,19.64,1.42
7031,0,69719821,5392,49.39,638570.00,2,69745738,25917,69719821,5392,49.39,90.82,638570.00,0,16.80,19.64,1.39
7032,0,69725233,5412,49.53,638619.56,2,69748444,23211,69725233,5412,49.57,90.82,638619.56,1,16.84,19.64,1.41
7033,0,69730741,5508,50.48,638670.00,2,69751198,20457,69730741,5508,50.45,90.81,638670.00,0,15.04,19.64,1.39
7034,0,69736073,5332,48.80,638718.81,2,69753864,17791,69736073,5332,48.84,90.80,638718.81,1,15.08,19.64,1.40
7035,0,69741593,5520,50.56,638769.38,2,69756624,15031,69741593,5520,50.56,90.80,638769.38,0,12.28,19.64,1.36
7036,0,69748371,6778,62.06,638831.44,2,69760013,11642,69748371,6778,62.08,90.79,638831.44,1,12.84,19.64,1.37
7037,0,69762161,13790,126.32,638957.75,2,69766908,4747,69762161,13790,126.30,90.80,638957.75,0,11.30,19.64,1.35
7038,0,69793109,30948,283.49,639241.25,2,69793109,0,69793109,30948,283.46,90.83,639241.25,0,12.04,19.64,1.37
7039,0,69824186,31077,284.59,639525.88,2,69824186,0,69824186,31077,284.64,90.85,639525.88,0,12.32,19.64,1.38
7040,0,69855375,31189,285.69,639811.56,2,69855375,0,69855375,31189,285.66,90.88,639811.56,1,18.99,19.64,1.40
7041,0,69886836,31461,288.11,640099.62,2,69886836,0,69886836,31461,288.15,90.91,640099.62,0,18.61,19.64,1.37
7042,0,69886836,0,0.00,640099.62,2,69897086,10250,69886836,0,0.00,90.90,640099.62,1,20.48,19.48,1.39
7043,0,69907755,20919,191.61,640291.25,2,69907755,0,69907755,20919,191.60,90.91,640291.25,0,19.26,19.48,1.37
7044,0,69907755,0,0.00,640291.25,2,69918880,11125,69907755,0,0.00,90.90,640291.25,1,19.99,18.99,1.38
7045,0,69925119,17364,159.08,640450.31,2,69927562,2443,69925119,17364,159.04,90.91,640450.31,1,18.39,18.99,1.36
7046,0,69956815,31696,290.31,640740.62,2,69956815,0,69956815,31696,290.31,90.94,640740.62,0,17.74,18.99,1.35
7047,0,69956815,0,0.00,640740.62,2,69966934,10119,69956815,0,0.00,90.92,640740.62,1,22.23,19.00,1.36
7048,0,69956815,0,0.00,640740.62,2,69973243,16428,69956815,0,0.00,90.91,640740.62,0,20.34,19.34,1.34
7049,0,69956815,0,0.00,640740.62,2,69977969,21154,69956815,0,0.00,90.90,640740.62,1,21.06,19.00,1.35
7050,0,69956815,0,0.00,640740.62,2,69981789,24974,69956815,0,0.00,90.89,640740.62,1,20.47,19.47,1.35
7051,0,69956815,0,0.00,640740.62,2,69985151,28336,69956815,0,0.00,90.87,640740.62,0,19.56,18.56,1.33
7052,0,69956815,0,0.00,640740.62,2,69988003,31188,69956815,0,0.00,90.86,640740.62,1,19.86,18.86,1.35
7053,0,69963073,6258,57.30,640797.94,2,69991132,28059,69963073,6258,57.32,90.85,640797.94,0,18.72,18.86,1.34
7054,0,69969351,6278,57.52,640855.44,2,69994271,24920,69969351,6278,57.50,90.85,640855.44,1,18.77,18.86,1.35
7055,0,69975517,6166,56.49,640911.94,2,69997354,21837,69975517,6166,56.47,90.85,640911.94,0,17.50,18.86,1.34
7056,0,69981573,6056,55.47,640967.44,2,70000382,18809,69981573,6056,55.47,90.84,640967.44,1,18.13,18.86,1.35
7057,0,69987529,5956,54.51,641021.94,2,70003360,15831,69987529,5956,54.55,90.83,641021.94,0,16.16,18.86,1.33
7058,0,69993913,6384,58.47,641080.44,2,70006552,12639,69993913,6384,58.47,90.83,641080.44,1,16.21,18.86,1.34
7059,0,70006523,12610,115.48,641195.88,2,70012857,6334,70006523,12610,115.50,90.83,641195.88,0,15.34,18.86,1.34
7060,0,70031753,25230,231.10,641427.00,2,70031753,0,70031753,25230,231.08,90.85,641427.00,1,15.47,18.86,1.35
7061,0,70063599,31846,291.70,641718.69,2,70063599,0,70063599,31846,291.68,90.88,641718.69,0,14.10,18.86,1.33
7062,0,70095039,31440,287.96,642006.62,2,70095039,0,70095039,31440,287.96,90.91,642006.62,1,16.16,18.86,1.35
7063,0,70126098,31059,284.44,642291.12,2,70126098,0,70126098,31059,284.47,90.94,642291.12,1,16.98,18.86,1.34
7064,0,70157447,31349,287.16,642578.25,2,70157447,0,70157447,31349,287.13,90.97,642578.25,0,17.51,18.86,1.33
7065,0,70157447,0,0.00,642578.25,2,70168262,10815,70157447,0,0.00,90.95,642578.25,0,19.90,18.90,1.34
7066,0,70157447,0,0.00,642578.25,2,70174390,16943,70157447,0,0.00,90.94,642578.25,1,21.32,19.00,1.35
7067,0,70157447,0,0.00,642578.25,2,70178722,21275,70157447,0,0.00,90.93,642578.25,0,19.34,18.34,1.33
7068,0,70157447,0,0.00,642578.25,2,70182647,25200,70157447,0,0.00,90.91,642578.25,1,19.62,18.62,1.34
7069,0,70157447,0,0.00,642578.25,2,70186274,28827,70157447,0,0.00,90.90,642578.25,0,19.74,18.74,1.33
7070,0,70157447,0,0.00,642578.25,2,70189575,32128,70157447,0,0.00,90.89,642578.25,1,19.98,18.98,1.34
7071,0,70163739,6292,57.59,642635.81,2,70192721,28982,70163739,6292,57.63,90.88,642635.81,0,17.81,18.98,1.31
7072,0,70169903,6164,56.49,642692.31,2,70195803,25900,70169903,6164,56.46,90.88,642692.31,1,18.01,18.98,1.32
7073,0,70175955,6052,55.39,642747.75,2,70198829,22874,70175955,6052,55.43,90.87,642747.75,0,16.71,18.98,1.31
7074,0,70181859,5904,54.08,642801.81,2,70201781,19922,70181859,5904,54.08,90.87,642801.81,1,16.77,18.98,1.33
7075,0,70187653,5794,53.12,642854.94,2,70204678,17025,70187653,5794,53.07,90.86,642854.94,0,14.85,18.98,1.30
7076,0,70193473,5820,53.27,642908.19,2,70207588,14115,70193473,5820,53.31,90.86,642908.19,1,15.08,18.98,1.31
7077,0,70199893,6420,58.84,642967.06,2,70210798,10905,70199893,6420,58.80,90.85,642967.06,0,15.88,18.98,1.31
7078,0,70217289,17396,159.29,643126.31,2,70219496,2207,70217289,17396,159.33,90.86,643126.31,1,16.30,18.98,1.32
7079,0,70249136,31847,291.70,643418.00,2,70249136,0,70249136,31847,291.69,90.89,643418.00,0,14.88,18.98,1.30
7080,0,70278721,29585,270.96,643689.00,2,70278721,0,70278721,29585,270.97,90.92,643689.00,1,16.87,18.98,1.32
7081,0,70309177,30456,278.95,643967.94,2,70309177,0,70309177,30456,278.95,90.94,643967.94,0,15.94,18.98,1.30
7082,0,70340559,31382,287.45,644255.38,2,70340559,0,70340559,31382,287.43,90.97,644255.38,1,16.21,18.98,1.32
7083,0,70371469,30910,283.13,644538.50,2,70371469,0,70371469,30910,283.11,91.00,644538.50,0,16.29,18.98,1.30
7084,0,70402725,31256,286.28,644824.81,2,70402725,0,70402725,31256,286.28,91.03,644824.81,1,18.29,18.98,1.31
7085,0,70434401,31676,290.09,645114.88,2,70434401,0,70434401,31676,290.12,91.05,645114.88,0,18.31,18.98,1.29
7086,0,70434401,0,0.00,645114.88,2,70444719,10318,70434401,0,0.00,91.04,645114.88,1,20.03,19.03,1.30
7087,0,70434401,0,0.00,645114.88,2,70450452,16051,70434401,0,0.00,91.03,645114.88,0,20.50,19.50,1.29
7088,0,70434401,0,0.00,645114.88,2,70454780,20379,70434401,0,0.00,91.02,645114.88,1,21.07,19.00,1.30
7089,0,70434401,0,0.00,645114.88,2,70458231,23830,70434401,0,0.00,91.00,645114.88,0,20.81,19.81,1.28
7090,0,70434401,0,0.00,645114.88,2,70461545,27144,70434401,0,0.00,90.99,645114.88,1,20.81,19.81,1.30
7091,0,70440797,6396,58.62,645173.50,2,70464743,23946,70440797,6396,58.58,90.98,645173.50,0,19.32,19.81,1.28
7092,0,70446851,6054,55.39,645228.88,2,70467770,20919,70446851,6054,55.45,90.98,645228.88,1,19.67,19.81,1.30
7093,0,70453385,6534,59.86,645288.75,2,70471037,17652,70453385,6534,59.85,90.98,645288.75,0,19.33,19.81,1.28
7094,0,70453385,0,0.00,645288.75,2,70474172,20787,70453385,0,0.00,90.96,645288.75,1,19.96,18.96,1.29
7095,0,70459113,5728,52.46,645341.19,2,70477036,17923,70459113,5728,52.46,90.96,645341.19,0,18.52,18.96,1.28
7096,0,70465059,5946,54.44,645395.69,2,70480009,14950,70465059,5946,54.46,90.95,645395.69,1,18.57,18.96,1.29
7097,0,70474047,8988,82.36,645478.00,2,70484503,10456,70474047,8988,82.32,90.95,645478.00,0,17.51,18.96,1.28
7098,0,70474047,0,0.00,645478.00,2,70489462,15415,70474047,0,0.00,90.94,645478.00,0,19.05,18.05,1.29
7099,0,70474047,0,0.00,645478.00,2,70492726,18679,70474047,0,0.00,90.93,645478.00,1,19.57,18.57,1.31
7100,0,70481191,7144,65.43,645543.44,2,70496298,15107,70481191,7144,65.43,90.92,645543.44,1,18.50,18.57,1.30
7101,0,70490403,9212,84.34,645627.81,2,70500904,10501,70490403,9212,84.37,90.92,645627.81,0,17.42,18.57,1.29
7102,0,70509115,18712,171.38,645799.19,2,70510260,1145,70509115,18712,171.38,90.93,645799.19,1,17.50,18.57,1.30
7103,0,70540720,31605,289.50,646088.69,2,70540720,0,70540720,31605,289.47,90.96,646088.69,0,16.47,18.57,1.29
7104,0,70571812,31092,284.74,646373.44,2,70571812,0,70571812,31092,284.77,90.99,646373.44,1,17.46,18.57,1.31
7105,0,70601504,29692,271.99,646645.38,2,70601504,0,70601504,29692,271.95,91.01,646645.38,0,18.18,18.57,1.30
7106,0,70601504,0,0.00,646645.38,2,70612052,10548,70601504,0,0.00,91.00,646645.38,1,19.32,18.32,1.31
7107,0,70622184,20680,189.41,646834.81,2,70622392,208,70622184,20680,189.41,91.01,646834.81,0,17.41,18.32,1.29
7108,0,70653329,31145,285.25,647120.06,2,70653329,0,70653329,31145,285.26,91.04,647120.06,1,17.60,18.32,1.30
7109,0,70684525,31196,285.76,647405.81,2,70684525,0,70684525,31196,285.73,91.07,647405.81,0,17.54,18.32,1.30
7110,0,70684525,0,0.00,647405.81,2,70694501,9976,70684525,0,0.00,91.06,647405.81,1,18.94,17.94,1.31
7111,0,70705558,21033,192.63,647598.44,2,70705558,0,70705558,21033,192.64,91.07,647598.44,0,16.92,17.94,1.28
7112,0,70705558,0,0.00,647598.44,2,70716794,11236,70705558,0,0.00,91.06,647598.44,1,24.27,19.00,1.30
7113,0,70705558,0,0.00,647598.44,2,70722381,16823,70705558,0,0.00,91.04,647598.44,0,24.81,19.00,1.29
7114,0,70705558,0,0.00,647598.44,2,70726783,21225,70705558,0,0.00,91.03,647598.44,1,26.53,19.00,1.30
7115,0,70705558,0,0.00,647598.44,2,70730797,25239,70705558,0,0.00,91.02,647598.44,0,24.92,19.00,1.28
7116,0,70705558,0,0.00,647598.44,2,70734390,28832,70705558,0,0.00,91.01,647598.44,1,24.92,19.00,1.30
7117,0,70705558,0,0.00,647598.44,2,70737678,32120,70705558,0,0.00,90.99,647598.44,0,23.75,19.00,1.29
7118,0,70705558,0,0.00,647598.44,2,70740723,35165,70705558,0,0.00,90.98,647598.44,1,23.75,19.00,1.30
7119,0,70705558,0,0.00,647598.44,2,70743567,38009,70705558,0,0.00,90.97,647598.44,0,22.43,19.00,1.29
7120,0,70705558,0,0.00,647598.44,2,70746244,40686,70705558,0,0.00,90.95,647598.44,1,22.43,19.00,1.30
7121,0,70705558,0,0.00,647598.44,2,70748790,43232,70705558,0,0.00,90.94,647598.44,1,21.26,19.00,1.30
7122,0,70705558,0,0.00,647598.44,2,70751208,45650,70705558,0,0.00,90.93,647598.44,0,20.22,19.22,1.29
7123,0,70705558,0,0.00,647598.44,2,70753344,47786,70705558,0,0.00,90.92,647598.44,0,20.22,19.22,1.30
7124,0,70705558,0,0.00,647598.44,2,70755163,49605,70705558,0,0.00,90.90,647598.44,1,20.22,19.22,1.32
7125,0,70709786,4228,38.69,647637.12,2,70757277,47491,70709786,4228,38.72,90.90,647637.12,0,18.82,19.22,1.30
7126,0,70714094,4308,39.49,647676.62,2,70759431,45337,70714094,4308,39.46,90.89,647676.62,1,18.85,19.22,1.32
7127,0,70718288,4194,38.39,647715.06,2,70761528,43240,70718288,4194,38.41,90.88,647715.06,0,17.80,19.22,1.31
7128,0,70722316,4028,36.93,647751.94,2,70763542,41226,70722316,4028,36.89,90.87,647751.94,1,18.13,19.22,1.32
7129,0,70726416,4100,37.52,647789.50,2,70765592,39176,70726416,4100,37.55,90.87,647789.50,0,17.87,19.22,1.31
7130,0,70730398,3982,36.49,647825.94,2,70767583,37185,70730398,3982,36.47,90.86,647825.94,1,18.47,19.22,1.32
7131,0,70734346,3948,36.12,647862.06,2,70769557,35211,70734346,3948,36.16,90.85,647862.06,0,16.97,19.22,1.31
7132,0,70738424,4078,37.37,647899.44,2,70771596,33172,70738424,4078,37.35,90.84,647899.44,1,17.00,19.22,1.32
7133,0,70742502,4078,37.37,647936.81,2,70773635,31133,70742502,4078,37.35,90.84,647936.81,0,16.07,19.22,1.32
7134,0,70746548,4046,37.00,647973.81,2,70775658,29110,70746548,4046,37.06,90.83,647973.81,1,16.11,19.22,1.33
7135,0,70750552,4004,36.71,648010.56,2,70777660,27108,70750552,4004,36.67,90.82,648010.56,0,14.71,19.22,1.32
7136,0,70754530,3978,36.42,648046.94,2,70779649,25119,70754530,3978,36.43,90.81,648046.94,1,14.75,19.22,1.33
7137,0,70758590,4060,37.22,648084.19,2,70781679,23089,70758590,4060,37.19,90.81,648084.19,0,13.90,19.22,1.32
7138,0,70762822,4232,38.76,648122.94,2,70783795,20973,70762822,4232,38.76,90.80,648122.94,0,14.51,19.22,1.33
7139,0,70766996,4174,38.18,648161.12,2,70785882,18886,70766996,4174,38.23,90.79,648161.12,1,15.41,19.22,1.35
7140,0,70771054,4058,37.22,648198.31,2,70787911,16857,70771054,4058,37.17,90.78,648198.31,0,14.54,19.22,1.34
7141,0,70775744,4690,42.94,648241.25,2,70790256,14512,70775744,4690,42.96,90.78,648241.25,1,14.58,19.22,1.35
7142,0,70785490,9746,89.25,648330.50,2,70795129,9639,70785490,9746,89.26,90.78,648330.50,0,13.47,19.22,1.34
7143,0,70805108,19618,179.66,648510.19,2,70805108,0,70805108,19618,179.68,90.79,648510.19,1,13.67,19.22,1.36
7144,0,70835031,29923,274.11,648784.31,2,70835031,0,70835031,29923,274.07,90.82,648784.31,1,12.73,19.22,1.35
7145,0,70864277,29246,267.89,649052.19,2,70864277,0,70864277,29246,267.87,90.84,649052.19,0,12.63,19.22,1.34
7146,0,70895237,30960,283.57,649335.75,2,70895237,0,70895237,30960,283.57,90.87,649335.75,1,16.13,19.22,1.36
7147,0,70925772,30535,279.68,649615.44,2,70925772,0,70925772,30535,279.67,90.89,649615.44,0,17.18,19.22,1.35
7148,0,70925772,0,0.00,649615.44,2,70936480,10708,70925772,0,0.00,90.88,649615.44,1,19.46,18.46,1.36
7149,0,70925772,0,0.00,649615.44,2,70942689,16917,70925772,0,0.00,90.87,649615.44,0,19.07,18.07,1.35
7150,0,70925772,0,0.00,649615.44,2,70946850,21078,70925772,0,0.00,90.86,649615.44,1,20.12,19.12,1.37
7151,0,70933812,8040,73.57,649689.00,2,70950870,17058,70933812,8040,73.64,90.85,649689.00,0,19.02,19.12,1.35
7152,0,70942210,8398,76.94,649765.94,2,70955069,12859,70942210,8398,76.92,90.85,649765.94,1,19.09,19.12,1.37
7153,0,70953500,11290,103.46,649869.38,2,70960714,7214,70953500,11290,103.41,90.85,649869.38,0,18.36,19.12,1.35
7154,0,70953500,0,0.00,649869.38,2,70967502,14002,70953500,0,0.00,90.84,649869.38,1,19.74,18.74,1.37
7155,0,70967278,13778,126.18,649995.56,2,70974391,7113,70967278,13778,126.19,90.84,649995.56,0,18.73,18.74,1.36
7156,0,70967278,0,0.00,649995.56,2,70980382,13104,70967278,0,0.00,90.83,649995.56,1,18.85,17.85,1.37
7157,0,70981166,13888,127.20,650122.75,2,70987326,6160,70981166,13888,127.20,90.84,650122.75,0,17.61,17.85,1.36
7158,0,70981166,0,0.00,650122.75,2,70994552,13386,70981166,0,0.00,90.82,650122.75,0,19.42,18.42,1.37
7159,0,70981166,0,0.00,650122.75,2,70999056,17890,70981166,0,0.00,90.81,650122.75,1,19.90,18.90,1.38
7160,0,70981166,0,0.00,650122.75,2,71002091,20925,70981166,0,0.00,90.80,650122.75,0,19.03,18.03,1.38
7161,0,70981166,0,0.00,650122.75,2,71004437,23271,70981166,0,0.00,90.79,650122.75,1,19.03,18.03,1.39
7162,0,70985738,4572,41.84,650164.62,2,71006723,20985,70985738,4572,41.88,90.78,650164.62,1,17.72,18.03,1.38
7163,0,70990752,5014,45.94,650210.56,2,71009230,18478,70990752,5014,45.92,90.77,650210.56,1,16.96,18.03,1.38
7164,0,70996074,5322,48.73,650259.25,2,71011891,15817,70996074,5322,48.74,90.77,650259.25,0,16.32,18.03,1.38
7165,0,71003816,7742,70.93,650330.19,2,71015762,11946,71003816,7742,70.91,90.76,650330.19,1,16.37,18.03,1.39
7166,0,71016942,13126,120.24,650450.44,2,71022325,5383,71016942,13126,120.22,90.77,650450.44,0,15.48,18.03,1.39
7167,0,71044604,27662,253.38,650703.81,2,71044604,0,71044604,27662,253.36,90.79,650703.81,1,15.60,18.03,1.40
7168,0,71076174,31570,289.13,650992.94,2,71076174,0,71076174,31570,289.15,90.82,650992.94,0,14.66,18.03,1.39
7169,0,71109007,32833,300.71,651293.69,2,71109007,0,71109007,32833,300.72,90.85,651293.69,0,16.29,18.03,1.41
7170,0,71109007,0,0.00,651293.69,2,71119598,10591,71109007,0,0.00,90.84,651293.69,1,18.59,17.59,1.42
7171,0,71130533,21526,197.18,651490.88,2,71130533,0,71130533,21526,197.16,90.85,651490.88,0,16.89,17.59,1.39
7172,0,71130533,0,0.00,651490.88,2,71141058,10525,71130533,0,0.00,90.84,651490.88,1,18.80,17.80,1.41
7173,0,71130533,0,0.00,651490.88,2,71146870,16337,71130533,0,0.00,90.83,651490.88,0,18.54,17.54,1.38
7174,0,71130533,0,0.00,651490.88,2,71151459,20926,71130533,0,0.00,90.81,651490.88,0,18.54,17.54,1.39
7175,0,71130533,0,0.00,651490.88,2,71155410,24877,71130533,0,0.00,90.80,651490.88,1,18.83,17.83,1.41
7176,0,71130533,0,0.00,651490.88,2,71158977,28444,71130533,0,0.00,90.79,651490.88,0,18.29,17.29,1.38
7177,0,71130533,0,0.00,651490.88,2,71162222,31689,71130533,0,0.00,90.77,651490.88,1,18.57,17.57,1.40
71