timestamp,socket_0,socket_0_TSENT,socket_0_TSENTSEC,socket_0_TTHSENTSEC,socket_0_TTHSENT,socket_status_0,TMSG,TOSEND,SENT,TMSGSEC,TTHMSGSEC,AVG,THtotalsent,ackSent,state,globalState,THloss
1,0,0,0,0.00,0.00,2,0,0,0,0,0.00,0.00,0.00,0,0.00,8.00,0.00
2,0,0,0,0.00,0.00,2,0,0,0,0,0.00,0.00,0.00,0,0.00,8.00,0.00
3,0,0,0,0.00,0.00,2,0,0,0,0,0.00,0.00,0.00,0,0.00,8.00,0.00
4,0,0,0,0.00,0.00,2,0,0,0,0,0.00,0.00,0.00,0,0.00,8.00,0.00
5,0,0,0,0.00,0.00,2,0,0,0,0,0.00,0.00,0.00,0,0.00,8.00,0.00
6,0,0,0,0.00,0.00,2,0,0,0,0,0.00,0.00,0.00,0,0.00,8.00,0.00
7,0,0,0,0.00,0.00,2,0,0,0,0,0.00,0.00,0.00,0,0.00,8.00,0.00
8,0,0,0,0.00,0.00,2,0,0,0,0,0.00,0.00,0.00,0,0.00,8.00,0.00
9,0,0,0,0.00,0.00,2,0,0,0,0,0.00,0.00,0.00,0,0.00,8.00,0.00
10,0,0,0,0.00,0.00,2,0,0,0,0,0.00,0.00,0.00,0,0.00,8.00,0.00
11,0,0,0,0.00,0.00,2,0,0,0,0,0.00,0.00,0.00,0,0.00,8.00,0.00
12,0,0,0,0.00,0.00,2,0,0,0,0,0.00,0.00,0.00,0,0.00,8.00,0.00
13,0,0,0,0.00,0.00,2,0,0,0,0,0.00,0.00,0.00,0,0.00,8.00,0.00
14,0,0,0,0.00,0.00,2,0,0,0,0,0.00,0.00,0.00,0,0.00,8.00,0.00
15,0,0,0,0.00,0.00,2,0,0,0,0,0.00,0.00,0.00,0,0.00,8.00,0.00
16,0,0,0,0.00,0.00,2,0,0,0,0,0.00,0.00,0.00,0,0.00,8.00,0.00
17,0,0,0,0.00,0.00,2,0,0,0,0,0.00,0.00,0.00,0,0.00,8.00,0.00
18,0,4198,4198,38.45,38.45,2,4198,0,4198,4198,38.45,2.14,38.45,0,0.00,8.00,0.00
19,0,39361,35163,322.06,360.51,2,39361,0,39361,35163,322.06,18.97,360.51,0,1.78,8.00,0.00
20,0,76460,37099,339.79,700.30,2,76460,0,76460,37099,339.79,35.02,700.30,1,2.10,8.00,0.00
21,0,113338,36878,337.77,1038.07,2,113338,0,113338,36878,337.77,49.43,1038.07,1,2.30,8.00,0.00
22,0,150247,36909,338.05,1376.13,2,150247,0,150247,36909,338.05,62.55,1376.13,0,2.63,8.00,4.76
23,0,181972,31725,290.57,1666.70,2,181972,0,181972,31725,290.57,72.47,1666.70,1,9.12,10.12,9.09
24,0,181972,0,0.00,1666.70,2,191831,9859,181972,0,0.00,69.45,1666.70,0,14.32,13.32,9.09
25,0,181972,0,0.00,1666.70,2,197813,15841,181972,0,0.00,66.67,1666.70,1,14.32,13.32,4.17
26,0,181972,0,0.00,1666.70,2,202206,20234,181972,0,0.00,64.10,1666.70,0,15.17,14.17,4.17
27,0,181972,0,0.00,1666.70,2,206209,24237,181972,0,0.00,61.73,1666.70,1,15.17,14.17,3.85
28,0,181972,0,0.00,1666.70,2,209881,27909,181972,0,0.00,59.52,1666.70,0,15.69,14.69,3.85
29,0,181972,0,0.00,1666.70,2,213236,31264,181972,0,0.00,57.47,1666.70,1,15.69,14.69,3.57
30,0,181972,0,0.00,1666.70,2,216347,34375,181972,0,0.00,55.56,1666.70,0,15.41,14.41,3.57
31,0,181972,0,0.00,1666.70,2,219368,37396,181972,0,0.00,53.76,1666.70,0,15.41,14.41,3.33
32,0,181972,0,0.00,1666.70,2,222224,40252,181972,0,0.00,52.08,1666.70,1,16.55,15.55,6.45
33,0,181972,0,0.00,1666.70,2,224700,42728,181972,0,0.00,50.51,1666.70,0,16.16,15.16,6.45
34,0,181972,0,0.00,1666.70,2,226964,44992,181972,0,0.00,49.02,1666.70,1,16.16,15.16,3.03
35,0,186530,4558,41.75,1708.44,2,229243,42713,186530,4558,41.75,48.81,1708.44,0,14.80,15.16,3.03
36,0,191014,4484,41.07,1749.51,2,231485,40471,191014,4484,41.07,48.60,1749.51,1,14.84,15.16,2.86
37,0,195630,4616,42.28,1791.79,2,233793,38163,195630,4616,42.28,48.43,1791.79,0,14.39,15.16,2.86
38,0,200214,4584,41.99,1833.78,2,236085,35871,200214,4584,41.99,48.26,1833.78,0,14.43,15.16,2.70
39,0,204946,4732,43.34,1877.12,2,238451,33505,204946,4732,43.34,48.13,1877.12,0,14.76,15.16,5.26
40,0,209632,4686,42.92,1920.04,2,240794,31162,209632,4686,42.92,48.00,1920.04,1,15.14,15.16,7.69
41,0,214164,4532,41.51,1961.55,2,243060,28896,214164,4532,41.51,47.84,1961.55,0,14.87,15.16,7.69
42,0,218686,4522,41.42,2002.96,2,245321,26635,218686,4522,41.42,47.69,2002.96,1,14.91,15.16,2.44
43,0,223162,4476,41.00,2043.96,2,247559,24397,223162,4476,41.00,47.53,2043.96,0,13.18,15.16,2.44
44,0,227656,4494,41.16,2085.12,2,249806,22150,227656,4494,41.16,47.39,2085.12,1,13.22,15.16,2.33
45,0,232364,4708,43.12,2128.24,2,252160,19796,232364,4708,43.12,47.29,2128.24,0,11.49,15.16,2.33
46,0,237428,5064,46.38,2174.62,2,254692,17264,237428,5064,46.38,47.27,2174.62,1,11.53,15.16,2.22
47,0,242816,5388,49.35,2223.97,2,257386,14570,242816,5388,49.35,47.32,2223.97,1,9.61,15.16,2.22
48,0,251444,8628,79.02,2303.00,2,261700,10256,251444,8628,79.02,47.98,2303.00,0,9.65,15.16,2.13
49,0,273739,22295,204.20,2507.20,2,273739,0,273739,22295,204.20,51.17,2507.20,1,9.73,15.16,4.17
50,0,306326,32587,298.47,2805.67,2,306326,0,306326,32587,298.47,56.11,2805.67,1,9.70,15.16,4.17
51,0,335865,29539,270.55,3076.22,2,335865,0,335865,29539,270.55,60.32,3076.22,0,9.99,15.16,2.00
52,0,365153,29288,268.25,3344.47,2,365153,0,365153,29288,268.25,64.32,3344.47,1,13.22,15.16,3.92
53,0,391482,26329,241.15,3585.62,2,394499,3017,391482,26329,241.15,67.65,3585.62,0,15.61,14.61,3.92
54,0,391482,0,0.00,3585.62,2,403644,12162,391482,0,0.00,66.40,3585.62,1,15.84,14.84,1.89
55,0,391482,0,0.00,3585.62,2,409204,17722,391482,0,0.00,65.19,3585.62,0,16.50,15.50,1.89
56,0,391482,0,0.00,3585.62,2,413782,22300,391482,0,0.00,64.03,3585.62,0,16.50,15.50,1.82
57,0,391482,0,0.00,3585.62,2,417580,26098,391482,0,0.00,62.91,3585.62,1,17.04,16.04,3.57
58,0,398486,7004,64.15,3649.77,2,421082,22596,398486,7004,64.15,62.93,3649.77,0,16.00,16.04,3.57
59,0,398486,0,0.00,3649.77,2,424594,26108,398486,0,0.00,61.86,3649.77,0,16.07,15.07,1.72
60,0,398486,0,0.00,3649.77,2,427714,29228,398486,0,0.00,60.83,3649.77,1,16.61,15.61,3.39
61,0,399563,1077,9.86,3659.63,2,430579,31016,399563,1077,9.86,59.99,3659.63,0,16.07,15.07,3.39
62,0,399563,0,0.00,3659.63,2,433275,33712,399563,0,0.00,59.03,3659.63,1,16.08,15.08,1.64
63,0,404745,5182,47.46,3707.10,2,435866,31121,404745,5182,47.46,58.84,3707.10,0,14.69,15.08,1.64
64,0,409897,5152,47.19,3754.28,2,438442,28545,409897,5152,47.19,58.66,3754.28,1,14.74,15.08,1.59
65,0,414985,5088,46.60,3800.88,2,440986,26001,414985,5088,46.60,58.48,3800.88,1,13.29,15.08,1.59
66,0,420069,5084,46.56,3847.45,2,443528,23459,420069,5084,46.56,58.29,3847.45,0,13.33,15.08,1.54
67,0,425347,5278,48.34,3895.79,2,446167,20820,425347,5278,48.34,58.15,3895.79,1,13.73,15.08,3.03
68,0,430695,5348,48.98,3944.77,2,448841,18146,430695,5348,48.98,58.01,3944.77,1,11.48,15.08,3.03
69,0,436059,5364,49.13,3993.90,2,451523,15464,436059,5364,49.13,57.88,3993.90,0,11.53,15.08,1.47
70,0,443537,7478,68.49,4062.39,2,455262,11725,443537,7478,68.49,58.03,4062.39,1,11.75,15.08,2.90
71,0,460695,17158,157.15,4219.55,2,463841,3146,460695,17158,157.15,59.43,4219.55,0,10.56,15.08,0.15
72,0,494185,33490,306.74,4526.28,2,494185,0,494185,33490,306.74,62.87,4526.28,0,11.23,15.08,1.55
73,0,527517,33332,305.29,4831.57,2,527517,0,527517,33332,305.29,66.19,4831.57,1,12.25,15.08,2.92
74,0,560907,33390,305.82,5137.40,2,560907,0,560907,33390,305.82,69.42,5137.40,1,12.84,15.08,2.92
75,0,594944,34037,311.75,5449.14,2,594944,0,594944,34037,311.75,72.66,5449.14,0,13.14,15.08,1.35
76,0,594944,0,0.00,5449.14,2,605693,10749,594944,0,0.00,71.70,5449.14,1,15.42,14.42,2.67
77,0,594944,0,0.00,5449.14,2,611289,16345,594944,0,0.00,70.77,5449.14,0,16.08,15.08,2.67
78,0,594944,0,0.00,5449.14,2,615867,20923,594944,0,0.00,69.86,5449.14,0,16.08,15.08,1.30
79,0,594944,0,0.00,5449.14,2,619927,24983,594944,0,0.00,68.98,5449.14,1,16.95,15.95,2.56
80,0,602614,7670,70.25,5519.39,2,623762,21148,602614,7670,70.25,68.99,5519.39,1,14.64,15.95,2.56
81,0,610378,7764,71.11,5590.51,2,627644,17266,610378,7764,71.11,69.02,5590.51,0,14.71,15.95,1.25
82,0,618050,7672,70.27,5660.77,2,631480,13430,618050,7672,70.27,69.03,5660.77,0,14.96,15.95,2.47
83,0,627628,9578,87.73,5748.50,2,636269,8641,627628,9578,87.73,69.26,5748.50,1,14.96,15.95,2.47
84,0,650742,23114,211.70,5960.20,2,650742,0,650742,23114,211.70,70.95,5960.20,0,15.24,15.95,0.56
85,0,683622,32880,301.15,6261.35,2,683622,0,683622,32880,301.15,73.66,6261.35,1,15.74,15.95,1.74
86,0,711054,27432,251.25,6512.61,2,711054,0,711054,27432,251.25,75.73,6512.61,1,14.26,15.95,1.74
87,0,737213,26159,239.59,6752.20,2,737213,0,737213,26159,239.59,77.61,6752.20,0,14.51,15.95,1.16
88,0,763092,25879,237.03,6989.23,2,763092,0,763092,25879,237.03,79.42,6989.23,0,14.99,15.95,2.30
89,0,764292,1200,10.99,7000.22,2,773605,9313,764292,1200,10.99,78.65,7000.22,1,16.00,15.00,3.41
90,0,787996,23704,217.11,7217.32,2,787996,0,787996,23704,217.11,80.19,7217.32,0,14.82,15.00,3.41
91,0,787996,0,0.00,7217.32,2,799666,11670,787996,0,0.00,79.31,7217.32,1,15.03,14.03,1.11
92,0,806368,18372,168.27,7385.60,2,808852,2484,806368,18372,168.27,80.28,7385.60,0,14.00,14.03,1.11
93,0,806368,0,0.00,7385.60,2,818225,11857,806368,0,0.00,79.42,7385.60,1,14.17,13.17,1.09
94,0,806368,0,0.00,7385.60,2,823401,17033,806368,0,0.00,78.57,7385.60,0,14.93,13.93,1.09
95,0,806368,0,0.00,7385.60,2,826776,20408,806368,0,0.00,77.74,7385.60,1,14.93,13.93,1.06
96,0,809903,3535,32.38,7417.97,2,829964,20061,809903,3535,32.38,77.27,7417.97,0,14.52,13.52,1.06
97,0,809903,0,0.00,7417.97,2,832724,22821,809903,0,0.00,76.47,7417.97,1,14.55,13.55,1.04
98,0,809903,0,0.00,7417.97,2,835135,25232,809903,0,0.00,75.69,7417.97,0,14.41,13.41,1.04
99,0,809903,0,0.00,7417.97,2,837525,27622,809903,0,0.00,74.93,7417.97,1,14.41,13.41,1.02
100,0,809903,0,0.00,7417.97,2,839796,29893,809903,0,0.00,74.18,7417.97,0,15.99,14.99,1.02
101,0,809903,0,0.00,7417.97,2,841966,32063,809903,0,0.00,73.45,7417.97,1,15.99,14.99,1.00
102,0,809903,0,0.00,7417.97,2,844052,34149,809903,0,0.00,72.73,7417.97,1,15.06,14.06,0.07
103,0,814183,4280,39.20,7457.17,2,846192,32009,814183,4280,39.20,72.40,7457.17,0,13.95,14.06,0.07
104,0,818859,4676,42.83,7500.00,2,848530,29671,818859,4676,42.83,72.12,7500.00,1,13.99,14.06,0.97
105,0,823489,4630,42.41,7542.41,2,850845,27356,823489,4630,42.41,71.83,7542.41,0,12.71,14.06,0.97
106,0,828231,4742,43.43,7585.84,2,853216,24985,828231,4742,43.43,71.56,7585.84,1,12.75,14.06,0.95
107,0,833283,5052,46.27,7632.11,2,855742,22459,833283,5052,46.27,71.33,7632.11,0,11.32,14.06,0.95
108,0,838453,5170,47.35,7679.46,2,858327,19874,838453,5170,47.35,71.11,7679.46,1,11.36,14.06,0.93
109,0,843659,5206,47.68,7727.15,2,860930,17271,843659,5206,47.68,70.89,7727.15,0,10.99,14.06,0.93
110,0,849455,5796,53.09,7780.23,2,863828,14373,849455,5796,53.09,70.73,7780.23,1,11.03,14.06,0.92
111,0,857467,8012,73.38,7853.62,2,867834,10367,857467,8012,73.38,70.75,7853.62,0,9.28,14.06,0.92
112,0,877459,19992,183.11,8036.72,2,877830,371,877459,19992,183.11,71.76,8036.72,1,9.35,14.06,0.90
113,0,912598,35139,321.84,8358.57,2,912598,0,912598,35139,321.84,73.97,8358.57,0,8.64,14.06,0.90
114,0,947172,34574,316.67,8675.23,2,947172,0,947172,34574,316.67,76.10,8675.23,0,8.96,14.06,0.88
115,0,980865,33693,308.60,8983.83,2,980865,0,980865,33693,308.60,78.12,8983.83,1,10.53,14.06,1.75
116,0,1014733,33868,310.20,9294.03,2,1014733,0,1014733,33868,310.20,80.12,9294.03,0,11.00,14.06,1.75
117,0,1048381,33648,308.18,9602.21,2,1048381,0,1048381,33648,308.18,82.07,9602.21,1,11.30,14.06,0.86
118,0,1080005,31624,289.65,9891.86,2,1080799,794,1080005,31624,289.65,83.83,9891.86,0,14.62,13.62,0.86
119,0,1080005,0,0.00,9891.86,2,1091304,11299,1080005,0,0.00,83.12,9891.86,0,14.91,13.91,0.85
120,0,1080005,0,0.00,9891.86,2,1097060,17055,1080005,0,0.00,82.43,9891.86,1,16.34,15.34,1.68
121,0,1080005,0,0.00,9891.86,2,1101829,21824,1080005,0,0.00,81.75,9891.86,0,15.50,14.50,0.40
122,0,1080005,0,0.00,9891.86,2,1105906,25901,1080005,0,0.00,81.08,9891.86,1,16.37,15.37,1.22
123,0,1080005,0,0.00,9891.86,2,1109498,29493,1080005,0,0.00,80.42,9891.86,0,15.47,14.47,1.22
124,0,1080005,0,0.00,9891.86,2,1112745,32740,1080005,0,0.00,79.77,9891.86,1,15.47,14.47,0.81
125,0,1086199,6194,56.73,9948.59,2,1115842,29643,1086199,6194,56.73,79.59,9948.59,1,13.84,14.47,0.81
126,0,1092285,6086,55.74,10004.33,2,1118885,26600,1092285,6086,55.74,79.40,10004.33,0,13.90,14.47,0.80
127,0,1092285,0,0.00,10004.33,2,1121549,29264,1092285,0,0.00,78.77,10004.33,1,14.52,13.52,1.59
128,0,1097393,5108,46.78,10051.12,2,1124103,26710,1097393,5108,46.78,78.52,10051.12,0,13.35,13.52,0.37
129,0,1102701,5308,48.62,10099.74,2,1126757,24056,1102701,5308,48.62,78.29,10099.74,1,13.39,13.52,1.15
130,0,1107945,5244,48.03,10147.77,2,1129379,21434,1107945,5244,48.03,78.06,10147.77,0,12.33,13.52,0.41
131,0,1113167,5222,47.83,10195.59,2,1131990,18823,1113167,5222,47.83,77.83,10195.59,1,12.95,13.52,1.18
132,0,1118647,5480,50.19,10245.79,2,1134730,16083,1118647,5480,50.19,77.62,10245.79,1,12.53,13.52,0.54
133,0,1125303,6656,60.96,10306.75,2,1138058,12755,1125303,6656,60.96,77.49,10306.75,0,12.25,13.52,0.54
134,0,1139383,14080,128.96,10435.71,2,1145098,5715,1139383,14080,128.96,77.88,10435.71,1,12.31,13.52,0.75
135,0,1168182,28799,263.77,10699.48,2,1168182,0,1168182,28799,263.77,79.26,10699.48,0,13.28,13.52,0.75
136,0,1168182,0,0.00,10699.48,2,1179181,10999,1168182,0,0.00,78.67,10699.48,1,13.54,12.54,0.74
137,0,1168182,0,0.00,10699.48,2,1185128,16946,1168182,0,0.00,78.10,10699.48,0,12.79,11.79,0.74
138,0,1168182,0,0.00,10699.48,2,1189610,21428,1168182,0,0.00,77.53,10699.48,1,12.79,11.79,0.73
139,0,1176908,8726,79.92,10779.40,2,1193973,17065,1176908,8726,79.92,77.55,10779.40,0,11.58,11.79,0.73
140,0,1185512,8604,78.80,10858.21,2,1198275,12763,1185512,8604,78.80,77.56,10858.21,1,11.65,11.79,0.72
141,0,1197474,11962,109.56,10967.77,2,1204256,6782,1197474,11962,109.56,77.79,10967.77,0,10.41,11.79,0.72
142,0,1226619,29145,266.94,11234.71,2,1226619,0,1226619,29145,266.94,79.12,11234.71,1,10.51,11.79,0.71
143,0,1242129,15510,142.06,11376.77,2,1248783,6654,1242129,15510,142.06,79.56,11376.77,0,12.37,11.37,0.71
144,0,1242129,0,0.00,11376.77,2,1256235,14106,1242129,0,0.00,79.01,11376.77,0,12.50,11.50,0.70
145,0,1242129,0,0.00,11376.77,2,1261441,19312,1242129,0,0.00,78.46,11376.77,1,13.64,12.64,1.39
146,0,1251329,9200,84.26,11461.03,2,1266041,14712,1251329,9200,84.26,78.50,11461.03,1,11.22,12.64,1.39
147,0,1261563,10234,93.73,11554.77,2,1271158,9595,1261563,10234,93.73,78.60,11554.77,0,11.31,12.64,0.68
148,0,1284392,22829,209.09,11763.86,2,1284392,0,1284392,22829,209.09,79.49,11763.86,1,11.54,12.64,1.36
149,0,1317871,33479,306.64,12070.50,2,1317871,0,1317871,33479,306.64,81.01,12070.50,0,11.40,12.64,1.36
150,0,1350678,32807,300.48,12370.98,2,1350678,0,1350678,32807,300.48,82.47,12370.98,1,11.70,12.64,0.67
151,0,1350678,0,0.00,12370.98,2,1361349,10671,1350678,0,0.00,81.93,12370.98,0,12.94,11.94,0.22
152,0,1350678,0,0.00,12370.98,2,1367318,16640,1350678,0,0.00,81.39,12370.98,0,13.72,12.72,0.88
153,0,1350678,0,0.00,12370.98,2,1372074,21396,1350678,0,0.00,80.86,12370.98,1,13.88,12.88,1.53
154,0,1359172,8494,77.80,12448.78,2,1376321,17149,1359172,8494,77.80,80.84,12448.78,0,11.65,12.88,1.53
155,0,1367320,8148,74.63,12523.40,2,1380395,13075,1367320,8148,74.63,80.80,12523.40,1,11.73,12.88,0.65
156,0,1378698,11378,104.21,12627.62,2,1386084,7386,1378698,11378,104.21,80.95,12627.62,0,10.65,12.88,0.06
157,0,1407894,29196,267.41,12895.03,2,1407894,0,1407894,29196,267.41,82.13,12895.03,1,11.17,12.88,0.70
158,0,1418897,11003,100.78,12995.80,2,1426630,7733,1418897,11003,100.78,82.25,12995.80,0,13.93,12.93,0.70
159,0,1418897,0,0.00,12995.80,2,1433756,14859,1418897,0,0.00,81.73,12995.80,1,14.03,13.03,0.63
160,0,1418897,0,0.00,12995.80,2,1438804,19907,1418897,0,0.00,81.22,12995.80,0,13.48,12.48,0.63
161,0,1418897,0,0.00,12995.80,2,1442754,23857,1418897,0,0.00,80.72,12995.80,1,13.48,12.48,0.62
162,0,1418897,0,0.00,12995.80,2,1446317,27420,1418897,0,0.00,80.22,12995.80,0,12.98,11.98,0.62
163,0,1418897,0,0.00,12995.80,2,1449712,30815,1418897,0,0.00,79.73,12995.80,1,12.98,11.98,0.62
164,0,1425439,6542,59.92,13055.72,2,1452983,27544,1425439,6542,59.92,79.61,13055.72,1,10.20,11.98,0.62
165,0,1431853,6414,58.75,13114.47,2,1456190,24337,1431853,6414,58.75,79.48,13114.47,0,10.25,11.98,0.61
166,0,1438165,6312,57.81,13172.28,2,1459346,21181,1438165,6312,57.81,79.35,13172.28,0,10.58,11.98,1.21
167,0,1444365,6200,56.79,13229.07,2,1462446,18081,1444365,6200,56.79,79.22,13229.07,1,11.01,11.98,1.81
168,0,1450571,6206,56.84,13285.91,2,1465549,14978,1450571,6206,56.84,79.08,13285.91,1,8.74,11.98,0.11
169,0,1458173,7602,69.63,13355.54,2,1469350,11177,1458173,7602,69.63,79.03,13355.54,0,8.59,11.98,0.11
170,0,1474603,16430,150.48,13506.02,2,1477565,2962,1474603,16430,150.48,79.45,13506.02,0,8.65,11.98,0.59
171,0,1507758,33155,303.67,13809.69,2,1507758,0,1507758,33155,303.67,80.76,13809.69,1,9.76,11.98,1.18
172,0,1541467,33709,308.74,14118.43,2,1541467,0,1541467,33709,308.74,82.08,14118.43,1,9.09,11.98,1.18
173,0,1573478,32011,293.19,14411.62,2,1573478,0,1573478,32011,293.19,83.30,14411.62,0,9.39,11.98,0.58
174,0,1600416,26938,246.73,14658.35,2,1600416,0,1600416,26938,246.73,84.24,14658.35,0,9.70,11.98,1.16
175,0,1627550,27134,248.52,14906.87,2,1627550,0,1627550,27134,248.52,85.18,14906.87,1,10.15,11.98,1.72
176,0,1654954,27404,251.00,15157.87,2,1654954,0,1654954,27404,251.00,86.12,15157.87,0,9.75,11.98,1.02
177,0,1681613,26659,244.17,15402.04,2,1681613,0,1681613,26659,244.17,87.02,15402.04,1,10.75,11.98,1.58
178,0,1712333,30720,281.37,15683.41,2,1712333,0,1712333,30720,281.37,88.11,15683.41,0,9.32,11.98,0.63
179,0,1745647,33314,305.13,15988.54,2,1745647,0,1745647,33314,305.13,89.32,15988.54,1,10.28,11.98,1.18
180,0,1780096,34449,315.52,16304.06,2,1780096,0,1780096,34449,315.52,90.58,16304.06,1,9.65,11.98,0.49
181,0,1814372,34276,313.94,16617.99,2,1814372,0,1814372,34276,313.94,91.81,16617.99,0,8.78,11.98,0.49
182,0,1848911,34539,316.35,16934.34,2,1848911,0,1848911,34539,316.35,93.05,16934.34,1,9.09,11.98,0.55
183,0,1856661,7750,70.98,17005.32,2,1865475,8814,1856661,7750,70.98,92.93,17005.32,0,16.70,15.70,0.55
184,0,1856661,0,0.00,17005.32,2,1871942,15281,1856661,0,0.00,92.42,17005.32,1,16.77,15.77,0.55
185,0,1868091,11430,104.69,17110.01,2,1877657,9566,1868091,11430,104.69,92.49,17110.01,0,15.42,15.77,0.55
186,0,1889787,21696,198.72,17308.73,2,1889787,0,1889787,21696,198.72,93.06,17308.73,1,15.52,15.77,0.54
187,0,1895941,6154,56.37,17365.09,2,1905084,9143,1895941,6154,56.37,92.86,17365.09,0,18.38,17.38,0.54
188,0,1895941,0,0.00,17365.09,2,1911538,15597,1895941,0,0.00,92.37,17365.09,1,18.44,17.44,0.53
189,0,1895941,0,0.00,17365.09,2,1916342,20401,1895941,0,0.00,91.88,17365.09,0,19.95,18.95,0.53
190,0,1895941,0,0.00,17365.09,2,1920353,24412,1895941,0,0.00,91.40,17365.09,0,19.95,18.95,0.53
191,0,1895941,0,0.00,17365.09,2,1923713,27772,1895941,0,0.00,90.92,17365.09,1,19.95,18.95,1.05
192,0,1902559,6618,60.61,17425.71,2,1927022,24463,1902559,6618,60.61,90.76,17425.71,1,17.15,18.95,1.05
193,0,1909325,6766,61.97,17487.68,2,1930405,21080,1909325,6766,61.97,90.61,17487.68,0,17.21,18.95,0.52
194,0,1915747,6422,58.82,17546.50,2,1933616,17869,1915747,6422,58.82,90.45,17546.50,1,18.41,18.95,1.04
195,0,1922357,6610,60.54,17607.04,2,1936921,14564,1922357,6610,60.54,90.29,17607.04,0,16.60,18.95,0.04
196,0,1929943,7586,69.48,17676.52,2,1940714,10771,1929943,7586,69.48,90.19,17676.52,0,16.65,18.95,0.55
197,0,1947343,17400,159.37,17835.89,2,1949414,2071,1947343,17400,159.37,90.54,17835.89,1,16.72,18.95,1.06
198,0,1979684,32341,296.21,18132.10,2,1979684,0,1979684,32341,296.21,91.58,18132.10,0,17.17,18.95,0.21
199,0,1979684,0,0.00,18132.10,2,1990141,10457,1979684,0,0.00,91.12,18132.10,1,19.46,18.46,0.72
200,0,1979684,0,0.00,18132.10,2,1995987,16303,1979684,0,0.00,90.66,18132.10,0,19.43,18.43,0.72
201,0,1979684,0,0.00,18132.10,2,2000701,21017,1979684,0,0.00,90.21,18132.10,1,19.43,18.43,0.50
202,0,1988402,8718,79.85,18211.95,2,2005060,16658,1988402,8718,79.85,90.16,18211.95,0,18.18,18.43,0.50
203,0,1997120,8718,79.85,18291.80,2,2009419,12299,1997120,8718,79.85,90.11,18291.80,1,18.26,18.43,0.50
204,0,2010130,13010,119.16,18410.96,2,2015924,5794,2010130,13010,119.16,90.25,18410.96,0,17.35,18.43,0.50
205,0,2038549,28419,260.29,18671.25,2,2038549,0,2038549,28419,260.29,91.08,18671.25,1,17.46,18.43,0.49
206,0,2071552,33003,302.28,18973.53,2,2071552,0,2071552,33003,302.28,92.10,18973.53,1,16.96,18.43,0.49
207,0,2104489,32937,301.67,19275.20,2,2104489,0,2104489,32937,301.67,93.12,19275.20,0,17.25,18.43,0.49
208,0,2135737,31248,286.20,19561.40,2,2135737,0,2135737,31248,286.20,94.05,19561.40,1,18.34,18.43,0.97
209,0,2135737,0,0.00,19561.40,2,2146371,10634,2135737,0,0.00,93.60,19561.40,0,18.78,17.78,0.39
210,0,2135737,0,0.00,19561.40,2,2152179,16442,2135737,0,0.00,93.15,19561.40,0,20.03,19.03,0.87
211,0,2135737,0,0.00,19561.40,2,2156921,21184,2135737,0,0.00,92.71,19561.40,1,20.94,19.94,1.34
212,0,2144419,8682,79.52,19640.92,2,2161262,16843,2144419,8682,79.52,92.65,19640.92,1,19.79,19.94,0.64
213,0,2153159,8740,80.05,19720.97,2,2165632,12473,2153159,8740,80.05,92.59,19720.97,0,18.44,19.94,0.00
214,0,2164857,11698,107.14,19828.12,2,2171481,6624,2164857,11698,107.14,92.65,19828.12,1,18.69,19.94,0.47
215,0,2193322,28465,260.71,20088.83,2,2193322,0,2193322,28465,260.71,93.44,20088.83,0,18.07,19.94,0.47
216,0,2226162,32840,300.78,20389.61,2,2226162,0,2226162,32840,300.78,94.40,20389.61,0,18.32,19.94,0.47
217,0,2226162,0,0.00,20389.61,2,2236718,10556,2226162,0,0.00,93.96,20389.61,1,20.32,19.32,0.93
218,0,2226162,0,0.00,20389.61,2,2242465,16303,2226162,0,0.00,93.53,20389.61,0,20.36,19.36,0.93
219,0,2226162,0,0.00,20389.61,2,2246776,20614,2226162,0,0.00,93.10,20389.61,1,20.36,19.36,0.46
220,0,2226162,0,0.00,20389.61,2,2250748,24586,2226162,0,0.00,92.68,20389.61,0,20.98,19.98,0.46
221,0,2226162,0,0.00,20389.61,2,2254300,28138,2226162,0,0.00,92.26,20389.61,1,20.98,19.98,0.45
222,0,2232672,6510,59.63,20449.24,2,2257555,24883,2232672,6510,59.63,92.11,20449.24,0,19.17,19.98,0.45
223,0,2239338,6666,61.05,20510.29,2,2260888,21550,2239338,6666,61.05,91.97,20510.29,1,19.23,19.98,0.45
224,0,2246030,6692,61.29,20571.59,2,2264234,18204,2246030,6692,61.29,91.84,20571.59,0,18.72,19.98,0.45
225,0,2252590,6560,60.08,20631.67,2,2267514,14924,2252590,6560,60.08,91.70,20631.67,1,18.78,19.98,0.45
226,0,2259890,7300,66.86,20698.53,2,2271164,11274,2259890,7300,66.86,91.59,20698.53,0,18.45,19.98,0.14
227,0,2275064,15174,138.98,20837.51,2,2278751,3687,2275064,15174,138.98,91.80,20837.51,1,18.51,19.98,0.58
228,0,2305827,30763,281.76,21119.27,2,2305827,0,2305827,30763,281.76,92.63,21119.27,0,18.39,19.98,0.58
229,0,2333599,27772,254.37,21373.64,2,2333599,0,2333599,27772,254.37,93.33,21373.64,1,18.67,19.98,0.44
230,0,2364719,31120,285.03,21658.67,2,2364719,0,2364719,31120,285.03,94.17,21658.67,0,19.72,19.98,0.44
231,0,2364719,0,0.00,21658.67,2,2375194,10475,2364719,0,0.00,93.76,21658.67,1,20.00,19.00,0.43
232,0,2364719,0,0.00,21658.67,2,2380922,16203,2364719,0,0.00,93.36,21658.67,0,20.56,19.56,0.43
233,0,2364719,0,0.00,21658.67,2,2385349,20630,2364719,0,0.00,92.96,21658.67,1,20.56,19.56,0.43
234,0,2369684,4965,45.47,21704.14,2,2389431,19747,2369684,4965,45.47,92.75,21704.14,1,19.02,19.42,0.43
235,0,2377756,8072,73.93,21778.08,2,2393467,15711,2377756,8072,73.93,92.67,21778.08,0,19.07,19.42,0.43
236,0,2386428,8672,79.43,21857.50,2,2397803,11375,2386428,8672,79.43,92.62,21857.50,0,19.26,19.42,0.85
237,0,2386428,0,0.00,21857.50,2,2401788,15360,2386428,0,0.00,92.23,21857.50,1,19.68,18.68,1.27
238,0,2395202,8774,80.36,21937.87,2,2406175,10973,2395202,8774,80.36,92.18,21937.87,0,18.36,18.68,0.80
239,0,2414038,18836,172.52,22110.39,2,2415593,1555,2414038,18836,172.52,92.51,22110.39,0,18.44,18.68,1.21
240,0,2414038,0,0.00,22110.39,2,2424989,10951,2414038,0,0.00,92.13,22110.39,1,19.01,18.01,1.63
241,0,2432636,18598,170.34,22280.73,2,2434288,1652,2432636,18598,170.34,92.45,22280.73,1,17.88,18.01,1.03
242,0,2432636,0,0.00,22280.73,2,2443295,10659,2432636,0,0.00,92.07,22280.73,0,18.24,17.24,0.58
243,0,2432636,0,0.00,22280.73,2,2448749,16113,2432636,0,0.00,91.69,22280.73,1,18.68,17.68,0.99
244,0,2442774,10138,92.85,22373.58,2,2453818,11044,2442774,10138,92.85,91.70,22373.58,1,17.54,17.68,0.53
245,0,2461890,19116,175.09,22548.67,2,2463376,1486,2461890,19116,175.09,92.04,22548.67,0,17.16,17.68,0.40
246,0,2494599,32709,299.58,22848.25,2,2494599,0,2494599,32709,299.58,92.88,22848.25,1,17.33,17.68,0.80
247,0,2494599,0,0.00,22848.25,2,2505163,10564,2494599,0,0.00,92.50,22848.25,0,19.47,18.47,0.31
248,0,2494599,0,0.00,22848.25,2,2511020,16421,2494599,0,0.00,92.13,22848.25,1,20.24,19.24,0.71
249,0,2505541,10942,100.22,22948.47,2,2516491,10950,2505541,10942,100.22,92.16,22948.47,0,19.20,19.24,0.36
250,0,2505541,0,0.00,22948.47,2,2521454,15913,2505541,0,0.00,91.79,22948.47,1,19.51,18.51,0.76
251,0,2505541,0,0.00,22948.47,2,2525129,19588,2505541,0,0.00,91.43,22948.47,0,18.54,17.54,0.01
252,0,2505541,0,0.00,22948.47,2,2528314,22773,2505541,0,0.00,91.07,22948.47,1,18.73,17.73,0.41
253,0,2511207,5666,51.90,23000.37,2,2531147,19940,2511207,5666,51.90,90.91,23000.37,0,17.49,17.73,0.03
254,0,2517397,6190,56.69,23057.06,2,2534242,16845,2517397,6190,56.69,90.78,23057.06,0,17.54,17.73,0.43
255,0,2517397,0,0.00,23057.06,2,2537382,19985,2517397,0,0.00,90.42,23057.06,1,18.08,17.08,0.82
256,0,2523751,6354,58.20,23115.26,2,2540559,16808,2523751,6354,58.20,90.29,23115.26,1,15.58,17.08,0.82
257,0,2531719,7968,72.98,23188.24,2,2544543,12824,2531719,7968,72.98,90.23,23188.24,0,15.64,17.08,0.39
258,0,2546881,15162,138.87,23327.11,2,2552124,5243,2546881,15162,138.87,90.42,23327.11,0,15.82,17.08,0.78
259,0,2574571,27690,253.62,23580.72,2,2574571,0,2574571,27690,253.62,91.05,23580.72,1,16.58,17.08,1.16
260,0,2605006,30435,278.76,23859.48,2,2605006,0,2605006,30435,278.76,91.77,23859.48,0,15.87,17.08,0.61
261,0,2638237,33231,304.37,24163.85,2,2638237,0,2638237,33231,304.37,92.58,24163.85,1,16.91,17.08,0.99
262,0,2638237,0,0.00,24163.85,2,2648836,10599,2638237,0,0.00,92.23,24163.85,1,17.40,16.40,0.47
263,0,2638237,0,0.00,24163.85,2,2654716,16479,2638237,0,0.00,91.88,24163.85,0,16.79,15.79,0.04
264,0,2638237,0,0.00,24163.85,2,2658895,20658,2638237,0,0.00,91.53,24163.85,1,17.76,16.76,0.42
265,0,2646205,7968,72.98,24236.82,2,2662879,16674,2646205,7968,72.98,91.46,24236.82,0,16.50,16.76,0.42
266,0,2654809,8604,78.80,24315.63,2,2667181,12372,2654809,8604,78.80,91.41,24315.63,1,16.58,16.76,0.38
267,0,2668563,13754,125.97,24441.60,2,2674058,5495,2668563,13754,125.97,91.54,24441.60,0,15.36,16.76,0.38
268,0,2698920,30357,278.04,24719.65,2,2698920,0,2698920,30357,278.04,92.24,24719.65,0,15.48,16.76,0.37
269,0,2731518,32598,298.57,25018.21,2,2731518,0,2731518,32598,298.57,93.00,25018.21,1,16.15,16.76,0.75
270,0,2764265,32747,299.93,25318.15,2,2764265,0,2764265,32747,299.93,93.77,25318.15,0,16.74,16.76,0.75
271,0,2764265,0,0.00,25318.15,2,2774961,10696,2764265,0,0.00,93.42,25318.15,1,17.04,16.04,0.37
272,0,2764265,0,0.00,25318.15,2,2780922,16657,2764265,0,0.00,93.08,25318.15,0,18.35,17.35,0.37
273,0,2764265,0,0.00,25318.15,2,2785410,21145,2764265,0,0.00,92.74,25318.15,1,18.35,17.35,0.37
274,0,2768636,4371,40.03,25358.18,2,2789306,20670,2768636,4371,40.03,92.55,25358.18,0,17.71,16.71,0.37
275,0,2768636,0,0.00,25358.18,2,2792980,24344,2768636,0,0.00,92.21,25358.18,1,17.75,16.75,0.36
276,0,2775692,7056,64.63,25422.81,2,2796508,20816,2775692,7056,64.63,92.11,25422.81,0,16.30,16.75,0.36
277,0,2782560,6868,62.90,25485.71,2,2799942,17382,2782560,6868,62.90,92.01,25485.71,0,16.37,16.75,0.36
278,0,2789536,6976,63.89,25549.61,2,2803430,13894,2789536,6976,63.89,91.91,25549.61,1,16.53,16.75,0.72
279,0,2799196,9660,88.48,25638.08,2,2808260,9064,2799196,9660,88.48,91.89,25638.08,0,15.59,16.75,0.18
280,0,2823151,23955,219.41,25857.49,2,2823151,0,2823151,23955,219.41,92.35,25857.49,1,16.02,16.75,0.54
281,0,2856029,32878,301.13,26158.62,2,2856029,0,2856029,32878,301.13,93.09,26158.62,0,15.88,16.75,0.54
282,0,2888605,32576,298.37,26456.99,2,2888605,0,2888605,32576,298.37,93.82,26456.99,1,16.18,16.75,0.36
283,0,2897406,8801,80.61,26537.60,2,2905823,8417,2897406,8801,80.61,93.77,26537.60,0,17.69,16.69,0.36
284,0,2897406,0,0.00,26537.60,2,2912381,14975,2897406,0,0.00,93.44,26537.60,1,17.77,16.77,0.35
285,0,2897406,0,0.00,26537.60,2,2917028,19622,2897406,0,0.00,93.11,26537.60,0,18.85,17.85,0.24
286,0,2897406,0,0.00,26537.60,2,2921013,23607,2897406,0,0.00,92.79,26537.60,1,19.42,18.42,0.59
287,0,2905182,7776,71.22,26608.82,2,2924901,19719,2905182,7776,71.22,92.71,26608.82,0,17.76,18.42,0.08
288,0,2912854,7672,70.27,26679.09,2,2928737,15883,2912854,7672,70.27,92.64,26679.09,1,17.91,18.42,0.43
289,0,2920920,8066,73.88,26752.96,2,2932770,11850,2920920,8066,73.88,92.57,26752.96,1,17.85,18.42,0.21
290,0,2934436,13516,123.79,26876.76,2,2939528,5092,2934436,13516,123.79,92.68,26876.76,1,17.20,18.42,0.18
291,0,2964201,29765,272.62,27149.38,2,2964201,0,2964201,29765,272.62,93.30,27149.38,0,16.85,18.42,0.18
292,0,2996938,32737,299.84,27449.22,2,2996938,0,2996938,32737,299.84,94.00,27449.22,1,17.12,18.42,0.34
293,0,3029651,32713,299.62,27748.84,2,3029651,0,3029651,32713,299.62,94.71,27748.84,0,17.29,18.42,0.21
294,0,3029651,0,0.00,27748.84,2,3040192,10541,3029651,0,0.00,94.38,27748.84,1,18.62,17.62,0.55
295,0,3049799,20148,184.54,27933.38,2,3050266,467,3049799,20148,184.54,94.69,27933.38,0,17.58,17.62,0.07
296,0,3049799,0,0.00,27933.38,2,3060592,10793,3049799,0,0.00,94.37,27933.38,1,20.84,19.84,0.41
297,0,3049799,0,0.00,27933.38,2,3066157,16358,3049799,0,0.00,94.05,27933.38,0,20.51,19.51,0.02
298,0,3049799,0,0.00,27933.38,2,3069984,20185,3049799,0,0.00,93.74,27933.38,0,21.15,19.00,0.35
299,0,3049799,0,0.00,27933.38,2,3073207,23408,3049799,0,0.00,93.42,27933.38,0,21.24,19.00,0.69
300,0,3049799,0,0.00,27933.38,2,3076085,26286,3049799,0,0.00,93.11,27933.38,1,21.24,19.00,1.02
301,0,3055979,6180,56.60,27989.98,2,3079175,23196,3055979,6180,56.60,92.99,27989.98,0,19.00,19.00,0.16
302,0,3055979,0,0.00,27989.98,2,3082247,26268,3055979,0,0.00,92.68,27989.98,1,19.35,18.35,0.50
303,0,3055979,0,0.00,27989.98,2,3084996,29017,3055979,0,0.00,92.38,27989.98,0,18.40,17.40,0.28
304,0,3055979,0,0.00,27989.98,2,3087581,31602,3055979,0,0.00,92.07,27989.98,0,18.60,17.60,0.61
305,0,3055979,0,0.00,27989.98,2,3090028,34049,3055979,0,0.00,91.77,27989.98,1,18.70,17.70,0.94
306,0,3060741,4762,43.62,28033.60,2,3092409,31668,3060741,4762,43.62,91.61,28033.60,0,16.53,17.70,0.22
307,0,3065493,4752,43.52,28077.12,2,3094785,29292,3065493,4752,43.52,91.46,28077.12,1,16.81,17.70,0.54
308,0,3070219,4726,43.29,28120.41,2,3097148,26929,3070219,4726,43.29,91.30,28120.41,1,15.74,17.70,0.18
309,0,3074941,4722,43.25,28163.66,2,3099509,24568,3074941,4722,43.25,91.14,28163.66,1,15.09,17.70,0.17
310,0,3079725,4784,43.82,28207.47,2,3101901,22176,3079725,4784,43.82,90.99,28207.47,0,14.44,17.70,0.02
311,0,3084939,5214,47.76,28255.23,2,3104508,19569,3084939,5214,47.76,90.85,28255.23,1,14.73,17.70,0.34
312,0,3090021,5082,46.55,28301.78,2,3107049,17028,3090021,5082,46.55,90.71,28301.78,1,12.63,17.70,0.34
313,0,3095751,5730,52.48,28354.26,2,3109914,14163,3095751,5730,52.48,90.59,28354.26,0,12.67,17.70,0.32
314,0,3105563,9812,89.87,28444.12,2,3114820,9257,3105563,9812,89.87,90.59,28444.12,1,12.91,17.70,0.64
315,0,3128500,22937,210.08,28654.21,2,3128500,0,3128500,22937,210.08,90.97,28654.21,0,11.56,17.70,0.28
316,0,3161831,33331,305.28,28959.49,2,3161831,0,3161831,33331,305.28,91.64,28959.49,1,12.48,17.70,0.60
317,0,3194846,33015,302.39,29261.88,2,3194846,0,3194846,33015,302.39,92.31,29261.88,0,13.98,17.70,0.36
318,0,3228101,33255,304.59,29566.46,2,3228101,0,3228101,33255,304.59,92.98,29566.46,0,17.00,17.70,0.68
319,0,3228101,0,0.00,29566.46,2,3238650,10549,3228101,0,0.00,92.68,29566.46,1,18.64,17.64,0.99
320,0,3248709,20608,188.75,29755.21,2,3248954,245,3248709,20608,188.75,92.99,29755.21,1,16.99,17.64,0.52
321,0,3281481,32772,300.16,30055.37,2,3281481,0,3281481,32772,300.16,93.63,30055.37,0,16.23,17.64,0.26
322,0,3314142,32661,299.14,30354.52,2,3314142,0,3314142,32661,299.14,94.27,30354.52,1,17.36,17.64,0.58
323,0,3314142,0,0.00,30354.52,2,3324843,10701,3314142,0,0.00,93.98,30354.52,0,18.07,17.07,0.20
324,0,3314142,0,0.00,30354.52,2,3330568,16426,3314142,0,0.00,93.69,30354.52,1,18.35,17.35,0.51
325,0,3314142,0,0.00,30354.52,2,3335018,20876,3314142,0,0.00,93.40,30354.52,0,18.51,17.51,0.51
326,0,3314142,0,0.00,30354.52,2,3338873,24731,3314142,0,0.00,93.11,30354.52,0,18.51,17.51,0.31
327,0,3314142,0,0.00,30354.52,2,3342515,28373,3314142,0,0.00,92.83,30354.52,1,18.51,17.51,0.61
328,0,3321080,6938,63.55,30418.06,2,3345984,24904,3321080,6938,63.55,92.74,30418.06,1,16.73,17.51,0.61
329,0,3327906,6826,62.52,30480.58,2,3349397,21491,3327906,6826,62.52,92.65,30480.58,0,16.79,17.51,0.30
330,0,3334652,6746,61.79,30542.37,2,3352770,18118,3334652,6746,61.79,92.55,30542.37,0,17.12,17.51,0.61
331,0,3341256,6604,60.49,30602.86,2,3356072,14816,3341256,6604,60.49,92.46,30602.86,1,17.18,17.51,0.91
332,0,3348796,7540,69.06,30671.92,2,3359842,11046,3348796,7540,69.06,92.39,30671.92,0,15.13,17.51,0.28
333,0,3364626,15830,144.99,30816.91,2,3367757,3131,3364626,15830,144.99,92.54,30816.91,1,15.72,17.51,0.58
334,0,3396654,32028,293.35,31110.25,2,3396654,0,3396654,32028,293.35,93.14,31110.25,0,15.27,17.51,0.12
335,0,3429439,32785,300.28,31410.53,2,3429439,0,3429439,32785,300.28,93.76,31410.53,1,16.88,17.51,0.42
336,0,3462705,33266,304.69,31715.22,2,3462705,0,3462705,33266,304.69,94.39,31715.22,1,16.81,17.51,0.02
337,0,3464066,1361,12.47,31727.69,2,3474449,10383,3464066,1361,12.47,94.15,31727.69,0,19.22,18.22,0.02
338,0,3464066,0,0.00,31727.69,2,3480268,16202,3464066,0,0.00,93.87,31727.69,0,19.23,18.23,0.30
339,0,3464066,0,0.00,31727.69,2,3484799,20733,3464066,0,0.00,93.59,31727.69,0,19.90,18.90,0.59
340,0,3464066,0,0.00,31727.69,2,3488685,24619,3464066,0,0.00,93.32,31727.69,1,20.23,19.23,0.88
341,0,3471038,6972,63.86,31791.54,2,3492171,21133,3471038,6972,63.86,93.23,31791.54,1,18.69,19.23,0.48
342,0,3478246,7208,66.02,31857.56,2,3495775,17529,3478246,7208,66.02,93.15,31857.56,0,17.39,19.23,0.11
343,0,3485874,7628,69.87,31927.43,2,3499589,13715,3485874,7628,69.87,93.08,31927.43,0,17.53,19.23,0.41
344,0,3495234,9360,85.73,32013.16,2,3504269,9035,3495234,9360,85.73,93.06,32013.16,1,17.60,19.23,0.70
345,0,3518271,23037,211.00,32224.15,2,3518271,0,3518271,23037,211.00,93.40,32224.15,1,15.92,19.23,0.13
346,0,3551255,32984,302.10,32526.26,2,3551255,0,3551255,32984,302.10,94.01,32526.26,0,15.77,19.23,0.08
347,0,3583874,32619,298.76,32825.02,2,3583874,0,3583874,32619,298.76,94.60,32825.02,1,17.26,19.23,0.37
348,0,3616413,32539,298.03,33123.05,2,3616413,0,3616413,32539,298.03,95.18,33123.05,0,18.34,19.23,0.37
349,0,3649215,32802,300.44,33423.48,2,3649215,0,3649215,32802,300.44,95.77,33423.48,1,18.63,19.23,0.29
350,0,3649215,0,0.00,33423.48,2,3659846,10631,3649215,0,0.00,95.50,33423.48,1,20.99,19.99,0.08
351,0,3649215,0,0.00,33423.48,2,3665538,16323,3649215,0,0.00,95.22,33423.48,0,21.59,19.00,0.08
352,0,3649215,0,0.00,33423.48,2,3669775,20560,3649215,0,0.00,94.95,33423.48,1,21.59,19.00,0.28
353,0,3649215,0,0.00,33423.48,2,3673464,24249,3649215,0,0.00,94.68,33423.48,0,20.38,19.38,0.28
354,0,3649215,0,0.00,33423.48,2,3676793,27578,3649215,0,0.00,94.42,33423.48,1,20.38,19.38,0.28
355,0,3655849,6634,60.76,33484.24,2,3680110,24261,3655849,6634,60.76,94.32,33484.24,0,19.01,19.38,0.28
356,0,3661993,6144,56.27,33540.52,2,3683182,21189,3661993,6144,56.27,94.21,33540.52,0,19.07,19.38,0.28
357,0,3668361,6368,58.33,33598.84,2,3686366,18005,3668361,6368,58.33,94.11,33598.84,1,19.24,19.38,0.56
358,0,3674763,6402,58.64,33657.48,2,3689567,14804,3674763,6402,58.64,94.02,33657.48,0,17.66,19.38,0.56
359,0,3682453,7690,70.43,33727.91,2,3693412,10959,3682453,7690,70.43,93.95,33727.91,0,17.72,19.38,0.28
360,0,3699623,17170,157.26,33885.17,2,3701997,2374,3699623,17170,157.26,94.13,33885.17,1,18.06,19.38,0.56
361,0,3731571,31948,292.61,34177.79,2,3731571,0,3731571,31948,292.61,94.68,34177.79,0,17.23,19.38,0.35
362,0,3763990,32419,296.93,34474.71,2,3763990,0,3763990,32419,296.93,95.23,34474.71,1,17.51,19.38,0.62
363,0,3796337,32347,296.27,34770.98,2,3796337,0,3796337,32347,296.27,95.79,34770.98,0,16.85,19.38,0.06
364,0,3796337,0,0.00,34770.98,2,3807122,10785,3796337,0,0.00,95.52,34770.98,1,21.54,19.00,0.34
365,0,3796337,0,0.00,34770.98,2,3812829,16492,3796337,0,0.00,95.26,34770.98,0,22.71,19.00,0.34
366,0,3796337,0,0.00,34770.98,2,3817618,21281,3796337,0,0.00,95.00,34770.98,1,22.71,19.00,0.27
367,0,3796337,0,0.00,34770.98,2,3821806,25469,3796337,0,0.00,94.74,34770.98,1,21.61,19.00,0.07
368,0,3796337,0,0.00,34770.98,2,3825525,29188,3796337,0,0.00,94.49,34770.98,0,21.00,20.00,0.01
369,0,3796337,0,0.00,34770.98,2,3828915,32578,3796337,0,0.00,94.23,34770.98,0,21.22,19.00,0.28
370,0,3796337,0,0.00,34770.98,2,3832014,35677,3796337,0,0.00,93.98,34770.98,1,21.22,19.00,0.55
371,0,3796337,0,0.00,34770.98,2,3834910,38573,3796337,0,0.00,93.72,34770.98,1,19.39,18.39,0.11
372,0,3796337,0,0.00,34770.98,2,3837636,41299,3796337,0,0.00,93.47,34770.98,1,18.43,17.43,0.00
373,0,3796337,0,0.00,34770.98,2,3840135,43798,3796337,0,0.00,93.22,34770.98,0,17.81,16.81,0.00
374,0,3796337,0,0.00,34770.98,2,3842363,46026,3796337,0,0.00,92.97,34770.98,1,17.81,16.81,0.27
375,0,3800815,4478,41.01,34812.00,2,3844602,43787,3800815,4478,41.01,92.83,34812.00,0,16.50,16.81,0.03
376,0,3805411,4596,42.10,34854.09,2,3846900,41489,3805411,4596,42.10,92.70,34854.09,1,16.54,16.81,0.30
377,0,3809999,4588,42.02,34896.12,2,3849194,39195,3809999,4588,42.02,92.56,34896.12,0,15.00,16.81,0.30
378,0,3814701,4702,43.07,34939.18,2,3851545,36844,3814701,4702,43.07,92.43,34939.18,1,15.04,16.81,0.27
379,0,3819377,4676,42.83,34982.01,2,3853883,34506,3819377,4676,42.83,92.30,34982.01,0,14.28,16.81,0.02
380,0,3824045,4668,42.75,35024.77,2,3856217,32172,3824045,4668,42.75,92.17,35024.77,1,15.00,16.81,0.28
381,0,3828591,4546,41.64,35066.40,2,3858490,29899,3828591,4546,41.64,92.04,35066.40,0,13.38,16.81,0.28
382,0,3833097,4506,41.27,35107.67,2,3860743,27646,3833097,4506,41.27,91.90,35107.67,1,13.42,16.81,0.26
383,0,3837561,4464,40.89,35148.56,2,3862975,25414,3837561,4464,40.89,91.77,35148.56,0,11.99,16.81,0.26
384,0,3841997,4436,40.63,35189.19,2,3865193,23196,3841997,4436,40.63,91.64,35189.19,1,12.03,16.81,0.26
385,0,3846575,4578,41.93,35231.12,2,3867482,20907,3846575,4578,41.93,91.51,35231.12,0,10.82,16.81,0.26
386,0,3851447,4872,44.62,35275.74,2,3869918,18471,3851447,4872,44.62,91.39,35275.74,1,10.87,16.81,0.26
387,0,3856571,5124,46.93,35322.67,2,3872480,15909,3856571,5124,46.93,91.27,35322.67,0,10.42,16.81,0.01
388,0,3862689,6118,56.04,35378.71,2,3875539,12850,3862689,6118,56.04,91.18,35378.71,0,10.76,16.81,0.27
389,0,3876589,13900,127.31,35506.02,2,3882489,5900,3876589,13900,127.31,91.28,35506.02,1,10.81,16.81,0.53
390,0,3907426,30837,282.44,35788.46,2,3907426,0,3907426,30837,282.44,91.77,35788.46,0,10.74,16.81,0.53
391,0,3940612,33186,303.95,36092.41,2,3940612,0,3940612,33186,303.95,92.31,36092.41,1,11.02,16.81,0.26
392,0,3973662,33050,302.71,36395.12,2,3973662,0,3973662,33050,302.71,92.84,36395.12,0,12.08,16.81,0.01
393,0,4006634,32972,301.99,36697.11,2,4006634,0,4006634,32972,301.99,93.38,36697.11,1,13.40,16.81,0.27
394,0,4039473,32839,300.78,36997.89,2,4039473,0,4039473,32839,300.78,93.90,36997.89,0,12.90,16.81,0.27
395,0,4072387,32914,301.46,37299.35,2,4072387,0,4072387,32914,301.46,94.43,37299.35,1,13.19,16.81,0.25
396,0,4105522,33135,303.49,37602.84,2,4105522,0,4105522,33135,303.49,94.96,37602.84,0,15.60,16.81,0.25
397,0,4138496,32974,302.01,37904.85,2,4138496,0,4138496,32974,302.01,95.48,37904.85,1,15.90,16.81,0.25
398,0,4147847,9351,85.65,37990.50,2,4156024,8177,4147847,9351,85.65,95.45,37990.50,0,18.05,17.05,0.25
399,0,4147847,0,0.00,37990.50,2,4162600,14753,4147847,0,0.00,95.21,37990.50,1,18.13,17.13,0.25
400,0,4147847,0,0.00,37990.50,2,4167156,19309,4147847,0,0.00,94.98,37990.50,0,17.40,16.40,0.02
401,0,4147847,0,0.00,37990.50,2,4171078,23231,4147847,0,0.00,94.74,37990.50,0,17.72,16.72,0.27
402,0,4147847,0,0.00,37990.50,2,4174608,26761,4147847,0,0.00,94.50,37990.50,1,18.30,17.30,0.52
403,0,4147847,0,0.00,37990.50,2,4178018,30171,4147847,0,0.00,94.27,37990.50,0,18.00,17.00,0.25
404,0,4147847,0,0.00,37990.50,2,4181222,33375,4147847,0,0.00,94.04,37990.50,1,18.00,17.00,0.50
405,0,4153943,6096,55.83,38046.33,2,4184270,30327,4153943,6096,55.83,93.94,38046.33,1,16.67,17.00,0.27
406,0,4159983,6040,55.32,38101.65,2,4187290,27307,4159983,6040,55.32,93.85,38101.65,0,16.05,17.00,0.17
407,0,4166009,6026,55.19,38156.84,2,4190303,24294,4166009,6026,55.19,93.75,38156.84,1,16.67,17.00,0.41
408,0,4171627,5618,51.46,38208.30,2,4193112,21485,4171627,5618,51.46,93.65,38208.30,1,16.64,17.00,0.22
409,0,4177145,5518,50.54,38258.84,2,4195871,18726,4177145,5518,50.54,93.54,38258.84,0,15.64,17.00,0.10
410,0,4182687,5542,50.76,38309.60,2,4198642,15955,4182687,5542,50.76,93.44,38309.60,1,15.69,17.00,0.35
411,0,4189275,6588,60.34,38369.94,2,4201936,12661,4189275,6588,60.34,93.36,38369.94,0,14.07,17.00,0.01
412,0,4202341,13066,119.67,38489.61,2,4208469,6128,4202341,13066,119.67,93.42,38489.61,1,14.68,17.00,0.25
413,0,4231417,29076,266.31,38755.92,2,4231417,0,4231417,29076,266.31,93.84,38755.92,0,15.15,17.00,0.10
414,0,4231417,0,0.00,38755.92,2,4242207,10790,4231417,0,0.00,93.61,38755.92,1,17.41,16.41,0.34
415,0,4234741,3324,30.44,38786.37,2,4249374,14633,4234741,3324,30.44,93.46,38786.37,0,17.33,16.33,0.34
416,0,4234741,0,0.00,38786.37,2,4254174,19433,4234741,0,0.00,93.24,38786.37,1,17.36,16.36,0.24
417,0,4242769,8028,73.53,38859.89,2,4258188,15419,4242769,8028,73.53,93.19,38859.89,0,16.10,16.36,0.05
418,0,4251817,9048,82.87,38942.77,2,4262712,10895,4251817,9048,82.87,93.16,38942.77,0,16.17,16.36,0.29
419,0,4251817,0,0.00,38942.77,2,4267033,15216,4251817,0,0.00,92.94,38942.77,1,17.98,16.98,0.53
420,0,4261501,9684,88.70,39031.46,2,4271875,10374,4261501,9684,88.70,92.93,39031.46,0,15.73,16.98,0.53
421,0,4282381,20880,191.24,39222.70,2,4282381,0,4282381,20880,191.24,93.17,39222.70,1,15.81,16.98,0.24
422,0,4315683,33302,305.02,39527.72,2,4315683,0,4315683,33302,305.02,93.67,39527.72,0,15.52,16.98,0.02
423,0,4348758,33075,302.94,39830.66,2,4348758,0,4348758,33075,302.94,94.16,39830.66,1,16.10,16.98,0.25
424,0,4368174,19416,177.83,40008.49,2,4374068,5894,4368174,19416,177.83,94.36,40008.49,0,17.89,16.89,0.25
425,0,4368174,0,0.00,40008.49,2,4382295,14121,4368174,0,0.00,94.14,40008.49,1,18.06,17.06,0.24
426,0,4368825,651,5.96,40014.45,2,4387619,18794,4368825,651,5.96,93.93,40014.45,0,18.25,17.25,0.24
427,0,4368825,0,0.00,40014.45,2,4392224,23399,4368825,0,0.00,93.71,40014.45,1,18.26,17.26,0.23
428,0,4377217,8392,76.86,40091.32,2,4396420,19203,4377217,8392,76.86,93.67,40091.32,0,16.93,17.26,0.03
429,0,4385475,8258,75.64,40166.95,2,4400549,15074,4385475,8258,75.64,93.63,40166.95,1,17.00,17.26,0.26
430,0,4393465,7990,73.18,40240.13,2,4404544,11079,4393465,7990,73.18,93.58,40240.13,0,16.63,17.26,0.26
431,0,4409163,15698,143.78,40383.91,2,4412393,3230,4409163,15698,143.78,93.70,40383.91,1,16.70,17.26,0.23
432,0,4440954,31791,291.18,40675.09,2,4440954,0,4440954,31791,291.18,94.16,40675.09,1,15.62,17.26,0.23
433,0,4473531,32577,298.38,40973.46,2,4473531,0,4473531,32577,298.38,94.63,40973.46,0,15.91,17.26,0.23
434,0,4473531,0,0.00,40973.46,2,4483905,10374,4473531,0,0.00,94.41,40973.46,1,17.66,16.66,0.46
435,0,4473531,0,0.00,40973.46,2,4489748,16217,4473531,0,0.00,94.19,40973.46,0,16.76,15.76,0.23
436,0,4473531,0,0.00,40973.46,2,4494429,20898,4473531,0,0.00,93.98,40973.46,1,18.49,17.49,0.46
437,0,4481831,8300,76.02,41049.48,2,4498579,16748,4481831,8300,76.02,93.93,41049.48,0,16.70,17.49,0.11
438,0,4490171,8340,76.39,41125.87,2,4502749,12578,4490171,8340,76.39,93.89,41125.87,1,16.77,17.49,0.34
439,0,4501273,11102,101.68,41227.55,2,4508300,7027,4501273,11102,101.68,93.91,41227.55,0,15.81,17.49,0.13
440,0,4527460,26187,239.85,41467.41,2,4527460,0,4527460,26187,239.85,94.24,41467.41,1,17.05,17.49,0.36
441,0,4559641,32181,294.75,41762.15,2,4559641,0,4559641,32181,294.75,94.70,41762.15,0,16.84,17.49,0.36
442,0,4589978,30337,277.86,42040.01,2,4589978,0,4589978,30337,277.86,95.11,42040.01,1,17.13,17.49,0.23
443,0,4598874,8896,81.48,42121.49,2,4606279,7405,4598874,8896,81.48,95.08,42121.49,0,19.03,18.03,0.23
444,0,4598874,0,0.00,42121.49,2,4613105,14231,4598874,0,0.00,94.87,42121.49,1,19.11,18.11,0.23
445,0,4603648,4774,43.73,42165.22,2,4618604,14956,4603648,4774,43.73,94.75,42165.22,0,19.23,18.23,0.23
446,0,4603648,0,0.00,42165.22,2,4622860,19212,4603648,0,0.00,94.54,42165.22,0,19.27,18.27,0.22
447,0,4603648,0,0.00,42165.22,2,4626528,22880,4603648,0,0.00,94.33,42165.22,1,19.56,18.56,0.45
448,0,4610428,6780,62.10,42227.32,2,4629918,19490,4610428,6780,62.10,94.26,42227.32,1,15.91,18.56,0.45
449,0,4617496,7068,64.74,42292.05,2,4633452,15956,4617496,7068,64.74,94.19,42292.05,0,15.97,18.56,0.22
450,0,4625666,8170,74.83,42366.88,2,4637537,11871,4625666,8170,74.83,94.15,42366.88,1,17.17,18.56,0.45
451,0,4639240,13574,124.33,42491.21,2,4644324,5084,4639240,13574,124.33,94.22,42491.21,0,15.97,18.56,0.09
452,0,4668991,29751,272.49,42763.70,2,4668991,0,4668991,29751,272.49,94.61,42763.70,1,16.21,18.56,0.31
453,0,4697453,28462,260.69,43024.39,2,4697453,0,4697453,28462,260.69,94.98,43024.39,0,16.46,18.56,0.31
454,0,4729119,31666,290.03,43314.42,2,4729119,0,4729119,31666,290.03,95.41,43314.42,0,16.71,18.56,0.22
455,0,4729119,0,0.00,43314.42,2,4739783,10664,4729119,0,0.00,95.20,43314.42,1,18.92,17.92,0.44
456,0,4748993,19874,182.03,43496.45,2,4749720,727,4748993,19874,182.03,95.39,43496.45,0,17.14,17.92,0.11
457,0,4748993,0,0.00,43496.45,2,4759560,10567,4748993,0,0.00,95.18,43496.45,1,18.82,17.82,0.33
458,0,4748993,0,0.00,43496.45,2,4764815,15822,4748993,0,0.00,94.97,43496.45,0,18.95,17.95,0.00
459,0,4748993,0,0.00,43496.45,2,4768258,19265,4748993,0,0.00,94.76,43496.45,0,18.95,17.95,0.22
460,0,4748993,0,0.00,43496.45,2,4771128,22135,4748993,0,0.00,94.56,43496.45,1,18.95,17.95,0.44
461,0,4755357,6364,58.29,43554.73,2,4774310,18953,4755357,6364,58.29,94.48,43554.73,1,17.37,17.95,0.17
462,0,4763045,7688,70.42,43625.15,2,4778154,15109,4763045,7688,70.42,94.43,43625.15,0,17.10,17.95,0.17
463,0,4772555,9510,87.10,43712.25,2,4782909,10354,4772555,9510,87.10,94.41,43712.25,1,17.17,17.95,0.22
464,0,4792415,19860,181.90,43894.15,2,4792839,424,4792415,19860,181.90,94.60,43894.15,0,16.59,17.95,0.22
465,0,4824295,31880,291.99,44186.14,2,4824295,0,4824295,31880,291.99,95.02,44186.14,1,16.77,17.95,0.22
466,0,4856082,31787,291.14,44477.28,2,4856082,0,4856082,31787,291.14,95.44,44477.28,1,17.06,17.95,0.07
467,0,4865261,9179,84.07,44561.36,2,4873398,8137,4865261,9179,84.07,95.42,44561.36,0,19.32,18.32,0.07
468,0,4865261,0,0.00,44561.36,2,4879962,14701,4865261,0,0.00,95.22,44561.36,1,19.40,18.40,0.21
469,0,4867124,1863,17.06,44578.42,2,4884870,17746,4867124,1863,17.06,95.05,44578.42,0,19.95,18.95,0.21
470,0,4867124,0,0.00,44578.42,2,4888710,21586,4867124,0,0.00,94.85,44578.42,0,19.97,18.97,0.21
471,0,4867124,0,0.00,44578.42,2,4892229,25105,4867124,0,0.00,94.65,44578.42,1,19.97,18.97,0.43
472,0,4873940,6816,62.43,44640.85,2,4895637,21697,4873940,6816,62.43,94.58,44640.85,1,18.68,18.97,0.15
473,0,4880226,6286,57.57,44698.42,2,4898780,18554,4880226,6286,57.57,94.50,44698.42,0,17.93,18.97,0.15
474,0,4887242,7016,64.26,44762.68,2,4902288,15046,4887242,7016,64.26,94.44,44762.68,1,17.98,18.97,0.21
475,0,4894946,7704,70.56,44833.24,2,4906140,11194,4894946,7704,70.56,94.39,44833.24,0,16.80,18.97,0.21
476,0,4911770,16824,154.09,44987.34,2,4914552,2782,4911770,16824,154.09,94.51,44987.34,1,16.87,18.97,0.21
477,0,4943611,31841,291.63,45278.97,2,4943611,0,4943611,31841,291.63,94.92,45278.97,0,16.19,18.97,0.21
478,0,4975498,31887,292.06,45571.02,2,4975498,0,4975498,31887,292.06,95.34,45571.02,0,16.48,18.97,0.21
479,0,5007606,32108,294.08,45865.11,2,5007606,0,5007606,32108,294.08,95.75,45865.11,1,17.95,18.97,0.42
480,0,5039638,32032,293.38,46158.49,2,5039638,0,5039638,32032,293.38,96.16,46158.49,0,17.98,18.97,0.23
481,0,5039638,0,0.00,46158.49,2,5050113,10475,5039638,0,0.00,95.96,46158.49,1,20.63,19.63,0.44
482,0,5039638,0,0.00,46158.49,2,5055772,16134,5039638,0,0.00,95.76,46158.49,1,19.88,18.88,0.07
483,0,5039638,0,0.00,46158.49,2,5060079,20441,5039638,0,0.00,95.57,46158.49,0,19.42,18.42,0.07
484,0,5039638,0,0.00,46158.49,2,5063949,24311,5039638,0,0.00,95.37,46158.49,1,19.42,18.42,0.21
485,0,5047328,7690,70.43,46228.92,2,5067794,20466,5047328,7690,70.43,95.32,46228.92,0,18.02,18.42,0.21
486,0,5054788,7460,68.33,46297.25,2,5071524,16736,5054788,7460,68.33,95.26,46297.25,0,18.09,18.42,0.21
487,0,5062346,7558,69.22,46366.47,2,5075303,12957,5062346,7558,69.22,95.21,46366.47,1,18.35,18.42,0.41
488,0,5072666,10320,94.52,46461.00,2,5080463,7797,5072666,10320,94.52,95.21,46461.00,0,16.93,18.42,0.14
489,0,5098758,26092,238.98,46699.97,2,5098758,0,5098758,26092,238.98,95.50,46699.97,1,17.30,18.42,0.34
490,0,5130430,31672,290.09,46990.06,2,5130430,0,5130430,31672,290.09,95.90,46990.06,0,16.75,18.42,0.10
491,0,5162322,31892,292.10,47282.16,2,5162322,0,5162322,31892,292.10,96.30,47282.16,1,18.25,18.42,0.31
492,0,5194369,32047,293.52,47575.68,2,5194369,0,5194369,32047,293.52,96.70,47575.68,1,16.97,18.42,0.06
493,0,5198469,4100,37.55,47613.23,2,5208205,9736,5198469,4100,37.55,96.58,47613.23,0,20.06,19.06,0.06
494,0,5198469,0,0.00,47613.23,2,5214474,16005,5198469,0,0.00,96.38,47613.23,0,20.09,19.09,0.20
495,0,5198469,0,0.00,47613.23,2,5219100,20631,5198469,0,0.00,96.19,47613.23,1,20.31,19.31,0.40
496,0,5198469,0,0.00,47613.23,2,5223318,24849,5198469,0,0.00,95.99,47613.23,1,21.31,19.00,0.16
497,0,5198469,0,0.00,47613.23,2,5227053,28584,5198469,0,0.00,95.80,47613.23,0,19.70,18.70,0.16
498,0,5198469,0,0.00,47613.23,2,5230434,31965,5198469,0,0.00,95.61,47613.23,0,19.70,18.70,0.20
499,0,5198469,0,0.00,47613.23,2,5233551,35082,5198469,0,0.00,95.42,47613.23,1,19.70,18.70,0.40
500,0,5204391,5922,54.24,47667.48,2,5236512,32121,5204391,5922,54.24,95.33,47667.48,0,18.42,18.70,0.18
501,0,5204391,0,0.00,47667.48,2,5239330,34939,5204391,0,0.00,95.14,47667.48,1,18.91,17.91,0.38
502,0,5209693,5302,48.56,47716.04,2,5241981,32288,5209693,5302,48.56,95.05,47716.04,0,17.24,17.91,0.12
503,0,5214927,5234,47.94,47763.98,2,5244598,29671,5214927,5234,47.94,94.96,47763.98,1,17.65,17.91,0.31
504,0,5220089,5162,47.28,47811.25,2,5247179,27090,5220089,5162,47.28,94.86,47811.25,1,16.46,17.91,0.09
505,0,5224901,4812,44.07,47855.33,2,5249585,24684,5224901,4812,44.07,94.76,47855.33,0,15.42,17.91,0.09
506,0,5229679,4778,43.76,47899.09,2,5251974,22295,5229679,4778,43.76,94.66,47899.09,0,15.46,17.91,0.20
507,0,5234625,4946,45.30,47944.39,2,5254447,19822,5234625,4946,45.30,94.56,47944.39,1,15.50,17.91,0.40
508,0,5239615,4990,45.70,47990.09,2,5256942,17327,5239615,4990,45.70,94.47,47990.09,1,14.21,17.91,0.16
509,0,5245271,5656,51.80,48041.90,2,5259770,14499,5245271,5656,51.80,94.38,48041.90,0,14.11,17.91,0.16
510,0,5254051,8780,80.42,48122.32,2,5264160,10109,5254051,8780,80.42,94.36,48122.32,1,14.16,17.91,0.20
511,0,5274540,20489,187.66,48309.98,2,5274540,0,5274540,20489,187.66,94.54,48309.98,0,12.83,17.91,0.01
512,0,5306771,32231,295.21,48605.18,2,5306771,0,5306771,32231,295.21,94.93,48605.18,1,14.62,17.91,0.20
513,0,5338380,31609,289.51,48894.69,2,5338380,0,5338380,31609,289.51,95.31,48894.69,0,16.64,17.91,0.20
514,0,5370022,31642,289.81,49184.50,2,5370022,0,5370022,31642,289.81,95.69,49184.50,1,16.92,17.91,0.19
515,0,5398655,28633,262.25,49446.76,2,5398655,0,5398655,28633,262.25,96.01,49446.76,0,17.20,17.91,0.00
516,0,5430326,31671,290.08,49736.84,2,5430326,0,5430326,31671,290.08,96.39,49736.84,0,17.46,17.91,0.20
517,0,5430326,0,0.00,49736.84,2,5440751,10425,5430326,0,0.00,96.20,49736.84,1,18.03,17.03,0.39
518,0,5449764,19438,178.03,49914.87,2,5450470,706,5449764,19438,178.03,96.36,49914.87,0,16.82,17.03,0.39
519,0,5481205,31441,287.97,50202.84,2,5481205,0,5481205,31441,287.97,96.73,50202.84,1,16.99,17.03,0.19
520,0,5481205,0,0.00,50202.84,2,5491706,10501,5481205,0,0.00,96.54,50202.84,0,17.95,16.95,0.02
521,0,5481205,0,0.00,50202.84,2,5497394,16189,5481205,0,0.00,96.36,50202.84,1,19.94,18.94,0.21
522,0,5486671,5466,50.06,50252.90,2,5502248,15577,5486671,5466,50.06,96.27,50252.90,0,19.64,18.64,0.21
523,0,5486671,0,0.00,50252.90,2,5506110,19439,5486671,0,0.00,96.09,50252.90,1,19.69,18.69,0.19
524,0,5493853,7182,65.78,50318.68,2,5509701,15848,5493853,7182,65.78,96.03,50318.68,0,18.25,18.69,0.19
525,0,5502353,8500,77.85,50396.54,2,5513951,11598,5502353,8500,77.85,95.99,50396.54,1,18.32,18.69,0.19
526,0,5510981,8628,79.02,50475.56,2,5521568,10587,5510981,8628,79.02,95.96,50475.56,0,18.87,17.87,0.19
527,0,5510981,0,0.00,50475.56,2,5527178,16197,5510981,0,0.00,95.78,50475.56,1,18.95,17.95,0.19
528,0,5518656,7675,70.30,50545.86,2,5532544,13888,5518656,7675,70.30,95.73,50545.86,0,18.74,17.74,0.19
529,0,5518656,0,0.00,50545.86,2,5536740,18084,5518656,0,0.00,95.55,50545.86,0,18.81,17.81,0.19
530,0,5518656,0,0.00,50545.86,2,5539375,20719,5518656,0,0.00,95.37,50545.86,1,19.40,18.40,0.38
531,0,5524590,5934,54.35,50600.21,2,5542342,17752,5524590,5934,54.35,95.29,50600.21,1,17.76,18.40,0.14
532,0,5532816,8226,75.34,50675.55,2,5546455,13639,5532816,8226,75.34,95.25,50675.55,0,16.69,18.40,0.03
533,0,5546104,13288,121.71,50797.25,2,5553099,6995,5546104,13288,121.71,95.30,50797.25,1,17.05,18.40,0.22
534,0,5571364,25260,231.36,51028.61,2,5571364,0,5571364,25260,231.36,95.56,51028.61,1,17.26,18.40,0.05
535,0,5596329,24965,228.66,51257.27,2,5598916,2587,5596329,24965,228.66,95.81,51257.27,0,18.68,17.68,0.05
536,0,5596329,0,0.00,51257.27,2,5607789,11460,5596329,0,0.00,95.63,51257.27,1,18.90,17.90,0.19
537,0,5597590,1261,11.55,51268.82,2,5613681,16091,5597590,1261,11.55,95.47,51268.82,0,19.01,18.01,0.19
538,0,5597590,0,0.00,51268.82,2,5618190,20600,5597590,0,0.00,95.30,51268.82,0,19.02,18.02,0.19
539,0,5597590,0,0.00,51268.82,2,5622295,24705,5597590,0,0.00,95.12,51268.82,1,19.02,18.02,0.37
540,0,5605226,7636,69.94,51338.76,2,5626113,20887,5605226,7636,69.94,95.07,51338.76,0,17.17,18.02,0.08
541,0,5605226,0,0.00,51338.76,2,5629511,24285,5605226,0,0.00,94.90,51338.76,1,18.10,17.10,0.27
542,0,5611386,6160,56.42,51395.18,2,5632591,21205,5611386,6160,56.42,94.83,51395.18,1,17.09,17.10,0.11
543,0,5617366,5980,54.77,51449.95,2,5635581,18215,5617366,5980,54.77,94.75,51449.95,0,15.82,17.10,0.11
544,0,5623768,6402,58.64,51508.59,2,5638782,15014,5623768,6402,58.64,94.68,51508.59,1,15.88,17.10,0.18
545,0,5631582,7814,71.57,51580.16,2,5642689,11107,5631582,7814,71.57,94.64,51580.16,0,14.88,17.10,0.18
546,0,5649430,17848,163.47,51743.63,2,5651613,2183,5649430,17848,163.47,94.77,51743.63,1,14.95,17.10,0.18
547,0,5681244,31814,291.39,52035.02,2,5681244,0,5681244,31814,291.39,95.13,52035.02,0,14.89,17.10,0.18
548,0,5712658,31414,287.72,52322.74,2,5712658,0,5712658,31414,287.72,95.48,52322.74,1,15.18,17.10,0.18
549,0,5744451,31793,291.19,52613.93,2,5744451,0,5744451,31793,291.19,95.84,52613.93,0,14.95,17.10,0.03
550,0,5776244,31793,291.19,52905.13,2,5776244,0,5776244,31793,291.19,96.19,52905.13,1,16.95,17.10,0.21
551,0,5776244,0,0.00,52905.13,2,5786737,10493,5776244,0,0.00,96.02,52905.13,0,17.46,16.46,0.21
552,0,5776244,0,0.00,52905.13,2,5792496,16252,5776244,0,0.00,95.84,52905.13,1,17.46,16.46,0.18
553,0,5776244,0,0.00,52905.13,2,5796564,20320,5776244,0,0.00,95.67,52905.13,0,16.91,15.91,0.18
554,0,5776244,0,0.00,52905.13,2,5800408,24164,5776244,0,0.00,95.50,52905.13,1,16.91,15.91,0.18
555,0,5783654,7410,67.87,52973.00,2,5804113,20459,5783654,7410,67.87,95.45,52973.00,0,15.69,15.91,0.18
556,0,5791122,7468,68.40,53041.40,2,5807847,16725,5791122,7468,68.40,95.40,53041.40,0,15.76,15.91,0.18
557,0,5791122,0,0.00,53041.40,2,5811348,20226,5791122,0,0.00,95.23,53041.40,1,15.96,14.96,0.36
558,0,5797398,6276,57.48,53098.88,2,5814486,17088,5797398,6276,57.48,95.16,53098.88,0,13.87,14.96,0.36
559,0,5804174,6776,62.06,53160.94,2,5817874,13700,5804174,6776,62.06,95.10,53160.94,1,13.92,14.96,0.18
560,0,5815126,10952,100.31,53261.25,2,5823350,8224,5815126,10952,100.31,95.11,53261.25,0,12.83,14.96,0.02
561,0,5837468,22342,204.63,53465.88,2,5837468,0,5837468,22342,204.63,95.30,53465.88,1,13.28,14.96,0.20
562,0,5869770,32302,295.86,53761.74,2,5869770,0,5869770,32302,295.86,95.66,53761.74,0,12.94,14.96,0.20
563,0,5901835,32065,293.69,54055.43,2,5901835,0,5901835,32065,293.69,96.01,54055.43,0,13.23,14.96,0.18
564,0,5934004,32169,294.64,54350.07,2,5934004,0,5934004,32169,294.64,96.37,54350.07,1,14.50,14.96,0.36
565,0,5965930,31926,292.41,54642.48,2,5965930,0,5965930,31926,292.41,96.71,54642.48,0,14.58,14.96,0.08
566,0,5965930,0,0.00,54642.48,2,5976514,10584,5965930,0,0.00,96.54,54642.48,1,19.36,18.36,0.25
567,0,5965930,0,0.00,54642.48,2,5982556,16626,5965930,0,0.00,96.37,54642.48,0,18.59,17.59,0.14
568,0,5965930,0,0.00,54642.48,2,5986858,20928,5965930,0,0.00,96.20,54642.48,1,18.59,17.59,0.32
569,0,5974180,8250,75.56,54718.04,2,5990983,16803,5974180,8250,75.56,96.17,54718.04,1,15.80,17.59,0.32
570,0,5982770,8590,78.68,54796.72,2,5995278,12508,5982770,8590,78.68,96.13,54796.72,0,15.88,17.59,0.18
571,0,5995358,12588,115.29,54912.01,2,6001572,6214,5995358,12588,115.29,96.17,54912.01,1,16.41,17.59,0.35
572,0,6024545,29187,267.33,55179.34,2,6024545,0,6024545,29187,267.33,96.47,55179.34,0,15.40,17.59,0.25
573,0,6055081,30536,279.68,55459.02,2,6055081,0,6055081,30536,279.68,96.79,55459.02,1,17.48,17.59,0.43
574,0,6055081,0,0.00,55459.02,2,6065670,10589,6055081,0,0.00,96.62,55459.02,1,18.46,17.46,0.29
575,0,6055081,0,0.00,55459.02,2,6071906,16825,6055081,0,0.00,96.45,55459.02,0,18.94,17.94,0.17
576,0,6055081,0,0.00,55459.02,2,6076708,21627,6055081,0,0.00,96.28,55459.02,1,19.23,18.23,0.34
577,0,6063345,8264,75.69,55534.71,2,6080840,17495,6063345,8264,75.69,96.25,55534.71,0,18.02,18.23,0.23
578,0,6063345,0,0.00,55534.71,2,6084472,21127,6063345,0,0.00,96.08,55534.71,0,19.53,18.53,0.40
579,0,6063345,0,0.00,55534.71,2,6087815,24470,6063345,0,0.00,95.91,55534.71,1,20.10,19.10,0.57
580,0,6069539,6194,56.73,55591.44,2,6090912,21373,6069539,6194,56.73,95.85,55591.44,1,18.29,19.10,0.32
581,0,6075649,6110,55.96,55647.41,2,6093967,18318,6075649,6110,55.96,95.78,55647.41,0,17.06,19.10,0.18
582,0,6081981,6332,58.00,55705.40,2,6097133,15152,6081981,6332,58.00,95.71,55705.40,1,17.11,19.10,0.35
583,0,6090011,8030,73.55,55778.95,2,6101148,11137,6090011,8030,73.55,95.68,55778.95,0,16.76,19.10,0.16
584,0,6108289,18278,167.41,55946.36,2,6110287,1998,6108289,18278,167.41,95.80,55946.36,1,17.60,19.10,0.33
585,0,6138532,30243,277.00,56223.36,2,6138532,0,6138532,30243,277.00,96.11,56223.36,0,16.27,19.10,0.15
586,0,6170262,31730,290.62,56513.97,2,6170262,0,6170262,31730,290.62,96.44,56513.97,1,18.01,19.10,0.32
587,0,6201876,31614,289.56,56803.53,2,6201876,0,6201876,31614,289.56,96.77,56803.53,0,17.76,19.10,0.13
588,0,6201876,0,0.00,56803.53,2,6212129,10253,6201876,0,0.00,96.60,56803.53,1,19.46,18.46,0.30
589,0,6201876,0,0.00,56803.53,2,6217669,15793,6201876,0,0.00,96.44,56803.53,0,19.26,18.26,0.03
590,0,6201876,0,0.00,56803.53,2,6222157,20281,6201876,0,0.00,96.28,56803.53,1,19.73,18.73,0.20
591,0,6210354,8478,77.65,56881.18,2,6226396,16042,6210354,8478,77.65,96.25,56881.18,0,18.27,18.73,0.03
592,0,6210354,0,0.00,56881.18,2,6230313,19959,6210354,0,0.00,96.08,56881.18,1,19.21,18.21,0.19
593,0,6217630,7276,66.64,56947.82,2,6233951,16321,6217630,7276,66.64,96.03,56947.82,0,17.22,18.21,0.19
594,0,6225602,7972,73.02,57020.84,2,6237937,12335,6225602,7972,73.02,95.99,57020.84,1,17.29,18.21,0.17
595,0,6238288,12686,116.19,57137.03,2,6244280,5992,6238288,12686,116.19,96.03,57137.03,0,16.11,18.21,0.01
596,0,6266821,28533,261.34,57398.37,2,6266821,0,6266821,28533,261.34,96.31,57398.37,1,16.41,18.21,0.18
597,0,6297948,31127,285.09,57683.46,2,6297948,0,6297948,31127,285.09,96.62,57683.46,0,16.60,18.21,0.18
598,0,6329384,31436,287.93,57971.39,2,6329384,0,6329384,31436,287.93,96.94,57971.39,0,16.88,18.21,0.17
599,0,6361554,32170,294.65,58266.04,2,6361554,0,6361554,32170,294.65,97.27,58266.04,1,18.11,18.21,0.33
600,0,6361554,0,0.00,58266.04,2,6371803,10249,6361554,0,0.00,97.11,58266.04,0,19.37,18.37,0.09
601,0,6361554,0,0.00,58266.04,2,6377285,15731,6361554,0,0.00,96.95,58266.04,1,19.37,18.37,0.26
602,0,6361554,0,0.00,58266.04,2,6381724,20170,6361554,0,0.00,96.79,58266.04,0,20.32,19.32,0.04
603,0,6361554,0,0.00,58266.04,2,6385656,24102,6361554,0,0.00,96.63,58266.04,1,20.33,19.33,0.21
604,0,6368868,7314,66.99,58333.02,2,6389313,20445,6368868,7314,66.99,96.58,58333.02,0,19.07,19.33,0.07
605,0,6368868,0,0.00,58333.02,2,6392743,23875,6368868,0,0.00,96.42,58333.02,1,19.74,18.74,0.24
606,0,6368868,0,0.00,58333.02,2,6395776,26908,6368868,0,0.00,96.26,58333.02,1,18.78,17.78,0.09
607,0,6374682,5814,53.25,58386.27,2,6398683,24001,6374682,5814,53.25,96.19,58386.27,0,17.55,17.78,0.09
608,0,6380186,5504,50.41,58436.69,2,6401435,21249,6380186,5504,50.41,96.11,58436.69,1,17.60,17.78,0.16
609,0,6385892,5706,52.26,58488.95,2,6404288,18396,6385892,5706,52.26,96.04,58488.95,0,16.46,17.78,0.00
610,0,6391902,6010,55.05,58543.99,2,6407293,15391,6391902,6010,55.05,95.97,58543.99,1,16.58,17.78,0.17
611,0,6399324,7422,67.98,58611.97,2,6411004,11680,6399324,7422,67.98,95.93,58611.97,0,15.06,17.78,0.17
612,0,6415556,16232,148.67,58760.64,2,6419120,3564,6415556,16232,148.67,96.01,58760.64,1,15.13,17.78,0.16
613,0,6445801,30245,277.02,59037.66,2,6445801,0,6445801,30245,277.02,96.31,59037.66,0,14.29,17.78,0.04
614,0,6475434,29633,271.41,59309.07,2,6475434,0,6475434,29633,271.41,96.59,59309.07,1,15.26,17.78,0.20
615,0,6502993,27559,252.42,59561.48,2,6502993,0,6502993,27559,252.42,96.85,59561.48,0,16.42,17.78,0.20
616,0,6530503,27510,251.97,59813.45,2,6530503,0,6530503,27510,251.97,97.10,59813.45,1,16.67,17.78,0.16
617,0,6558248,27745,254.12,60067.57,2,6558248,0,6558248,27745,254.12,97.35,60067.57,0,17.05,17.78,0.10
618,0,6558248,0,0.00,60067.57,2,6567950,9702,6558248,0,0.00,97.20,60067.57,1,20.61,19.61,0.26
619,0,6558248,0,0.00,60067.57,2,6573637,15389,6558248,0,0.00,97.04,60067.57,0,20.30,19.30,0.14
620,0,6558248,0,0.00,60067.57,2,6578012,19764,6558248,0,0.00,96.88,60067.57,1,20.40,19.40,0.30
621,0,6558248,0,0.00,60067.57,2,6581743,23495,6558248,0,0.00,96.73,60067.57,0,20.16,19.16,0.36
622,0,6558248,0,0.00,60067.57,2,6585098,26850,6558248,0,0.00,96.57,60067.57,1,20.28,19.28,0.52
623,0,6565034,6786,62.15,60129.73,2,6588491,23457,6565034,6786,62.15,96.52,60129.73,0,18.92,19.28,0.37
624,0,6571794,6760,61.92,60191.64,2,6591871,20077,6571794,6760,61.92,96.46,60191.64,1,19.17,19.28,0.53
625,0,6578046,6252,57.26,60248.90,2,6594997,16951,6578046,6252,57.26,96.40,60248.90,0,17.92,19.28,0.33
626,0,6584600,6554,60.03,60308.93,2,6598274,13674,6584600,6554,60.03,96.34,60308.93,0,18.09,19.28,0.49
627,0,6593472,8872,81.26,60390.19,2,6602710,9238,6593472,8872,81.26,96.32,60390.19,1,18.43,19.28,0.65
628,0,6616627,23155,212.08,60602.27,2,6616627,0,6616627,23155,212.08,96.50,60602.27,0,16.79,19.28,0.40
629,0,6644680,28053,256.94,60859.21,2,6644680,0,6644680,28053,256.94,96.76,60859.21,1,17.50,19.28,0.56
630,0,6672015,27335,250.36,61109.57,2,6672015,0,6672015,27335,250.36,97.00,61109.57,0,17.17,19.28,0.37
631,0,6672015,0,0.00,61109.57,2,6681685,9670,6672015,0,0.00,96.85,61109.57,1,19.80,18.80,0.53
632,0,6690749,18734,171.59,61281.16,2,6691052,303,6690749,18734,171.59,96.96,61281.16,0,18.15,18.80,0.30
633,0,6690749,0,0.00,61281.16,2,6700551,9802,6690749,0,0.00,96.81,61281.16,0,19.87,18.87,0.46
634,0,6690749,0,0.00,61281.16,2,6705794,15045,6690749,0,0.00,96.66,61281.16,1,21.29,19.00,0.62
635,0,6690749,0,0.00,61281.16,2,6709727,18978,6690749,0,0.00,96.51,61281.16,0,22.26,19.00,0.45
636,0,6690749,0,0.00,61281.16,2,6713294,22545,6690749,0,0.00,96.35,61281.16,1,22.36,19.00,0.60
637,0,6690749,0,0.00,61281.16,2,6716539,25790,6690749,0,0.00,96.20,61281.16,0,21.14,19.00,0.50
638,0,6690749,0,0.00,61281.16,2,6719516,28767,6690749,0,0.00,96.05,61281.16,1,21.36,19.00,0.65
639,0,6690749,0,0.00,61281.16,2,6722057,31308,6690749,0,0.00,95.90,61281.16,0,19.98,18.98,0.40
640,0,6690749,0,0.00,61281.16,2,6724625,33876,6690749,0,0.00,95.75,61281.16,1,20.04,19.04,0.55
641,0,6690749,0,0.00,61281.16,2,6727081,36332,6690749,0,0.00,95.60,61281.16,1,19.23,18.23,0.50
642,0,6695747,4998,45.78,61326.94,2,6729580,33833,6695747,4998,45.78,95.52,61326.94,0,18.21,18.23,0.42
643,0,6695747,0,0.00,61326.94,2,6732029,36282,6695747,0,0.00,95.38,61326.94,1,18.34,17.34,0.58
644,0,6700407,4660,42.68,61369.62,2,6734359,33952,6700407,4660,42.68,95.29,61369.62,1,16.93,17.34,0.43
645,0,6705005,4598,42.11,61411.73,2,6736658,31653,6705005,4598,42.11,95.21,61411.73,0,16.32,17.34,0.43
646,0,6709581,4576,41.91,61453.64,2,6738946,29365,6709581,4576,41.91,95.13,61453.64,1,16.47,17.34,0.59
647,0,6714131,4550,41.67,61495.32,2,6741221,27090,6714131,4550,41.67,95.05,61495.32,0,15.23,17.34,0.44
648,0,6718635,4504,41.25,61536.57,2,6743473,24838,6718635,4504,41.25,94.96,61536.57,1,15.52,17.34,0.59
649,0,6723147,4512,41.33,61577.89,2,6745729,22582,6723147,4512,41.33,94.88,61577.89,0,14.13,17.34,0.45
650,0,6727575,4428,40.56,61618.45,2,6747943,20368,6727575,4428,40.56,94.80,61618.45,0,14.35,17.34,0.60
651,0,6732347,4772,43.71,61662.16,2,6750329,17982,6732347,4772,43.71,94.72,61662.16,1,14.48,17.34,0.75
652,0,6737429,5082,46.55,61708.71,2,6752870,15441,6737429,5082,46.55,94.65,61708.71,1,12.68,17.34,0.52
653,0,6743585,6156,56.38,61765.09,2,6755948,12363,6743585,6156,56.38,94.59,61765.09,0,12.12,17.34,0.47
654,0,6756383,12798,117.22,61882.31,2,6762347,5964,6756383,12798,117.22,94.62,61882.31,1,12.39,17.34,0.63
655,0,6784856,28473,260.79,62143.09,2,6784856,0,6784856,28473,260.79,94.87,62143.09,0,12.15,17.34,0.52
656,0,6812393,27537,252.21,62395.31,2,6812393,0,6812393,27537,252.21,95.11,62395.31,1,12.68,17.34,0.67
657,0,6843755,31362,287.25,62682.55,2,6843755,0,6843755,31362,287.25,95.41,62682.55,0,13.71,17.34,0.61
658,0,6875438,31683,290.19,62972.74,2,6875438,0,6875438,31683,290.19,95.70,62972.74,0,16.53,17.34,0.76
659,0,6875438,0,0.00,62972.74,2,6885885,10447,6875438,0,0.00,95.56,62972.74,1,17.80,16.80,0.91
660,0,6895948,20510,187.85,63160.59,2,6896140,192,6895948,20510,187.85,95.70,63160.59,0,16.22,16.80,0.71
661,0,6895948,0,0.00,63160.59,2,6906590,10642,6895948,0,0.00,95.55,63160.59,1,16.90,15.90,0.86
662,0,6916172,20224,185.23,63345.83,2,6916702,530,6916172,20224,185.23,95.69,63345.83,1,15.87,15.90,0.77
663,0,6948710,32538,298.02,63643.85,2,6948710,0,6948710,32538,298.02,95.99,63643.85,0,15.64,15.90,0.69
664,0,6948710,0,0.00,63643.85,2,6959076,10366,6948710,0,0.00,95.85,63643.85,1,17.71,16.71,0.84
665,0,6948710,0,0.00,63643.85,2,6964931,16221,6948710,0,0.00,95.71,63643.85,0,17.43,16.43,0.74
666,0,6948710,0,0.00,63643.85,2,6969571,20861,6948710,0,0.00,95.56,63643.85,0,18.54,17.54,0.89
667,0,6948710,0,0.00,63643.85,2,6973721,25011,6948710,0,0.00,95.42,63643.85,1,18.54,17.54,1.04
668,0,6956000,7290,66.77,63710.62,2,6977366,21366,6956000,7290,66.77,95.38,63710.62,1,16.75,17.54,0.82
669,0,6956000,0,0.00,63710.62,2,6980626,24626,6956000,0,0.00,95.23,63710.62,0,17.62,16.62,0.79
670,0,6956000,0,0.00,63710.62,2,6983716,27716,6956000,0,0.00,95.09,63710.62,0,17.90,16.90,0.94
671,0,6956000,0,0.00,63710.62,2,6986585,30585,6956000,0,0.00,94.95,63710.62,1,17.90,16.90,1.09
672,0,6961418,5418,49.62,63760.24,2,6989294,27876,6961418,5418,49.62,94.88,63760.24,1,15.93,16.90,0.84
673,0,6966726,5308,48.62,63808.86,2,6991948,25222,6966726,5308,48.62,94.81,63808.86,0,15.03,16.90,0.79
674,0,6971990,5264,48.21,63857.07,2,6994580,22590,6971990,5264,48.21,94.74,63857.07,0,16.42,16.90,0.94
675,0,6971990,0,0.00,63857.07,2,6997094,25104,6971990,0,0.00,94.60,63857.07,0,17.04,16.04,1.08
676,0,6971990,0,0.00,63857.07,2,6999368,27378,6971990,0,0.00,94.46,63857.07,1,17.04,16.04,1.23
677,0,6976258,4268,39.09,63896.16,2,7001502,25244,6976258,4268,39.09,94.38,63896.16,1,14.80,16.04,0.92
678,0,6980528,4270,39.11,63935.27,2,7003637,23109,6980528,4270,39.11,94.30,63935.27,0,14.22,16.04,0.94
679,0,6985180,4652,42.61,63977.88,2,7005963,20783,6985180,4652,42.61,94.22,63977.88,0,14.26,16.04,1.08
680,0,6989832,4652,42.61,64020.49,2,7008289,18457,6989832,4652,42.61,94.15,64020.49,1,14.87,16.04,1.23
681,0,6994862,5030,46.07,64066.56,2,7010804,15942,6994862,5030,46.07,94.08,64066.56,1,14.01,16.04,1.02
682,0,7002516,7654,70.10,64136.66,2,7014631,12115,7002516,7654,70.10,94.04,64136.66,0,13.65,16.04,1.03
683,0,7018734,16218,148.54,64285.20,2,7022740,4006,7018734,16218,148.54,94.12,64285.20,1,13.72,16.04,1.17
684,0,7049903,31169,285.48,64570.68,2,7049903,0,7049903,31169,285.48,94.40,64570.68,1,13.32,16.04,1.07
685,0,7082573,32670,299.23,64869.91,2,7082573,0,7082573,32670,299.23,94.70,64869.91,0,13.52,16.04,1.07
686,0,7115229,32656,299.10,65169.01,2,7115229,0,7115229,32656,299.10,95.00,65169.01,0,14.84,16.04,1.21
687,0,7115229,0,0.00,65169.01,2,7125834,10605,7115229,0,0.00,94.86,65169.01,1,16.86,15.86,1.36
688,0,7115229,0,0.00,65169.01,2,7131630,16401,7115229,0,0.00,94.72,65169.01,1,16.53,15.53,1.19
689,0,7115229,0,0.00,65169.01,2,7136335,21106,7115229,0,0.00,94.58,65169.01,0,15.80,14.80,1.17
690,0,7115229,0,0.00,65169.01,2,7140142,24913,7115229,0,0.00,94.45,65169.01,1,16.05,15.05,1.31
691,0,7122427,7198,65.93,65234.94,2,7143741,21314,7122427,7198,65.93,94.41,65234.94,0,14.60,15.05,1.13
692,0,7129479,7052,64.59,65299.53,2,7147267,17788,7129479,7052,64.59,94.36,65299.53,1,14.67,15.05,1.28
693,0,7136813,7334,67.17,65366.70,2,7150934,14121,7136813,7334,67.17,94.32,65366.70,0,13.83,15.05,1.24
694,0,7145161,8348,76.46,65443.16,2,7155108,9947,7145161,8348,76.46,94.30,65443.16,1,13.90,15.05,1.38
695,0,7166483,21322,195.29,65638.45,2,7166483,0,7166483,21322,195.29,94.44,65638.45,0,12.27,15.05,1.16
696,0,7202984,36501,334.32,65972.77,2,7202984,0,7202984,36501,334.32,94.79,65972.77,1,13.07,15.05,1.30
697,0,7228864,25880,237.04,66209.80,2,7228864,0,7228864,25880,237.04,94.99,66209.80,0,14.12,15.05,1.26
698,0,7228864,0,0.00,66209.80,2,7237543,8679,7228864,0,0.00,94.86,66209.80,0,16.34,15.34,1.41
699,0,7228864,0,0.00,66209.80,2,7244013,15149,7228864,0,0.00,94.72,66209.80,1,16.92,15.92,1.55
700,0,7228864,0,0.00,66209.80,2,7248907,20043,7228864,0,0.00,94.59,66209.80,1,16.79,15.79,1.38
701,0,7228864,0,0.00,66209.80,2,7253117,24253,7228864,0,0.00,94.45,66209.80,0,15.84,14.84,1.32
702,0,7228864,0,0.00,66209.80,2,7256831,27967,7228864,0,0.00,94.32,66209.80,1,16.06,15.06,1.46
703,0,7228864,0,0.00,66209.80,2,7260117,31253,7228864,0,0.00,94.18,66209.80,1,16.69,15.69,1.43
704,0,7228864,0,0.00,66209.80,2,7263122,34258,7228864,0,0.00,94.05,66209.80,0,15.72,14.72,1.37
705,0,7228864,0,0.00,66209.80,2,7265451,36587,7228864,0,0.00,93.91,66209.80,1,15.96,14.96,1.51
706,0,7228864,0,0.00,66209.80,2,7267862,38998,7228864,0,0.00,93.78,66209.80,0,15.08,14.08,1.45
707,0,7228864,0,0.00,66209.80,2,7270235,41371,7228864,0,0.00,93.65,66209.80,0,15.08,14.08,1.59
708,0,7228864,0,0.00,66209.80,2,7272489,43625,7228864,0,0.00,93.52,66209.80,1,15.73,14.73,1.73
709,0,7233228,4364,39.97,66249.77,2,7274671,41443,7233228,4364,39.97,93.44,66249.77,0,14.17,14.73,1.55
710,0,7237550,4322,39.59,66289.36,2,7276832,39282,7237550,4322,39.59,93.37,66289.36,1,14.25,14.73,1.69
711,0,7241854,4304,39.42,66328.78,2,7278984,37130,7241854,4304,39.42,93.29,66328.78,0,12.41,14.73,1.47
712,0,7246096,4242,38.85,66367.63,2,7281105,35009,7246096,4242,38.85,93.21,66367.63,1,12.45,14.73,1.61
713,0,7250302,4206,38.52,66406.16,2,7283208,32906,7250302,4206,38.52,93.14,66406.16,0,11.08,14.73,1.44
714,0,7254470,4168,38.18,66444.33,2,7285292,30822,7254470,4168,38.18,93.06,66444.33,0,11.12,14.73,1.58
715,0,7258782,4312,39.49,66483.82,2,7287448,28666,7258782,4312,39.49,92.98,66483.82,1,11.16,14.73,1.72
716,0,7263098,4316,39.53,66523.35,2,7289606,26508,7263098,4316,39.53,92.91,66523.35,0,8.89,14.73,1.41
717,0,7267414,4316,39.53,66562.88,2,7291764,24350,7267414,4316,39.53,92.84,66562.88,1,8.93,14.73,1.55
718,0,7271752,4338,39.73,66602.62,2,7293933,22181,7271752,4338,39.73,92.76,66602.62,0,8.10,14.73,1.52
719,0,7276148,4396,40.26,66642.88,2,7296131,19983,7276148,4396,40.26,92.69,66642.88,1,8.55,14.73,1.66
720,0,7280214,4066,37.24,66680.12,2,7298164,17950,7280214,4066,37.24,92.61,66680.12,1,7.53,14.73,1.59
721,0,7285096,4882,44.71,66724.84,2,7300605,15509,7285096,4882,44.71,92.54,66724.84,0,6.78,14.73,1.57
722,0,7291812,6716,61.51,66786.35,2,7303963,12151,7291812,6716,61.51,92.50,66786.35,1,6.82,14.73,1.71
723,0,7305420,13608,124.64,66910.98,2,7310767,5347,7305420,13608,124.64,92.55,66910.98,0,6.28,14.73,1.73
724,0,7329870,24450,223.94,67134.92,2,7329870,0,7329870,24450,223.94,92.73,67134.92,1,7.24,14.73,1.87
725,0,7354219,24349,223.01,67357.94,2,7354219,0,7354219,24349,223.01,92.91,67357.94,0,7.58,14.73,1.71
726,0,7378102,23883,218.75,67576.69,2,7378102,0,7378102,23883,218.75,93.08,67576.69,1,9.62,14.73,1.84
727,0,7402229,24127,220.98,67797.66,2,7402229,0,7402229,24127,220.98,93.26,67797.66,0,10.90,14.73,1.84
728,0,7427748,25519,233.73,68031.40,2,7427748,0,7427748,25519,233.73,93.45,68031.40,1,11.84,14.73,1.98
729,0,7452085,24337,222.90,68254.30,2,7452085,0,7452085,24337,222.90,93.63,68254.30,0,10.69,14.73,1.77
730,0,7475166,23081,211.40,68465.70,2,7475166,0,7475166,23081,211.40,93.79,68465.70,1,10.91,14.73,1.91
731,0,7498876,23710,217.16,68682.87,2,7498876,0,7498876,23710,217.16,93.96,68682.87,0,10.51,14.73,1.88
732,0,7523979,25103,229.92,68912.79,2,7523979,0,7523979,25103,229.92,94.14,68912.79,1,11.71,14.73,2.02
733,0,7548245,24266,222.25,69135.04,2,7548245,0,7548245,24266,222.25,94.32,69135.04,0,11.60,14.73,1.81
734,0,7571299,23054,211.15,69346.20,2,7571299,0,7571299,23054,211.15,94.48,69346.20,1,12.50,14.73,1.95
735,0,7594874,23575,215.93,69562.12,2,7594874,0,7594874,23575,215.93,94.64,69562.12,0,13.47,14.73,1.91
736,0,7594874,0,0.00,69562.12,2,7604982,10108,7594874,0,0.00,94.51,69562.12,0,15.68,14.68,2.04
737,0,7594874,0,0.00,69562.12,2,7611321,16447,7594874,0,0.00,94.39,69562.12,1,15.68,14.68,2.17
738,0,7594874,0,0.00,69562.12,2,7616082,21208,7594874,0,0.00,94.26,69562.12,0,15.90,14.90,1.97
739,0,7594874,0,0.00,69562.12,2,7619842,24968,7594874,0,0.00,94.13,69562.12,1,15.90,14.90,2.10
740,0,7594874,0,0.00,69562.12,2,7623331,28457,7594874,0,0.00,94.00,69562.12,0,15.17,14.17,2.06
741,0,7594874,0,0.00,69562.12,2,7626667,31793,7594874,0,0.00,93.88,69562.12,1,16.38,15.38,2.19
742,0,7594874,0,0.00,69562.12,2,7629763,34889,7594874,0,0.00,93.75,69562.12,0,15.61,14.61,2.07
743,0,7594874,0,0.00,69562.12,2,7632656,37782,7594874,0,0.00,93.62,69562.12,0,15.61,14.61,2.20
744,0,7594874,0,0.00,69562.12,2,7635379,40505,7594874,0,0.00,93.50,69562.12,1,15.61,14.61,2.33
745,0,7600140,5266,48.23,69610.35,2,7638012,37872,7600140,5266,48.23,93.44,69610.35,0,14.34,14.61,2.23
746,0,7600140,0,0.00,69610.35,2,7640551,40411,7600140,0,0.00,93.31,69610.35,1,14.89,13.89,2.36
747,0,7600140,0,0.00,69610.35,2,7642925,42785,7600140,0,0.00,93.19,69610.35,0,14.93,13.93,2.29
748,0,7600140,0,0.00,69610.35,2,7645190,45050,7600140,0,0.00,93.06,69610.35,1,15.21,14.21,2.42
749,0,7604550,4410,40.39,69650.74,2,7647395,42845,7604550,4410,40.39,92.99,69650.74,0,13.81,14.21,2.29
750,0,7608552,4002,36.65,69687.40,2,7649396,40844,7608552,4002,36.65,92.92,69687.40,1,13.85,14.21,2.42
751,0,7612748,4196,38.43,69725.83,2,7651494,38746,7612748,4196,38.43,92.84,69725.83,0,12.83,14.21,2.36
752,0,7616916,4168,38.18,69764.01,2,7653578,36662,7616916,4168,38.18,92.77,69764.01,1,12.87,14.21,2.49
753,0,7621060,4144,37.96,69801.96,2,7655650,34590,7621060,4144,37.96,92.70,69801.96,0,12.17,14.21,2.43
754,0,7625040,3980,36.45,69838.41,2,7657640,32600,7625040,3980,36.45,92.62,69838.41,1,13.35,14.21,2.56
755,0,7629042,4002,36.65,69875.07,2,7659641,30599,7629042,4002,36.65,92.55,69875.07,0,12.84,14.21,2.49
756,0,7633006,3964,36.31,69911.38,2,7661623,28617,7633006,3964,36.31,92.48,69911.38,1,12.91,14.21,2.62
757,0,7636918,3912,35.83,69947.20,2,7663579,26661,7636918,3912,35.83,92.40,69947.20,0,11.72,14.21,2.53
758,0,7640888,3970,36.36,69983.57,2,7665564,24676,7640888,3970,36.36,92.33,69983.57,1,11.76,14.21,2.66
759,0,7645104,4216,38.61,70022.18,2,7667672,22568,7645104,4216,38.61,92.26,70022.18,0,11.01,14.21,2.64
760,0,7649506,4402,40.32,70062.50,2,7669873,20367,7649506,4402,40.32,92.19,70062.50,1,11.28,14.21,2.77
761,0,7654170,4664,42.72,70105.22,2,7672205,18035,7654170,4664,42.72,92.12,70105.22,1,10.85,14.21,2.75
762,0,7659286,5116,46.86,70152.08,2,7674763,15477,7659286,5116,46.86,92.06,70152.08,0,10.66,14.21,2.69
763,0,7667008,7722,70.73,70222.80,2,7678624,11616,7667008,7722,70.73,92.04,70222.80,1,11.33,14.21,2.81
764,0,7682382,15374,140.81,70363.62,2,7686311,3929,7682382,15374,140.81,92.10,70363.62,0,10.46,14.21,2.77
765,0,7713291,30909,283.10,70646.71,2,7713291,0,7713291,30909,283.10,92.35,70646.71,1,11.29,14.21,2.90
766,0,7742086,28795,263.74,70910.45,2,7742086,0,7742086,28795,263.74,92.57,70910.45,1,13.15,14.21,2.92
767,0,7770713,28627,262.20,71172.65,2,7770713,0,7770713,28627,262.20,92.79,71172.65,0,13.32,14.21,2.85
768,0,7770713,0,0.00,71172.65,2,7780695,9982,7770713,0,0.00,92.67,71172.65,1,14.39,13.39,2.98
769,0,7770713,0,0.00,71172.65,2,7786295,15582,7770713,0,0.00,92.55,71172.65,0,13.55,12.55,2.96
770,0,7770713,0,0.00,71172.65,2,7790781,20068,7770713,0,0.00,92.43,71172.65,0,13.55,12.55,3.09
771,0,7770713,0,0.00,71172.65,2,7794681,23968,7770713,0,0.00,92.31,71172.65,1,13.66,12.66,3.21
772,0,7770713,0,0.00,71172.65,2,7798242,27529,7770713,0,0.00,92.19,71172.65,0,12.86,11.86,3.13
773,0,7770713,0,0.00,71172.65,2,7801599,30886,7770713,0,0.00,92.07,71172.65,1,12.86,11.86,3.26
774,0,7770713,0,0.00,71172.65,2,7804718,34005,7770713,0,0.00,91.95,71172.65,0,11.90,10.90,3.21
775,0,7770713,0,0.00,71172.65,2,7807638,36925,7770713,0,0.00,91.84,71172.65,1,12.08,11.08,3.34
776,0,7770713,0,0.00,71172.65,2,7810027,39314,7770713,0,0.00,91.72,71172.65,0,11.68,10.68,3.32
777,0,7770713,0,0.00,71172.65,2,7812411,41698,7770713,0,0.00,91.60,71172.65,1,12.25,11.25,3.45
778,0,7770713,0,0.00,71172.65,2,7814770,44057,7770713,0,0.00,91.48,71172.65,0,11.31,10.31,3.40
779,0,7770713,0,0.00,71172.65,2,7817040,46327,7770713,0,0.00,91.36,71172.65,1,11.31,10.31,3.53
780,0,7770713,0,0.00,71172.65,2,7819227,48514,7770713,0,0.00,91.25,71172.65,0,10.34,9.34,3.48
781,0,7770713,0,0.00,71172.65,2,7821335,50622,7770713,0,0.00,91.13,71172.65,1,10.53,9.53,3.61
782,0,7770713,0,0.00,71172.65,2,7823376,52663,7770713,0,0.00,91.01,71172.65,0,9.69,8.69,3.58
783,0,7770713,0,0.00,71172.65,2,7825347,54634,7770713,0,0.00,90.90,71172.65,1,10.48,9.48,3.71
784,0,7770713,0,0.00,71172.65,2,7827262,56549,7770713,0,0.00,90.78,71172.65,1,10.02,9.02,3.65
785,0,7770713,0,0.00,71172.65,2,7829126,58413,7770713,0,0.00,90.67,71172.65,0,9.42,8.42,3.64
786,0,7770713,0,0.00,71172.65,2,7830947,60234,7770713,0,0.00,90.55,71172.65,1,9.42,8.42,3.76
787,0,7770713,0,0.00,71172.65,2,7832821,62108,7770713,0,0.00,90.44,71172.65,0,8.42,8.00,3.71
788,0,7774371,3658,33.50,71206.15,2,7834650,60279,7774371,3658,33.50,90.36,71206.15,1,8.57,9.57,3.83
789,0,7777847,3476,31.84,71237.98,2,7836388,58541,7777847,3476,31.84,90.29,71237.98,0,7.51,9.57,3.73
790,0,7781323,3476,31.84,71269.82,2,7838126,56803,7781323,3476,31.84,90.21,71269.82,1,7.54,9.57,3.85
791,0,7784767,3444,31.54,71301.37,2,7839848,55081,7784767,3444,31.54,90.14,71301.37,0,7.50,9.57,3.82
792,0,7787933,3166,29.00,71330.37,2,7841431,53498,7787933,3166,29.00,90.06,71330.37,1,8.04,9.57,3.95
793,0,7791199,3266,29.91,71360.28,2,7843064,51865,7791199,3266,29.91,89.99,71360.28,0,6.83,9.57,3.84
794,0,7794577,3378,30.94,71391.22,2,7844753,50176,7794577,3378,30.94,89.91,71391.22,1,7.03,9.57,3.96
795,0,7798027,3450,31.60,71422.82,2,7846478,48451,7798027,3450,31.60,89.84,71422.82,0,6.37,9.57,3.94
796,0,7801495,3468,31.76,71454.58,2,7848212,46717,7801495,3468,31.76,89.77,71454.58,1,6.40,9.57,4.06
797,0,7804935,3440,31.51,71486.09,2,7849932,44997,7804935,3440,31.51,89.69,71486.09,0,5.06,9.57,3.89
798,0,7808325,3390,31.05,71517.14,2,7851627,43302,7808325,3390,31.05,89.62,71517.14,1,5.09,9.57,4.01
799,0,7811695,3370,30.87,71548.00,2,7853312,41617,7811695,3370,30.87,89.55,71548.00,0,4.33,9.57,3.99
800,0,7815047,3352,30.70,71578.70,2,7854988,39941,7815047,3352,30.70,89.47,71578.70,1,4.63,9.57,4.11
801,0,7818381,3334,30.54,71609.24,2,7856655,38274,7818381,3334,30.54,89.40,71609.24,0,4.13,9.57,4.06
802,0,7821697,3316,30.37,71639.61,2,7858313,36616,7821697,3316,30.37,89.33,71639.61,1,4.66,9.57,4.18
803,0,7824993,3296,30.19,71669.80,2,7859961,34968,7824993,3296,30.19,89.25,71669.80,0,4.06,9.57,4.13
804,0,7828273,3280,30.04,71699.84,2,7861601,33328,7828273,3280,30.04,89.18,71699.84,1,4.09,9.57,4.25
805,0,7831535,3262,29.88,71729.72,2,7863232,31697,7831535,3262,29.88,89.11,71729.72,0,2.82,9.57,4.15
806,0,7834829,3294,30.17,71759.89,2,7864879,30050,7834829,3294,30.17,89.03,71759.89,0,3.02,9.57,4.27
807,0,7838235,3406,31.20,71791.09,2,7866582,28347,7838235,3406,31.20,88.96,71791.09,1,3.05,9.57,4.39
808,0,7841763,3528,32.31,71823.40,2,7868346,26583,7841763,3528,32.31,88.89,71823.40,0,1.65,9.57,4.26
809,0,7845425,3662,33.54,71856.94,2,7870177,24752,7845425,3662,33.54,88.82,71856.94,1,1.68,9.57,4.38
810,0,7849197,3772,34.55,71891.48,2,7872063,22866,7849197,3772,34.55,88.75,71891.48,1,1.02,9.57,4.31
811,0,7852943,3746,34.31,71925.80,2,7873936,20993,7852943,3746,34.31,88.69,71925.80,0,1.21,9.57,4.32
812,0,7856947,4004,36.67,71962.47,2,7875938,18991,7856947,4004,36.67,88.62,71962.47,1,1.86,9.57,4.44
813,0,7861615,4668,42.75,72005.23,2,7878272,16657,7861615,4668,42.75,88.57,72005.23,0,1.52,9.57,4.49
814,0,7868363,6748,61.81,72067.03,2,7881646,13283,7868363,6748,61.81,88.53,72067.03,1,1.67,9.57,4.61
815,0,7881351,12988,118.96,72185.99,2,7888140,6789,7881351,12988,118.96,88.57,72185.99,1,0.59,9.57,4.54
816,0,7909463,28112,257.48,72443.47,2,7909463,0,7909463,28112,257.48,88.78,72443.47,0,0.77,9.57,4.48
817,0,7943997,34534,316.30,72759.77,2,7943997,0,7943997,34534,316.30,89.06,72759.77,0,2.18,9.57,4.60
818,0,7978797,34800,318.74,73078.51,2,7978797,0,7978797,34800,318.74,89.34,73078.51,1,2.84,9.57,4.71
819,0,8013925,35128,321.74,73400.24,2,8013925,0,8013925,35128,321.74,89.62,73400.24,0,2.33,9.57,4.69
820,0,8048804,34879,319.46,73719.70,2,8048804,0,8048804,34879,319.46,89.90,73719.70,0,2.90,9.57,4.80
821,0,8083619,34815,318.87,74038.58,2,8083619,0,8083619,34815,318.87,90.18,74038.58,1,4.25,9.57,4.92
822,0,8118813,35194,322.34,74360.92,2,8118813,0,8118813,35194,322.34,90.46,74360.92,1,4.72,9.57,4.72
823,0,8153542,34729,318.09,74679.01,2,8153542,0,8153542,34729,318.09,90.74,74679.01,0,6.08,9.57,4.67
824,0,8187898,34356,314.67,74993.68,2,8187898,0,8187898,34356,314.67,91.01,74993.68,0,8.10,9.57,4.78
825,0,8187898,0,0.00,74993.68,2,8198592,10694,8187898,0,0.00,90.90,74993.68,1,10.50,9.50,4.90
826,0,8187898,0,0.00,74993.68,2,8204271,16373,8187898,0,0.00,90.79,74993.68,1,10.28,9.28,4.64
827,0,8187898,0,0.00,74993.68,2,8208713,20815,8187898,0,0.00,90.68,74993.68,0,9.49,8.49,4.63
828,0,8187898,0,0.00,74993.68,2,8212573,24675,8187898,0,0.00,90.57,74993.68,1,11.21,10.21,4.74
829,0,8195396,7498,68.67,75062.35,2,8216322,20926,8195396,7498,68.67,90.55,75062.35,0,9.88,10.21,4.59
830,0,8202996,7600,69.61,75131.96,2,8220122,17126,8202996,7600,69.61,90.52,75131.96,1,9.94,10.21,4.71
831,0,8210472,7476,68.47,75200.44,2,8223860,13388,8210472,7476,68.47,90.49,75200.44,0,8.72,10.21,4.61
832,0,8219116,8644,79.17,75279.61,2,8228182,9066,8219116,8644,79.17,90.48,75279.61,1,9.94,10.21,4.72
833,0,8240587,21471,196.65,75476.27,2,8240587,0,8240587,21471,196.65,90.61,75476.27,0,9.09,10.21,4.54
834,0,8274763,34176,313.02,75789.28,2,8274763,0,8274763,34176,313.02,90.87,75789.28,1,9.56,10.21,4.65
835,0,8274763,0,0.00,75789.28,2,8285747,10984,8274763,0,0.00,90.77,75789.28,0,11.71,10.71,4.56
836,0,8274763,0,0.00,75789.28,2,8291481,16718,8274763,0,0.00,90.66,75789.28,1,12.27,11.27,4.67
837,0,8274763,0,0.00,75789.28,2,8295975,21212,8274763,0,0.00,90.55,75789.28,0,12.28,11.28,4.51
838,0,8274763,0,0.00,75789.28,2,8300060,25297,8274763,0,0.00,90.44,75789.28,0,12.57,11.57,4.62
839,0,8274763,0,0.00,75789.28,2,8303667,28904,8274763,0,0.00,90.33,75789.28,1,12.57,11.57,4.74
840,0,8281601,6838,62.63,75851.91,2,8307086,25485,8281601,6838,62.63,90.30,75851.91,0,11.10,11.57,4.61
841,0,8281601,0,0.00,75851.91,2,8310273,28672,8281601,0,0.00,90.19,75851.91,1,12.58,11.58,4.73
842,0,8281601,0,0.00,75851.91,2,8313151,31550,8281601,0,0.00,90.09,75851.91,0,11.62,10.62,4.59
843,0,8281601,0,0.00,75851.91,2,8315839,34238,8281601,0,0.00,89.98,75851.91,1,11.62,10.62,4.70
844,0,8286573,4972,45.54,75897.45,2,8318325,31752,8286573,4972,45.54,89.93,75897.45,0,10.25,10.62,4.59
845,0,8291297,4724,43.27,75940.72,2,8320687,29390,8291297,4724,43.27,89.87,75940.72,1,10.36,10.62,4.71
846,0,8296025,4728,43.30,75984.02,2,8323051,27026,8296025,4728,43.30,89.82,75984.02,0,9.99,10.62,4.62
847,0,8300989,4964,45.47,76029.49,2,8325533,24544,8300989,4964,45.47,89.76,76029.49,1,10.60,10.62,4.74
848,0,8306005,5016,45.94,76075.43,2,8328041,22036,8306005,5016,45.94,89.71,76075.43,0,9.94,10.62,4.68
849,0,8311115,5110,46.80,76122.23,2,8330596,19481,8311115,5110,46.80,89.66,76122.23,1,10.12,10.62,4.79
850,0,8316465,5350,49.00,76171.23,2,8333271,16806,8316465,5350,49.00,89.61,76171.23,1,9.19,10.62,4.74
851,0,8322461,5996,54.92,76226.16,2,8336269,13808,8322461,5996,54.92,89.57,76226.16,0,8.23,10.62,4.69
852,0,8333519,11058,101.28,76327.44,2,8341798,8279,8333519,11058,101.28,89.59,76327.44,1,8.81,10.62,4.81
853,0,8360104,26585,243.49,76570.93,2,8360104,0,8360104,26585,243.49,89.77,76570.93,0,8.36,10.62,4.75
854,0,8394334,34230,313.52,76884.45,2,8394334,0,8394334,34230,313.52,90.03,76884.45,1,9.06,10.62,4.86
855,0,8428499,34165,312.92,77197.37,2,8428499,0,8428499,34165,312.92,90.29,77197.37,0,8.69,10.62,4.76
856,0,8461938,33439,306.27,77503.63,2,8461938,0,8461938,33439,306.27,90.54,77503.63,1,10.43,10.62,4.87
857,0,8461938,0,0.00,77503.63,2,8472636,10698,8461938,0,0.00,90.44,77503.63,0,12.56,11.56,4.92
858,0,8461938,0,0.00,77503.63,2,8478472,16534,8461938,0,0.00,90.33,77503.63,0,13.28,12.28,5.03
859,0,8461938,0,0.00,77503.63,2,8482885,20947,8461938,0,0.00,90.23,77503.63,0,13.28,12.28,5.14
860,0,8461938,0,0.00,77503.63,2,8486737,24799,8461938,0,0.00,90.12,77503.63,1,13.28,12.28,5.25
861,0,8469518,7580,69.43,77573.06,2,8490527,21009,8469518,7580,69.43,90.10,77573.06,0,11.27,12.28,5.01
862,0,8476970,7452,68.25,77641.31,2,8494253,17283,8476970,7452,68.25,90.07,77641.31,1,11.68,12.28,5.12
863,0,8476970,0,0.00,77641.31,2,8497733,20763,8476970,0,0.00,89.97,77641.31,1,10.98,9.98,5.10
864,0,8476970,0,0.00,77641.31,2,8500665,23695,8476970,0,0.00,89.86,77641.31,0,10.12,9.12,5.06
865,0,8476970,0,0.00,77641.31,2,8503277,26307,8476970,0,0.00,89.76,77641.31,1,10.12,9.12,5.17
866,0,8476970,0,0.00,77641.31,2,8505745,28775,8476970,0,0.00,89.66,77641.31,1,9.30,8.30,5.14
867,0,8476970,0,0.00,77641.31,2,8508107,31137,8476970,0,0.00,89.55,77641.31,0,9.70,8.70,5.19
868,0,8476970,0,0.00,77641.31,2,8510325,33355,8476970,0,0.00,89.45,77641.31,1,9.92,8.92,5.30
869,0,8481106,4136,37.88,77679.20,2,8512393,31287,8481106,4136,37.88,89.39,77679.20,0,8.88,8.92,5.24
870,0,8485154,4048,37.08,77716.27,2,8514417,29263,8485154,4048,37.08,89.33,77716.27,1,8.92,8.92,5.35
871,0,8489362,4208,38.54,77754.81,2,8516521,27159,8489362,4208,38.54,89.27,77754.81,0,8.28,8.92,5.35
872,0,8493728,4366,39.99,77794.80,2,8518704,24976,8493728,4366,39.99,89.21,77794.80,1,8.32,8.92,5.46
873,0,8498386,4658,42.66,77837.47,2,8521033,22647,8498386,4658,42.66,89.16,77837.47,0,7.64,8.92,5.39
874,0,8503510,5124,46.93,77884.40,2,8523595,20085,8503510,5124,46.93,89.11,77884.40,1,7.92,8.92,5.49
875,0,8508770,5260,48.18,77932.58,2,8526225,17455,8508770,5260,48.18,89.07,77932.58,0,7.33,8.92,5.41
876,0,8514706,5936,54.37,77986.95,2,8529193,14487,8514706,5936,54.37,89.03,77986.95,1,8.09,8.92,5.52
877,0,8524972,10266,94.03,78080.97,2,8534326,9354,8524972,10266,94.03,89.03,78080.97,0,6.78,8.92,5.41
878,0,8550032,25060,229.53,78310.50,2,8550032,0,8550032,25060,229.53,89.19,78310.50,0,6.87,8.92,5.52
879,0,8550032,0,0.00,78310.50,2,8560930,10898,8550032,0,0.00,89.09,78310.50,1,9.47,8.47,5.63
880,0,8550032,0,0.00,78310.50,2,8567073,17041,8550032,0,0.00,88.99,78310.50,0,8.98,8.00,5.54
881,0,8560558,10526,96.41,78406.91,2,8572336,11778,8560558,10526,96.41,89.00,78406.91,1,10.02,11.02,5.65
882,0,8576914,16356,149.81,78556.71,2,8580514,3600,8576914,16356,149.81,89.07,78556.71,0,9.92,11.02,5.56
883,0,8609446,32532,297.96,78854.67,2,8609446,0,8609446,32532,297.96,89.30,78854.67,1,10.75,11.02,5.67
884,0,8609446,0,0.00,78854.67,2,8620114,10668,8609446,0,0.00,89.20,78854.67,0,11.36,10.36,5.54
885,0,8609446,0,0.00,78854.67,2,8626109,16663,8609446,0,0.00,89.10,78854.67,1,12.33,11.33,5.65
886,0,8609446,0,0.00,78854.67,2,8630774,21328,8609446,0,0.00,89.00,78854.67,1,11.37,10.37,5.59
887,0,8618076,8630,79.04,78933.72,2,8635089,17013,8618076,8630,79.04,88.99,78933.72,0,10.17,10.37,5.51
888,0,8626684,8608,78.84,79012.56,2,8639393,12709,8626684,8608,78.84,88.98,79012.56,1,10.27,10.37,5.61
889,0,8637352,10668,97.71,79110.27,2,8644727,7375,8637352,10668,97.71,88.99,79110.27,0,9.10,10.37,5.51
890,0,8666354,29002,265.63,79375.90,2,8666354,0,8666354,29002,265.63,89.19,79375.90,0,9.42,10.37,5.62
891,0,8666354,0,0.00,79375.90,2,8677163,10809,8666354,0,0.00,89.09,79375.90,1,10.62,9.62,5.72
892,0,8689355,23001,210.67,79586.57,2,8689355,0,8689355,23001,210.67,89.22,79586.57,1,8.95,9.62,5.57
893,0,8724389,35034,320.88,79907.45,2,8724389,0,8724389,35034,320.88,89.48,79907.45,0,9.50,9.62,5.48
894,0,8724389,0,0.00,79907.45,2,8735170,10781,8724389,0,0.00,89.38,79907.45,0,11.63,10.63,5.58
895,0,8724389,0,0.00,79907.45,2,8740829,16440,8724389,0,0.00,89.28,79907.45,1,12.21,11.21,5.69
896,0,8735039,10650,97.54,80004.99,2,8746154,11115,8735039,10650,97.54,89.29,80004.99,1,10.91,11.21,5.55
897,0,8753727,18688,171.17,80176.16,2,8755498,1771,8753727,18688,171.17,89.38,80176.16,0,9.66,11.21,5.43
898,0,8786870,33143,303.56,80479.72,2,8786870,0,8786870,33143,303.56,89.62,80479.72,0,10.74,11.21,5.54
899,0,8786870,0,0.00,80479.72,2,8797461,10591,8786870,0,0.00,89.52,80479.72,1,12.18,11.18,5.64
900,0,8806068,19198,175.84,80655.55,2,8807060,992,8806068,19198,175.84,89.62,80655.55,0,10.78,11.18,5.53
901,0,8806068,0,0.00,80655.55,2,8817057,10989,8806068,0,0.00,89.52,80655.55,1,12.09,11.09,5.64
902,0,8806068,0,0.00,80655.55,2,8822172,16104,8806068,0,0.00,89.42,80655.55,1,12.83,11.83,5.57
903,0,8816084,10016,91.74,80747.29,2,8827180,11096,8816084,10016,91.74,89.42,80747.29,0,11.68,11.83,5.50
904,0,8816084,0,0.00,80747.29,2,8832191,16107,8816084,0,0.00,89.32,80747.29,0,12.12,11.12,5.60
905,0,8816084,0,0.00,80747.29,2,8835425,19341,8816084,0,0.00,89.22,80747.29,1,13.10,12.10,5.71
906,0,8822210,6126,56.11,80803.40,2,8838488,16278,8822210,6126,56.11,89.19,80803.40,0,11.97,12.10,5.61
907,0,8830442,8232,75.40,80878.80,2,8842604,12162,8830442,8232,75.40,89.17,80878.80,1,12.03,12.10,5.72
908,0,8845700,15258,139.75,81018.55,2,8850233,4533,8845700,15258,139.75,89.23,81018.55,0,11.48,12.10,5.64
909,0,8845700,0,0.00,81018.55,2,8858355,12655,8845700,0,0.00,89.13,81018.55,1,12.19,11.19,5.74
910,0,8845700,0,0.00,81018.55,2,8863158,17458,8845700,0,0.00,89.03,81018.55,1,11.35,10.35,5.66
911,0,8845700,0,0.00,81018.55,2,8866248,20548,8845700,0,0.00,88.93,81018.55,0,11.34,10.34,5.63
912,0,8845700,0,0.00,81018.55,2,8868756,23056,8845700,0,0.00,88.84,81018.55,1,11.34,10.34,5.73
913,0,8850952,5252,48.10,81066.65,2,8871382,20430,8850952,5252,48.10,88.79,81066.65,0,9.77,10.34,5.60
914,0,8857348,6396,58.58,81125.23,2,8874580,17232,8857348,6396,58.58,88.76,81125.23,1,9.81,10.34,5.70
915,0,8857348,0,0.00,81125.23,2,8877773,20425,8857348,0,0.00,88.66,81125.23,0,10.34,9.34,5.71
916,0,8857348,0,0.00,81125.23,2,8880407,23059,8857348,0,0.00,88.56,81125.23,0,10.46,9.46,5.81
917,0,8857348,0,0.00,81125.23,2,8882666,25318,8857348,0,0.00,88.47,81125.23,1,10.46,9.46,5.91
918,0,8861836,4488,41.11,81166.34,2,8884910,23074,8861836,4488,41.11,88.42,81166.34,0,8.48,9.46,5.72
919,0,8866880,5044,46.20,81212.54,2,8887432,20552,8866880,5044,46.20,88.37,81212.54,1,8.66,9.46,5.82
920,0,8872574,5694,52.15,81264.69,2,8890279,17705,8872574,5694,52.15,88.33,81264.69,1,8.56,9.46,5.88
921,0,8879266,6692,61.29,81325.98,2,8893625,14359,8879266,6692,61.29,88.30,81325.98,1,8.37,9.46,5.93
922,0,8888890,9624,88.15,81414.12,2,8898437,9547,8888890,9624,88.15,88.30,81414.12,0,8.81,9.46,5.98
923,0,8909403,20513,187.88,81602.01,2,8909403,0,8909403,20513,187.88,88.41,81602.01,1,8.91,9.46,6.08
924,0,8909403,0,0.00,81602.01,2,8920623,11220,8909403,0,0.00,88.31,81602.01,0,9.83,8.83,6.12
925,0,8909403,0,0.00,81602.01,2,8926625,17222,8909403,0,0.00,88.22,81602.01,1,10.08,9.08,6.22
926,0,8909403,0,0.00,81602.01,2,8930971,21568,8909403,0,0.00,88.12,81602.01,0,10.26,9.26,6.18
927,0,8909403,0,0.00,81602.01,2,8934942,25539,8909403,0,0.00,88.03,81602.01,0,10.26,9.26,6.28
928,0,8909403,0,0.00,81602.01,2,8938555,29152,8909403,0,0.00,87.93,81602.01,1,10.84,9.84,6.38
929,0,8916263,6860,62.83,81664.84,2,8941985,25722,8916263,6860,62.83,87.91,81664.84,0,9.81,9.84,6.29
930,0,8916263,0,0.00,81664.84,2,8945224,28961,8916263,0,0.00,87.81,81664.84,1,9.87,8.87,6.39
931,0,8922295,6032,55.25,81720.09,2,8948240,25945,8922295,6032,55.25,87.78,81720.09,0,8.81,8.87,6.31
932,0,8922295,0,0.00,81720.09,2,8951093,28798,8922295,0,0.00,87.68,81720.09,1,9.07,8.07,6.41
933,0,8927407,5112,46.82,81766.91,2,8953649,26242,8927407,5112,46.82,87.64,81766.91,0,7.98,8.07,6.34
934,0,8932707,5300,48.54,81815.45,2,8956299,23592,8932707,5300,48.54,87.60,81815.45,1,8.02,8.07,6.44
935,0,8937921,5214,47.76,81863.20,2,8958906,20985,8937921,5214,47.76,87.55,81863.20,0,7.37,8.07,6.40
936,0,8942919,4998,45.78,81908.98,2,8961405,18486,8942919,4998,45.78,87.51,81908.98,1,7.45,8.07,6.50
937,0,8948371,5452,49.94,81958.92,2,8964131,15760,8948371,5452,49.94,87.47,81958.92,0,6.78,8.07,6.46
938,0,8955273,6902,63.22,82022.13,2,8967582,12309,8955273,6902,63.22,87.44,82022.13,0,7.02,8.07,6.56
939,0,8970955,15682,143.63,82165.77,2,8975423,4468,8970955,15682,143.63,87.50,82165.77,1,7.23,8.07,6.66
940,0,9003299,32344,296.24,82462.01,2,9003299,0,9003299,32344,296.24,87.73,82462.01,0,6.64,8.07,6.54
941,0,9003299,0,0.00,82462.01,2,9014363,11064,9003299,0,0.00,87.63,82462.01,1,8.10,8.00,6.64
942,0,9025711,22412,205.27,82667.28,2,9025711,0,9025711,22412,205.27,87.76,82667.28,0,7.65,8.00,6.62
943,0,9061146,35435,324.55,82991.84,2,9061146,0,9061146,35435,324.55,88.01,82991.84,1,7.96,8.00,6.72
944,0,9095912,34766,318.42,83310.26,2,9095912,0,9095912,34766,318.42,88.25,83310.26,1,8.24,9.24,6.61
945,0,9095912,0,0.00,83310.26,2,9107008,11096,9095912,0,0.00,88.16,83310.26,0,9.54,8.54,6.56
946,0,9095912,0,0.00,83310.26,2,9112824,16912,9095912,0,0.00,88.07,83310.26,1,9.74,8.74,6.66
947,0,9106800,10888,99.72,83409.98,2,9118268,11468,9106800,10888,99.72,88.08,83409.98,0,8.47,8.74,6.57
948,0,9106800,0,0.00,83409.98,2,9122901,16101,9106800,0,0.00,87.99,83409.98,0,9.03,8.03,6.67
949,0,9106800,0,0.00,83409.98,2,9126639,19839,9106800,0,0.00,87.89,83409.98,1,9.03,8.03,6.77
950,0,9113692,6892,63.12,83473.11,2,9130085,16393,9113692,6892,63.12,87.87,83473.11,1,7.73,8.03,6.68
951,0,9122272,8580,78.58,83551.70,2,9134375,12103,9122272,8580,78.58,87.86,83551.70,0,6.86,8.03,6.62
952,0,9139482,17210,157.63,83709.32,2,9142980,3498,9139482,17210,157.63,87.93,83709.32,1,7.55,8.03,6.71
953,0,9173963,34481,315.81,84025.13,2,9173963,0,9173963,34481,315.81,88.17,84025.13,0,6.68,8.03,6.63
954,0,9173963,0,0.00,84025.13,2,9184710,10747,9173963,0,0.00,88.08,84025.13,1,8.97,8.00,6.73
955,0,9194093,20130,184.37,84209.51,2,9194775,682,9194093,20130,184.37,88.18,84209.51,0,9.15,10.15,6.65
956,0,9194093,0,0.00,84209.51,2,9204820,10727,9194093,0,0.00,88.09,84209.51,1,10.18,9.18,6.75
957,0,9194093,0,0.00,84209.51,2,9210079,15986,9194093,0,0.00,87.99,84209.51,0,9.71,8.71,6.66
958,0,9194093,0,0.00,84209.51,2,9213543,19450,9194093,0,0.00,87.90,84209.51,0,10.18,9.18,6.76
959,0,9194093,0,0.00,84209.51,2,9216472,22379,9194093,0,0.00,87.81,84209.51,1,10.34,9.34,6.86
960,0,9200237,6144,56.27,84265.78,2,9219544,19307,9200237,6144,56.27,87.78,84265.78,1,8.51,9.34,6.69
961,0,9207559,7322,67.06,84332.84,2,9223205,15646,9207559,7322,67.06,87.76,84332.84,0,8.61,9.34,6.71
962,0,9207559,0,0.00,84332.84,2,9226831,19272,9207559,0,0.00,87.66,84332.84,0,9.65,8.65,6.80
963,0,9207559,0,0.00,84332.84,2,9229732,22173,9207559,0,0.00,87.57,84332.84,1,9.65,8.65,6.90
964,0,9212971,5412,49.57,84382.41,2,9232438,19467,9212971,5412,49.57,87.53,84382.41,0,8.47,8.65,6.83
965,0,9218807,5836,53.45,84435.87,2,9235356,16549,9218807,5836,53.45,87.50,84435.87,1,8.52,8.65,6.92
966,0,9218807,0,0.00,84435.87,2,9238271,19464,9218807,0,0.00,87.41,84435.87,0,8.83,8.00,6.87
967,0,9224537,5730,52.48,84488.34,2,9241136,16599,9224537,5730,52.48,87.37,84488.34,1,9.43,10.43,6.97
968,0,9232479,7942,72.74,84561.09,2,9245107,12628,9232479,7942,72.74,87.36,84561.09,1,8.78,10.43,6.96
969,0,9246917,14438,132.24,84693.33,2,9252326,5409,9246917,14438,132.24,87.40,84693.33,0,8.27,10.43,6.97
970,0,9277121,30204,276.64,84969.97,2,9277121,0,9277121,30204,276.64,87.60,84969.97,1,9.35,10.43,7.07
971,0,9311139,34018,311.57,85281.54,2,9311139,0,9311139,34018,311.57,87.83,85281.54,0,9.05,10.43,7.02
972,0,9344198,33059,302.79,85584.34,2,9344198,0,9344198,33059,302.79,88.05,85584.34,1,10.35,10.43,7.12
973,0,9344198,0,0.00,85584.34,2,9354812,10614,9344198,0,0.00,87.96,85584.34,0,11.14,10.14,7.05
974,0,9344198,0,0.00,85584.34,2,9360531,16333,9344198,0,0.00,87.87,85584.34,1,12.29,11.29,7.15
975,0,9354464,10266,94.03,85678.36,2,9365664,11200,9354464,10266,94.03,87.88,85678.36,0,10.97,11.29,7.04
976,0,9354464,0,0.00,85678.36,2,9370357,15893,9354464,0,0.00,87.79,85678.36,1,11.86,10.86,7.14
977,0,9363644,9180,84.08,85762.44,2,9374947,11303,9363644,9180,84.08,87.78,85762.44,0,10.71,10.86,7.07
978,0,9363644,0,0.00,85762.44,2,9379455,15811,9363644,0,0.00,87.69,85762.44,0,10.94,9.94,7.17
979,0,9363644,0,0.00,85762.44,2,9382669,19025,9363644,0,0.00,87.60,85762.44,1,11.78,10.78,7.26
980,0,9370084,6440,58.98,85821.42,2,9385889,15805,9370084,6440,58.98,87.57,85821.42,0,10.18,10.78,7.13
981,0,9379822,9738,89.19,85910.62,2,9390758,10936,9379822,9738,89.19,87.57,85910.62,1,10.29,10.78,7.22
982,0,9398526,18704,171.31,86081.93,2,9400110,1584,9398526,18704,171.31,87.66,86081.93,0,8.99,10.78,7.09
983,0,9431379,32853,300.90,86382.83,2,9431379,0,9431379,32853,300.90,87.88,86382.83,0,9.45,10.78,7.19
984,0,9431379,0,0.00,86382.83,2,9442135,10756,9431379,0,0.00,87.79,86382.83,1,10.82,9.82,7.28
985,0,9431379,0,0.00,86382.83,2,9448013,16634,9431379,0,0.00,87.70,86382.83,0,9.87,8.87,7.15
986,0,9431379,0,0.00,86382.83,2,9452576,21197,9431379,0,0.00,87.61,86382.83,1,10.22,9.22,7.24
987,0,9439919,8540,78.22,86461.05,2,9456846,16927,9439919,8540,78.22,87.60,86461.05,1,8.92,9.22,7.16
988,0,9448843,8924,81.74,86542.79,2,9461308,12465,9448843,8924,81.74,87.59,86542.79,0,7.73,9.22,7.07
989,0,9461777,12934,118.46,86661.25,2,9467775,5998,9461777,12934,118.46,87.63,86661.25,1,7.81,9.22,7.17
990,0,9492657,30880,282.83,86944.09,2,9492657,0,9492657,30880,282.83,87.82,86944.09,1,6.66,9.22,7.09
991,0,9527573,34916,319.80,87263.88,2,9527573,0,9527573,34916,319.80,88.06,87263.88,0,6.53,9.22,7.02
992,0,9527573,0,0.00,87263.88,2,9538561,10988,9527573,0,0.00,87.97,87263.88,1,9.27,8.27,7.12
993,0,9527573,0,0.00,87263.88,2,9544265,16692,9527573,0,0.00,87.88,87263.88,0,11.32,10.32,7.04
994,0,9527573,0,0.00,87263.88,2,9548654,21081,9527573,0,0.00,87.79,87263.88,1,11.32,10.32,7.13
995,0,9527573,0,0.00,87263.88,2,9552643,25070,9527573,0,0.00,87.70,87263.88,0,11.00,10.00,7.06
996,0,9527573,0,0.00,87263.88,2,9556190,28617,9527573,0,0.00,87.61,87263.88,1,11.36,10.36,7.15
997,0,9534287,6714,61.49,87325.38,2,9559547,25260,9534287,6714,61.49,87.59,87325.38,0,10.01,10.36,7.06
998,0,9540943,6656,60.96,87386.34,2,9562875,21932,9540943,6656,60.96,87.56,87386.34,0,10.19,10.36,7.15
999,0,9540943,0,0.00,87386.34,2,9565995,25052,9540943,0,0.00,87.47,87386.34,1,10.67,9.67,7.25
1000,0,9540943,0,0.00,87386.34,2,9568641,27698,9540943,0,0.00,87.39,87386.34,1,9.93,8.93,7.17
1001,0,9540943,0,0.00,87386.34,2,9571048,30105,9540943,0,0.00,87.30,87386.34,0,8.99,8.00,7.10
1002,0,9545685,4742,43.43,87429.77,2,9573419,27734,9545685,4742,43.43,87.26,87429.77,1,8.99,9.99,7.19
1003,0,9550433,4748,43.49,87473.26,2,9575793,25360,9550433,4748,43.49,87.21,87473.26,0,7.84,9.99,7.12
1004,0,9555105,4672,42.79,87516.05,2,9578129,23024,9555105,4672,42.79,87.17,87516.05,1,8.21,9.99,7.21
1005,0,9559879,4774,43.73,87559.77,2,9580516,20637,9559879,4774,43.73,87.12,87559.77,0,7.83,9.99,7.13
1006,0,9564823,4944,45.28,87605.05,2,9582988,18165,9564823,4944,45.28,87.08,87605.05,0,7.87,9.99,7.22
1007,0,9570635,5812,53.23,87658.29,2,9585894,15259,9570635,5812,53.23,87.05,87658.29,0,8.21,9.99,7.32
1008,0,9579803,9168,83.97,87742.26,2,9590478,10675,9579803,9168,83.97,87.05,87742.26,1,8.26,9.99,7.41
1009,0,9601847,22044,201.90,87944.16,2,9601847,0,9601847,22044,201.90,87.16,87944.16,1,7.07,9.99,7.27
1010,0,9637677,35830,328.17,88272.34,2,9637677,0,9637677,35830,328.17,87.40,88272.34,0,7.46,9.99,7.27
1011,0,9672434,34757,318.34,88590.67,2,9672434,0,9672434,34757,318.34,87.63,88590.67,1,8.74,9.99,7.36
1012,0,9707129,34695,317.77,88908.45,2,9707129,0,9707129,34695,317.77,87.85,88908.45,0,8.69,9.99,7.26
1013,0,9707129,0,0.00,88908.45,2,9718383,11254,9707129,0,0.00,87.77,88908.45,0,10.76,9.76,7.35
1014,0,9707129,0,0.00,88908.45,2,9724415,17286,9707129,0,0.00,87.68,88908.45,1,12.94,11.94,7.45
1015,0,9707129,0,0.00,88908.45,2,9728829,21700,9707129,0,0.00,87.59,88908.45,0,12.36,11.36,7.44
1016,0,9707129,0,0.00,88908.45,2,9732521,25392,9707129,0,0.00,87.51,88908.45,1,12.52,11.52,7.53
1017,0,9707129,0,0.00,88908.45,2,9735974,28845,9707129,0,0.00,87.42,88908.45,0,11.53,10.53,7.49
1018,0,9707129,0,0.00,88908.45,2,9739140,32011,9707129,0,0.00,87.34,88908.45,1,11.66,10.66,7.58
1019,0,9713265,6136,56.20,88964.65,2,9742208,28943,9713265,6136,56.20,87.31,88964.65,0,10.37,10.66,7.49
1020,0,9719409,6144,56.27,89020.92,2,9745280,25871,9719409,6144,56.27,87.28,89020.92,1,10.42,10.66,7.58
1021,0,9725509,6100,55.87,89076.80,2,9748330,22821,9725509,6100,55.87,87.24,89076.80,1,9.58,10.66,7.56
1022,0,9731647,6138,56.22,89133.02,2,9751399,19752,9731647,6138,56.22,87.21,89133.02,0,8.59,10.66,7.51
1023,0,9737489,5842,53.51,89186.52,2,9754320,16831,9737489,5842,53.51,87.18,89186.52,1,9.06,10.66,7.60
1024,0,9743763,6274,57.46,89243.98,2,9757457,13694,9743763,6274,57.46,87.15,89243.98,1,8.30,10.66,7.54
1025,0,9753377,9614,88.06,89332.04,2,9762264,8887,9753377,9614,88.06,87.15,89332.04,0,7.87,10.66,7.55
1026,0,9777920,24543,224.79,89556.83,2,9777920,0,9777920,24543,224.79,87.29,89556.83,1,7.96,10.66,7.64
1027,0,9812199,34279,313.96,89870.80,2,9812199,0,9812199,34279,313.96,87.51,89870.80,0,8.51,10.66,7.57
1028,0,9812199,0,0.00,89870.80,2,9823263,11064,9812199,0,0.00,87.42,89870.80,1,11.02,10.02,7.66
1029,0,9812199,0,0.00,89870.80,2,9828728,16529,9812199,0,0.00,87.34,89870.80,1,10.54,9.54,7.59
1030,0,9812199,0,0.00,89870.80,2,9833165,20966,9812199,0,0.00,87.25,89870.80,0,10.83,9.83,7.56
1031,0,9812199,0,0.00,89870.80,2,9837056,24857,9812199,0,0.00,87.17,89870.80,1,11.20,10.20,7.65
1032,0,9812199,0,0.00,89870.80,2,9840564,28365,9812199,0,0.00,87.08,89870.80,0,11.21,10.21,7.61
1033,0,9812199,0,0.00,89870.80,2,9843658,31459,9812199,0,0.00,87.00,89870.80,0,11.56,10.56,7.70
1034,0,9812199,0,0.00,89870.80,2,9846432,34233,9812199,0,0.00,86.92,89870.80,1,11.75,10.75,7.79
1035,0,9812199,0,0.00,89870.80,2,9849180,36981,9812199,0,0.00,86.83,89870.80,0,10.97,9.97,7.70
1036,0,9812199,0,0.00,89870.80,2,9851770,39571,9812199,0,0.00,86.75,89870.80,1,10.97,9.97,7.79
1037,0,9817235,5036,46.13,89916.92,2,9854288,37053,9817235,5036,46.13,86.71,89916.92,0,9.88,9.97,7.63
1038,0,9817235,0,0.00,89916.92,2,9856604,39369,9817235,0,0.00,86.63,89916.92,0,10.27,9.27,7.72
1039,0,9817235,0,0.00,89916.92,2,9858786,41551,9817235,0,0.00,86.54,89916.92,1,10.34,9.34,7.81
1040,0,9821661,4426,40.54,89957.46,2,9860999,39338,9821661,4426,40.54,86.50,89957.46,0,8.27,9.34,7.62
1041,0,9825991,4330,39.66,89997.12,2,9863164,37173,9825991,4330,39.66,86.45,89997.12,1,8.56,9.34,7.71
1042,0,9830343,4352,39.86,90036.98,2,9865340,34997,9830343,4352,39.86,86.41,90036.98,0,7.49,9.34,7.64
1043,0,9834713,4370,40.03,90077.00,2,9867525,32812,9834713,4370,40.03,86.36,90077.00,1,7.53,9.34,7.73
1044,0,9839069,4356,39.90,90116.90,2,9869703,30634,9839069,4356,39.90,86.32,90116.90,0,6.59,9.34,7.61
1045,0,9843497,4428,40.56,90157.45,2,9871917,28420,9843497,4428,40.56,86.28,90157.45,1,6.63,9.34,7.70
1046,0,9847791,4294,39.33,90196.79,2,9874064,26273,9847791,4294,39.33,86.23,90196.79,1,5.35,9.34,7.61
1047,0,9852251,4460,40.85,90237.63,2,9876294,24043,9852251,4460,40.85,86.19,90237.63,0,4.06,9.34,7.52
1048,0,9856717,4466,40.90,90278.54,2,9878527,21810,9856717,4466,40.90,86.14,90278.54,1,4.10,9.34,7.61
1049,0,9861495,4778,43.76,90322.30,2,9880916,19421,9861495,4778,43.76,86.10,90322.30,0,3.28,9.34,7.56
1050,0,9866477,4982,45.63,90367.93,2,9883407,16930,9866477,4982,45.63,86.06,90367.93,1,3.32,9.34,7.65
1051,0,9872763,6286,57.57,90425.51,2,9886550,13787,9872763,6286,57.57,86.04,90425.51,0,1.94,9.34,7.54
1052,0,9884563,11800,108.08,90533.59,2,9892450,7887,9884563,11800,108.08,86.06,90533.59,1,2.08,9.34,7.63
1053,0,9913007,28444,260.52,90794.10,2,9913007,0,9913007,28444,260.52,86.22,90794.10,0,1.68,9.34,7.62
1054,0,9948319,35312,323.43,91117.53,2,9948319,0,9948319,35312,323.43,86.45,91117.53,1,2.90,9.34,7.71
1055,0,9983284,34965,320.25,91437.78,2,9983284,0,9983284,34965,320.25,86.67,91437.78,0,2.99,9.34,7.57
1056,0,10018203,34919,319.83,91757.60,2,10018203,0,10018203,34919,319.83,86.89,91757.60,0,5.04,9.34,7.65
1057,0,10052776,34573,316.66,92074.26,2,10052776,0,10052776,34573,316.66,87.11,92074.26,1,7.01,9.34,7.74
1058,0,10087437,34661,317.46,92391.73,2,10087437,0,10087437,34661,317.46,87.33,92391.73,0,6.44,9.34,7.67
1059,0,10122490,35053,321.05,92712.78,2,10122490,0,10122490,35053,321.05,87.55,92712.78,0,7.49,9.34,7.76
1060,0,10122490,0,0.00,92712.78,2,10133560,11070,10122490,0,0.00,87.46,92712.78,1,9.40,8.40,7.85
1061,0,10143704,21214,194.30,92907.08,2,10144167,463,10143704,21214,194.30,87.57,92907.08,0,8.05,8.40,7.69
1062,0,10143704,0,0.00,92907.08,2,10154641,10937,10143704,0,0.00,87.48,92907.08,1,9.67,8.67,7.77
1063,0,10143704,0,0.00,92907.08,2,10160128,16424,10143704,0,0.00,87.40,92907.08,1,9.73,8.73,7.61
1064,0,10143704,0,0.00,92907.08,2,10164065,20361,10143704,0,0.00,87.32,92907.08,0,8.96,8.00,7.60
1065,0,10143704,0,0.00,92907.08,2,10167554,23850,10143704,0,0.00,87.24,92907.08,1,8.96,8.00,7.69
1066,0,10150836,7132,65.32,92972.40,2,10171120,20284,10150836,7132,65.32,87.22,92972.40,0,9.33,10.33,7.63
1067,0,10158702,7866,72.05,93044.45,2,10175053,16351,10158702,7866,72.05,87.20,93044.45,1,9.96,10.33,7.72
1068,0,10166562,7860,71.99,93116.44,2,10178983,12421,10166562,7860,71.99,87.19,93116.44,1,8.73,10.33,7.64
1069,0,10179448,12886,118.02,93234.46,2,10185426,5978,10179448,12886,118.02,87.22,93234.46,0,7.67,10.33,7.58
1070,0,10210129,30681,281.01,93515.47,2,10210129,0,10210129,30681,281.01,87.40,93515.47,1,9.52,10.33,7.67
1071,0,10244124,33995,311.36,93826.84,2,10244124,0,10244124,33995,311.36,87.61,93826.84,0,9.73,10.33,7.59
1072,0,10244124,0,0.00,93826.84,2,10254752,10628,10244124,0,0.00,87.53,93826.84,1,12.26,11.26,7.67
1073,0,10244124,0,0.00,93826.84,2,10260577,16453,10244124,0,0.00,87.44,93826.84,0,12.04,11.04,7.58
1074,0,10244124,0,0.00,93826.84,2,10265046,20922,10244124,0,0.00,87.36,93826.84,1,13.35,12.35,7.67
1075,0,10252456,8332,76.31,93903.15,2,10269212,16756,10252456,8332,76.31,87.35,93903.15,0,12.12,12.35,7.55
1076,0,10260748,8292,75.95,93979.09,2,10273358,12610,10260748,8292,75.95,87.34,93979.09,1,12.20,12.35,7.63
1077,0,10272738,11990,109.82,94088.91,2,10279353,6615,10272738,11990,109.82,87.36,94088.91,0,12.00,12.35,7.55
1078,0,10272738,0,0.00,94088.91,2,10286296,13558,10272738,0,0.00,87.28,94088.91,0,12.83,11.83,7.64
1079,0,10272738,0,0.00,94088.91,2,10290693,17955,10272738,0,0.00,87.20,94088.91,1,12.97,11.97,7.72
1080,0,10282402,9664,88.51,94177.43,2,10295525,13123,10282402,9664,88.51,87.20,94177.43,0,11.67,11.97,7.53
1081,0,10282402,0,0.00,94177.43,2,10300397,17995,10282402,0,0.00,87.12,94177.43,1,12.24,11.24,7.62
1082,0,10291410,9008,82.51,94259.93,2,10304901,13491,10291410,9008,82.51,87.12,94259.93,0,11.15,11.24,7.55
1083,0,10291410,0,0.00,94259.93,2,10309216,17806,10291410,0,0.00,87.04,94259.93,1,11.53,10.53,7.64
1084,0,10291410,0,0.00,94259.93,2,10312405,20995,10291410,0,0.00,86.96,94259.93,1,10.72,9.72,7.56
1085,0,10297818,6408,58.69,94318.62,2,10315609,17791,10297818,6408,58.69,86.93,94318.62,0,9.56,9.72,7.50
1086,0,10297818,0,0.00,94318.62,2,10318964,21146,10297818,0,0.00,86.85,94318.62,1,9.95,8.95,7.58
1087,0,10297818,0,0.00,94318.62,2,10321635,23817,10297818,0,0.00,86.77,94318.62,0,8.95,8.00,7.51
1088,0,10303038,5220,47.81,94366.43,2,10324245,21207,10303038,5220,47.81,86.73,94366.43,1,9.11,10.11,7.60
1089,0,10309202,6164,56.46,94422.89,2,10327327,18125,10309202,6164,56.46,86.71,94422.89,0,7.46,10.11,7.47
1090,0,10317204,8002,73.29,94496.18,2,10331328,14124,10317204,8002,73.29,86.69,94496.18,1,7.52,10.11,7.56
1091,0,10329438,12234,112.05,94608.23,2,10337445,8007,10329438,12234,112.05,86.72,94608.23,0,6.64,10.11,7.50
1092,0,10354503,25065,229.57,94837.80,2,10354503,0,10354503,25065,229.57,86.85,94837.80,1,7.15,10.11,7.59
1093,0,10388838,34335,314.48,95152.28,2,10388838,0,10388838,34335,314.48,87.06,95152.28,0,6.91,10.11,7.51
1094,0,10423455,34617,317.06,95469.34,2,10423455,0,10423455,34617,317.06,87.27,95469.34,0,8.88,10.11,7.60
1095,0,10423455,0,0.00,95469.34,2,10434269,10814,10423455,0,0.00,87.19,95469.34,1,11.65,10.65,7.68
1096,0,10423455,0,0.00,95469.34,2,10440218,16763,10423455,0,0.00,87.11,95469.34,0,11.19,10.19,7.60
1097,0,10423455,0,0.00,95469.34,2,10444987,21532,10423455,0,0.00,87.03,95469.34,1,11.19,10.19,7.68
1098,0,10432037,8582,78.60,95547.95,2,10449278,17241,10432037,8582,78.60,87.02,95547.95,0,9.93,10.19,7.61
1099,0,10432037,0,0.00,95547.95,2,10453140,21103,10432037,0,0.00,86.94,95547.95,0,10.72,9.72,7.70
1100,0,10432037,0,0.00,95547.95,2,10456505,24468,10432037,0,0.00,86.86,95547.95,1,10.81,9.81,7.78
1101,0,10438429,6392,58.54,95606.49,2,10459701,21272,10438429,6392,58.54,86.84,95606.49,0,9.28,9.81,7.66
1102,0,10444559,6130,56.15,95662.63,2,10462766,18207,10444559,6130,56.15,86.81,95662.63,1,9.34,9.81,7.74
1103,0,10444559,0,0.00,95662.63,2,10465556,20997,10444559,0,0.00,86.73,95662.63,0,8.73,8.00,7.70
1104,0,10444559,0,0.00,95662.63,2,10468156,23597,10444559,0,0.00,86.65,95662.63,1,8.93,8.00,7.78
1105,0,10449601,5042,46.18,95708.82,2,10470677,21076,10449601,5042,46.18,86.61,95708.82,0,7.87,8.00,7.72
1106,0,10455031,5430,49.73,95758.55,2,10473392,18361,10455031,5430,49.73,86.58,95758.55,1,7.92,8.00,7.81
1107,0,10461201,6170,56.51,95815.06,2,10476477,15276,10461201,6170,56.51,86.55,95815.06,1,7.31,8.00,7.77
1108,0,10471063,9862,90.33,95905.39,2,10481408,10345,10471063,9862,90.33,86.56,95905.39,0,6.31,8.00,7.72
1109,0,10493659,22596,206.96,96112.34,2,10493659,0,10493659,22596,206.96,86.67,96112.34,1,6.40,8.00,7.81
1110,0,10529136,35477,324.94,96437.28,2,10529136,0,10529136,35477,324.94,86.88,96437.28,1,6.38,8.00,7.76
1111,0,10564434,35298,323.30,96760.59,2,10564434,0,10564434,35298,323.30,87.09,96760.59,0,7.57,8.00,7.76
1112,0,10597800,33366,305.60,97066.19,2,10597800,0,10597800,33366,305.60,87.29,97066.19,1,10.34,11.34,7.84
1113,0,10597800,0,0.00,97066.19,2,10608875,11075,10597800,0,0.00,87.21,97066.19,0,11.41,10.41,7.81
1114,0,10597800,0,0.00,97066.19,2,10614870,17070,10597800,0,0.00,87.13,97066.19,0,11.98,10.98,7.89
1115,0,10597800,0,0.00,97066.19,2,10619486,21686,10597800,0,0.00,87.05,97066.19,1,12.23,11.23,7.97
1116,0,10606156,8356,76.53,97142.72,2,10623664,17508,10606156,8356,76.53,87.05,97142.72,0,10.68,11.23,7.83
1117,0,10614150,7994,73.22,97215.94,2,10627661,13511,10614150,7994,73.22,87.03,97215.94,1,10.75,11.23,7.91
1118,0,10624096,9946,91.10,97307.03,2,10632634,8538,10624096,9946,91.10,87.04,97307.03,0,9.99,11.23,7.89
1119,0,10649046,24950,228.52,97535.55,2,10649046,0,10649046,24950,228.52,87.16,97535.55,1,10.36,11.23,7.97
1120,0,10682741,33695,308.62,97844.16,2,10682741,0,10682741,33695,308.62,87.36,97844.16,0,10.23,11.23,7.89
1121,0,10682741,0,0.00,97844.16,2,10693458,10717,10682741,0,0.00,87.28,97844.16,1,12.13,11.13,7.97
1122,0,10682741,0,0.00,97844.16,2,10699329,16588,10682741,0,0.00,87.21,97844.16,1,11.21,10.21,7.90
1123,0,10682741,0,0.00,97844.16,2,10703981,21240,10682741,0,0.00,87.13,97844.16,0,11.76,10.76,7.84
1124,0,10682741,0,0.00,97844.16,2,10707943,25202,10682741,0,0.00,87.05,97844.16,0,11.76,10.76,7.92
1125,0,10682741,0,0.00,97844.16,2,10711551,28810,10682741,0,0.00,86.97,97844.16,1,11.76,10.76,8.01
1126,0,10689613,6872,62.94,97907.11,2,10714987,25374,10689613,6872,62.94,86.95,97907.11,1,10.41,10.76,7.87
1127,0,10689613,0,0.00,97907.11,2,10718237,28624,10689613,0,0.00,86.87,97907.11,0,11.12,10.12,7.84
1128,0,10689613,0,0.00,97907.11,2,10721007,31394,10689613,0,0.00,86.80,97907.11,1,11.43,10.43,7.93
1129,0,10694863,5250,48.09,97955.20,2,10723632,28769,10694863,5250,48.09,86.76,97955.20,0,9.81,10.43,7.81
1130,0,10700305,5442,49.84,98005.04,2,10726353,26048,10700305,5442,49.84,86.73,98005.04,1,9.86,10.43,7.89
1131,0,10705725,5420,49.64,98054.68,2,10729063,23338,10705725,5420,49.64,86.70,98054.68,0,8.86,10.43,7.85
1132,0,10711059,5334,48.85,98103.53,2,10731730,20671,10711059,5334,48.85,86.66,98103.53,1,9.77,10.43,7.93
1133,0,10716403,5344,48.95,98152.48,2,10734402,17999,10716403,5344,48.95,86.63,98152.48,0,9.33,10.43,7.81
1134,0,10722227,5824,53.34,98205.82,2,10737314,15087,10722227,5824,53.34,86.60,98205.82,1,9.37,10.43,7.89
1135,0,10730179,7952,72.83,98278.66,2,10741290,11111,10730179,7952,72.83,86.59,98278.66,0,8.56,10.43,7.87
1136,0,10749859,19680,180.25,98458.91,2,10751130,1271,10749859,19680,180.25,86.67,98458.91,1,8.63,10.43,7.95
1137,0,10782315,32456,297.27,98756.17,2,10782315,0,10782315,32456,297.27,86.86,98756.17,0,9.37,10.43,7.89
1138,0,10782315,0,0.00,98756.17,2,10792704,10389,10782315,0,0.00,86.78,98756.17,0,10.92,9.92,7.97
1139,0,10782315,0,0.00,98756.17,2,10798662,16347,10782315,0,0.00,86.70,98756.17,1,11.37,10.37,8.05
1140,0,10782315,0,0.00,98756.17,2,10803153,20838,10782315,0,0.00,86.63,98756.17,1,10.71,9.71,7.99
1141,0,10782315,0,0.00,98756.17,2,10806978,24663,10782315,0,0.00,86.55,98756.17,0,9.95,8.95,7.93
1142,0,10782315,0,0.00,98756.17,2,10810386,28071,10782315,0,0.00,86.48,98756.17,1,10.04,9.04,8.01
1143,0,10788845,6530,59.81,98815.98,2,10813651,24806,10788845,6530,59.81,86.45,98815.98,0,8.90,9.04,7.93
1144,0,10795103,6258,57.32,98873.30,2,10816780,21677,10795103,6258,57.32,86.43,98873.30,0,8.96,9.04,8.01
1145,0,10795103,0,0.00,98873.30,2,10819759,24656,10795103,0,0.00,86.35,98873.30,0,10.19,9.19,8.09
1146,0,10795103,0,0.00,98873.30,2,10822481,27378,10795103,0,0.00,86.28,98873.30,1,10.33,9.33,8.17
1147,0,10800345,5242,48.01,98921.31,2,10825102,24757,10800345,5242,48.01,86.24,98921.31,1,8.13,9.33,7.97
1148,0,10805519,5174,47.39,98968.70,2,10827689,22170,10805519,5174,47.39,86.21,98968.70,0,6.92,9.33,7.90
1149,0,10810775,5256,48.14,99016.84,2,10830317,19542,10810775,5256,48.14,86.18,99016.84,0,7.21,9.33,7.98
1150,0,10816223,5448,49.90,99066.74,2,10833041,16818,10816223,5448,49.90,86.14,99066.74,1,7.92,9.33,8.06
1151,0,10822655,6432,58.91,99125.65,2,10836257,13602,10822655,6432,58.91,86.12,99125.65,1,6.20,9.33,7.88
1152,0,10835463,12808,117.31,99242.96,2,10842661,7198,10835463,12808,117.31,86.15,99242.96,0,5.25,9.33,7.84
1153,0,10863290,27827,254.87,99497.83,2,10863290,0,10863290,27827,254.87,86.29,99497.83,1,5.74,9.33,7.92
1154,0,10897046,33756,309.17,99807.01,2,10897046,0,10897046,33756,309.17,86.49,99807.01,1,5.68,9.33,7.89
1155,0,10931046,34000,311.41,100118.41,2,10931046,0,10931046,34000,311.41,86.68,100118.41,0,5.88,9.33,7.89
1156,0,10964955,33909,310.58,100428.99,2,10964955,0,10964955,33909,310.58,86.88,100428.99,1,7.48,9.33,7.97
1157,0,10998277,33322,305.20,100734.19,2,10998277,0,10998277,33322,305.20,87.06,100734.19,0,9.00,9.33,7.95
1158,0,10998277,0,0.00,100734.19,2,11008791,10514,10998277,0,0.00,86.99,100734.19,0,10.47,9.47,8.03
1159,0,10998277,0,0.00,100734.19,2,11014328,16051,10998277,0,0.00,86.91,100734.19,1,11.63,10.63,8.11
1160,0,10998277,0,0.00,100734.19,2,11018626,20349,10998277,0,0.00,86.84,100734.19,1,10.77,9.77,8.07
1161,0,10998277,0,0.00,100734.19,2,11022320,24043,10998277,0,0.00,86.77,100734.19,0,9.87,8.87,8.04
1162,0,10998277,0,0.00,100734.19,2,11025642,27365,10998277,0,0.00,86.69,100734.19,1,10.04,9.04,8.12
1163,0,10998277,0,0.00,100734.19,2,11028681,30404,10998277,0,0.00,86.62,100734.19,0,9.54,8.54,8.11
1164,0,10998277,0,0.00,100734.19,2,11031432,33155,10998277,0,0.00,86.54,100734.19,1,9.61,8.61,8.19
1165,0,11003767,5490,50.28,100784.47,2,11034177,30410,11003767,5490,50.28,86.51,100784.47,0,8.18,8.61,8.09
1166,0,11009341,5574,51.05,100835.52,2,11036964,27623,11009341,5574,51.05,86.48,100835.52,1,8.44,8.61,8.17
1167,0,11014895,5554,50.87,100886.39,2,11039741,24846,11014895,5554,50.87,86.45,100886.39,0,7.45,8.61,8.11
1168,0,11020079,5184,47.48,100933.88,2,11042333,22254,11020079,5184,47.48,86.42,100933.88,0,8.04,8.61,8.19
1169,0,11025487,5408,49.53,100983.41,2,11045037,19550,11025487,5408,49.53,86.38,100983.41,1,8.29,8.61,8.27
1170,0,11031171,5684,52.06,101035.47,2,11047879,16708,11031171,5684,52.06,86.36,101035.47,0,7.07,8.61,8.18
1171,0,11037687,6516,59.68,101095.15,2,11051137,13450,11037687,6516,59.68,86.33,101095.15,1,7.35,8.61,8.26
1172,0,11048165,10478,95.97,101191.12,2,11056376,8211,11048165,10478,95.97,86.34,101191.12,0,6.16,8.61,8.17
1173,0,11075220,27055,247.80,101438.91,2,11075220,0,11075220,27055,247.80,86.48,101438.91,1,6.44,8.61,8.25
1174,0,11108773,33553,307.31,101746.23,2,11108773,0,11108773,33553,307.31,86.67,101746.23,0,6.34,8.61,8.18
1175,0,11142739,33966,311.10,102057.33,2,11142739,0,11142739,33966,311.10,86.86,102057.33,1,6.64,8.61,8.26
1176,0,11176172,33433,306.22,102363.55,2,11176172,0,11176172,33433,306.22,87.04,102363.55,0,7.74,8.61,8.20
1177,0,11176172,0,0.00,102363.55,2,11186920,10748,11176172,0,0.00,86.97,102363.55,1,10.69,9.69,8.27
1178,0,11176172,0,0.00,102363.55,2,11192828,16656,11176172,0,0.00,86.90,102363.55,0,11.87,10.87,8.20
1179,0,11176172,0,0.00,102363.55,2,11197350,21178,11176172,0,0.00,86.82,102363.55,0,13.01,12.01,8.28
1180,0,11176172,0,0.00,102363.55,2,11201047,24875,11176172,0,0.00,86.75,102363.55,1,13.01,12.01,8.35
1181,0,11176172,0,0.00,102363.55,2,11204362,28190,11176172,0,0.00,86.68,102363.55,0,12.10,11.10,8.33
1182,0,11176172,0,0.00,102363.55,2,11207502,31330,11176172,0,0.00,86.60,102363.55,1,12.10,11.10,8.40
1183,0,11176172,0,0.00,102363.55,2,11210421,34249,11176172,0,0.00,86.53,102363.55,1,11.29,10.29,8.35
1184,0,11181764,5592,51.22,102414.77,2,11213217,31453,11181764,5592,51.22,86.50,102414.77,0,10.18,10.29,8.30
1185,0,11187374,5610,51.38,102466.14,2,11216022,28648,11187374,5610,51.38,86.47,102466.14,1,10.23,10.29,8.38
1186,0,11192850,5476,50.16,102516.30,2,11218760,25910,11192850,5476,50.16,86.44,102516.30,0,9.41,10.29,8.36
1187,0,11198312,5462,50.03,102566.33,2,11221491,23179,11198312,5462,50.03,86.41,102566.33,1,9.46,10.29,8.43
1188,0,11203698,5386,49.33,102615.66,2,11224184,20486,11203698,5386,49.33,86.38,102615.66,0,8.95,10.29,8.41
1189,0,11209114,5416,49.61,102665.27,2,11226892,17778,11209114,5416,49.61,86.35,102665.27,1,9.57,10.29,8.49
1190,0,11214706,5592,51.22,102716.48,2,11229688,14982,11214706,5592,51.22,86.32,102716.48,1,8.85,10.29,8.44
1191,0,11221666,6960,63.75,102780.23,2,11233168,11502,11221666,6960,63.75,86.30,102780.23,0,8.06,10.29,8.42
1192,0,11237380,15714,143.93,102924.16,2,11241025,3645,11237380,15714,143.93,86.35,102924.16,1,8.12,10.29,8.50
1193,0,11268698,31318,286.84,103211.00,2,11268698,0,11268698,31318,286.84,86.51,103211.00,0,8.86,10.29,8.48
1194,0,11268698,0,0.00,103211.00,2,11279466,10768,11268698,0,0.00,86.44,103211.00,1,10.71,9.71,8.56
1195,0,11268698,0,0.00,103211.00,2,11285489,16791,11268698,0,0.00,86.37,103211.00,0,10.95,9.95,8.47
1196,0,11268698,0,0.00,103211.00,2,11290012,21314,11268698,0,0.00,86.30,103211.00,1,11.77,10.77,8.55
1197,0,11268698,0,0.00,103211.00,2,11293906,25208,11268698,0,0.00,86.22,103211.00,0,12.08,11.08,8.56
1198,0,11268698,0,0.00,103211.00,2,11297134,28436,11268698,0,0.00,86.15,103211.00,1,12.08,11.08,8.63
1199,0,11275076,6378,58.42,103269.41,2,11300323,25247,11275076,6378,58.42,86.13,103269.41,0,11.06,11.08,8.56
1200,0,11275076,0,0.00,103269.41,2,11303430,28354,11275076,0,0.00,86.06,103269.41,1,12.31,11.31,8.64
1201,0,11275076,0,0.00,103269.41,2,11306250,31174,11275076,0,0.00,85.99,103269.41,0,11.70,10.70,8.64
1202,0,11275076,0,0.00,103269.41,2,11308852,33776,11275076,0,0.00,85.91,103269.41,1,11.99,10.99,8.72
1203,0,11280134,5058,46.33,103315.74,2,11311381,31247,11280134,5058,46.33,85.88,103315.74,0,10.82,10.99,8.66
1204,0,11280134,0,0.00,103315.74,2,11313800,33666,11280134,0,0.00,85.81,103315.74,1,11.49,10.49,8.74
1205,0,11280134,0,0.00,103315.74,2,11316095,35961,11280134,0,0.00,85.74,103315.74,1,11.11,10.11,8.69
1206,0,11280134,0,0.00,103315.74,2,11318274,38140,11280134,0,0.00,85.67,103315.74,0,10.46,9.46,8.66
1207,0,11280134,0,0.00,103315.74,2,11320361,40227,11280134,0,0.00,85.60,103315.74,0,10.46,9.46,8.73
1208,0,11280134,0,0.00,103315.74,2,11322353,42219,11280134,0,0.00,85.53,103315.74,1,10.59,9.59,8.81
1209,0,11284042,3908,35.79,103351.54,2,11324307,40265,11284042,3908,35.79,85.49,103351.54,0,9.13,9.59,8.72
1210,0,11287946,3904,35.76,103387.29,2,11326259,38313,11287946,3904,35.76,85.44,103387.29,1,9.17,9.59,8.79
1211,0,11291742,3796,34.77,103422.06,2,11328157,36415,11291742,3796,34.77,85.40,103422.06,0,7.85,9.59,8.66
1212,0,11295422,3680,33.71,103455.77,2,11329997,34575,11295422,3680,33.71,85.36,103455.77,1,8.44,9.59,8.74
1213,0,11299314,3892,35.65,103491.41,2,11331943,32629,11299314,3892,35.65,85.32,103491.41,0,7.15,9.59,8.66
1214,0,11303286,3972,36.38,103527.79,2,11333929,30643,11303286,3972,36.38,85.28,103527.79,1,7.19,9.59,8.73
1215,0,11307444,4158,38.08,103565.88,2,11336008,28564,11307444,4158,38.08,85.24,103565.88,0,5.73,9.59,8.64
1216,0,11311588,4144,37.96,103603.83,2,11338080,26492,11311588,4144,37.96,85.20,103603.83,1,5.89,9.59,8.71
1217,0,11315884,4296,39.35,103643.18,2,11340228,24344,11315884,4296,39.35,85.16,103643.18,0,4.72,9.59,8.65
1218,0,11320220,4336,39.71,103682.89,2,11342396,22176,11320220,4336,39.71,85.13,103682.89,0,4.76,9.59,8.73
1219,0,11324652,4432,40.59,103723.48,2,11344612,19960,11324652,4432,40.59,85.09,103723.48,1,5.05,9.59,8.80
1220,0,11329454,4802,43.98,103767.47,2,11347013,17559,11329454,4802,43.98,85.06,103767.47,1,3.45,9.59,8.69
1221,0,11335274,5820,53.31,103820.77,2,11349923,14649,11335274,5820,53.31,85.03,103820.77,0,2.62,9.59,8.67
1222,0,11345518,10244,93.83,103914.60,2,11355045,9527,11345518,10244,93.83,85.04,103914.60,1,2.84,9.59,8.75
1223,0,11368004,22486,205.95,104120.55,2,11368004,0,11368004,22486,205.95,85.14,104120.55,0,1.94,9.59,8.71
1224,0,11402614,34610,317.00,104437.55,2,11402614,0,11402614,34610,317.00,85.32,104437.55,1,2.92,9.59,8.79
1225,0,11434884,32270,295.56,104733.11,2,11434884,0,11434884,32270,295.56,85.50,104733.11,0,3.74,9.59,8.73
1226,0,11466062,31178,285.56,105018.67,2,11466062,0,11466062,31178,285.56,85.66,105018.67,0,5.80,9.59,8.81
1227,0,11500146,34084,312.18,105330.85,2,11500146,0,11500146,34084,312.18,85.84,105330.85,1,7.16,9.59,8.88
1228,0,11534319,34173,312.99,105643.84,2,11534319,0,11534319,34173,312.99,86.03,105643.84,0,6.46,9.59,8.81
1229,0,11568342,34023,311.62,105955.46,2,11568342,0,11568342,34023,311.62,86.21,105955.46,1,7.03,9.59,8.89
1230,0,11602497,34155,312.83,106268.29,2,11602497,0,11602497,34155,312.83,86.40,106268.29,1,6.95,9.59,8.80
1231,0,11636390,33893,310.43,106578.72,2,11636390,0,11636390,33893,310.43,86.58,106578.72,0,7.44,9.59,8.72
1232,0,11636390,0,0.00,106578.72,2,11647444,11054,11636390,0,0.00,86.51,106578.72,1,9.69,8.69,8.80
1233,0,11636390,0,0.00,106578.72,2,11652894,16504,11636390,0,0.00,86.44,106578.72,0,9.89,8.89,8.72
1234,0,11636390,0,0.00,106578.72,2,11657308,20918,11636390,0,0.00,86.37,106578.72,1,10.45,9.45,8.80
1235,0,11644842,8452,77.41,106656.13,2,11661534,16692,11644842,8452,77.41,86.36,106656.13,0,9.40,9.45,8.67
1236,0,11644842,0,0.00,106656.13,2,11665356,20514,11644842,0,0.00,86.29,106656.13,1,10.32,9.32,8.74
1237,0,11651990,7148,65.47,106721.60,2,11668930,16940,11651990,7148,65.47,86.27,106721.60,0,9.12,9.32,8.68
1238,0,11651990,0,0.00,106721.60,2,11672297,20307,11651990,0,0.00,86.20,106721.60,0,9.39,8.39,8.76
1239,0,11651990,0,0.00,106721.60,2,11675216,23226,11651990,0,0.00,86.14,106721.60,1,9.74,8.74,8.83
1240,0,11657534,5544,50.78,106772.38,2,11677988,20454,11657534,5544,50.78,86.11,106772.38,0,8.64,8.74,8.71
1241,0,11657534,0,0.00,106772.38,2,11680587,23053,11657534,0,0.00,86.04,106772.38,1,9.35,8.35,8.79
1242,0,11662500,4966,45.48,106817.87,2,11683070,20570,11662500,4966,45.48,86.00,106817.87,1,8.31,8.35,8.71
1243,0,11668680,6180,56.60,106874.47,2,11686160,17480,11668680,6180,56.60,85.98,106874.47,0,7.37,8.35,8.67
1244,0,11676980,8300,76.02,106950.49,2,11690310,13330,11676980,8300,76.02,85.97,106950.49,1,7.42,8.35,8.75
1245,0,11692370,15390,140.96,107091.45,2,11698005,5635,11692370,15390,140.96,86.02,107091.45,0,7.06,8.35,8.70
1246,0,11692370,0,0.00,107091.45,2,11705743,13373,11692370,0,0.00,85.95,107091.45,1,8.43,8.00,8.77
1247,0,11706940,14570,133.45,107224.90,2,11713028,6088,11706940,14570,133.45,85.99,107224.90,0,7.22,8.00,8.64
1248,0,11735290,28350,259.66,107484.55,2,11735290,0,11735290,28350,259.66,86.13,107484.55,1,8.86,9.86,8.72
1249,0,11735290,0,0.00,107484.55,2,11745913,10623,11735290,0,0.00,86.06,107484.55,0,10.42,9.42,8.70
1250,0,11735290,0,0.00,107484.55,2,11751558,16268,11735290,0,0.00,85.99,107484.55,0,11.02,10.02,8.78
1251,0,11735290,0,0.00,107484.55,2,11756009,20719,11735290,0,0.00,85.92,107484.55,1,12.46,11.46,8.85
1252,0,11743372,8082,74.02,107558.58,2,11760050,16678,11743372,8082,74.02,85.91,107558.58,1,10.29,11.46,8.69
1253,0,11751806,8434,77.25,107635.83,2,11764267,12461,11751806,8434,77.25,85.90,107635.83,0,9.86,11.46,8.69
1254,0,11764878,13072,119.73,107755.55,2,11770803,5925,11764878,13072,119.73,85.93,107755.55,1,11.08,11.46,8.76
1255,0,11793514,28636,262.28,108017.84,2,11793514,0,11793514,28636,262.28,86.07,108017.84,0,10.23,11.46,8.66
1256,0,11793514,0,0.00,108017.84,2,11803907,10393,11793514,0,0.00,86.00,108017.84,1,11.77,10.77,8.73
1257,0,11793514,0,0.00,108017.84,2,11809674,16160,11793514,0,0.00,85.93,108017.84,0,11.04,10.04,8.68
1258,0,11793514,0,0.00,108017.84,2,11813925,20411,11793514,0,0.00,85.86,108017.84,0,11.19,10.19,8.76
1259,0,11793514,0,0.00,108017.84,2,11817834,24320,11793514,0,0.00,85.80,108017.84,1,11.50,10.50,8.83
1260,0,11800858,7344,67.26,108085.10,2,11821506,20648,11800858,7344,67.26,85.78,108085.10,1,10.47,10.50,8.79
1261,0,11808208,7350,67.32,108152.41,2,11825181,16973,11808208,7350,67.32,85.77,108152.41,0,9.03,10.50,8.70
1262,0,11815612,7404,67.81,108220.23,2,11828883,13271,11815612,7404,67.81,85.75,108220.23,1,9.95,10.50,8.77
1263,0,11825960,10348,94.78,108315.01,2,11834057,8097,11825960,10348,94.78,85.76,108315.01,0,8.67,10.50,8.70
1264,0,11852030,26070,238.78,108553.79,2,11852030,0,11852030,26070,238.78,85.88,108553.79,1,8.76,10.50,8.77
1265,0,11884438,32408,296.83,108850.62,2,11884438,0,11884438,32408,296.83,86.05,108850.62,0,8.41,10.50,8.68
1266,0,11884438,0,0.00,108850.62,2,11895471,11033,11884438,0,0.00,85.98,108850.62,1,10.69,9.69,8.75
1267,0,11884438,0,0.00,108850.62,2,11901581,17143,11884438,0,0.00,85.91,108850.62,0,10.05,9.05,8.75
1268,0,11884438,0,0.00,108850.62,2,11905786,21348,11884438,0,0.00,85.84,108850.62,0,11.05,10.05,8.82
1269,0,11884438,0,0.00,108850.62,2,11909640,25202,11884438,0,0.00,85.78,108850.62,1,11.08,10.08,8.90
1270,0,11891714,7276,66.64,108917.26,2,11913278,21564,11891714,7276,66.64,85.76,108917.26,1,9.08,10.08,8.72
1271,0,11899066,7352,67.34,108984.59,2,11916954,17888,11899066,7352,67.34,85.75,108984.59,0,8.32,10.08,8.68
1272,0,11906584,7518,68.86,109053.45,2,11920713,14129,11906584,7518,68.86,85.73,109053.45,1,8.64,10.08,8.75
1273,0,11915708,9124,83.57,109137.02,2,11925275,9567,11915708,9124,83.57,85.73,109137.02,0,7.05,10.08,8.58
1274,0,11939284,23576,215.93,109352.95,2,11939284,0,11939284,23576,215.93,85.83,109352.95,1,7.45,10.08,8.65
1275,0,11972277,32993,302.19,109655.14,2,11972277,0,11972277,32993,302.19,86.00,109655.14,0,8.30,10.08,8.64
1276,0,12004662,32385,296.62,109951.76,2,12004662,0,12004662,32385,296.62,86.17,109951.76,1,10.07,10.08,8.72
1277,0,12037539,32877,301.12,110252.88,2,12037539,0,12037539,32877,301.12,86.34,110252.88,0,9.20,10.08,8.61
1278,0,12070645,33106,303.22,110556.10,2,12070645,0,12070645,33106,303.22,86.51,110556.10,0,9.86,10.08,8.68
1279,0,12070645,0,0.00,110556.10,2,12081131,10486,12070645,0,0.00,86.44,110556.10,1,11.91,10.91,8.75
1280,0,12070645,0,0.00,110556.10,2,12086838,16193,12070645,0,0.00,86.37,110556.10,1,11.98,10.98,8.65
1281,0,12070645,0,0.00,110556.10,2,12091042,20397,12070645,0,0.00,86.30,110556.10,0,11.09,10.09,8.61
1282,0,12070645,0,0.00,110556.10,2,12094809,24164,12070645,0,0.00,86.24,110556.10,1,11.66,10.66,8.68
1283,0,12077427,6782,62.12,110618.22,2,12098200,20773,12077427,6782,62.12,86.22,110618.22,0,10.21,10.66,8.56
1284,0,12084465,7038,64.46,110682.68,2,12101719,17254,12084465,7038,64.46,86.20,110682.68,1,10.31,10.66,8.64
1285,0,12091837,7372,67.52,110750.20,2,12105405,13568,12091837,7372,67.52,86.19,110750.20,0,9.37,10.66,8.55
1286,0,12101269,9432,86.39,110836.59,2,12110121,8852,12101269,9432,86.39,86.19,110836.59,1,9.52,10.66,8.62
1287,0,12126515,25246,231.23,111067.82,2,12126515,0,12126515,25246,231.23,86.30,111067.82,0,8.10,10.66,8.52
1288,0,12159035,32520,297.85,111365.67,2,12159035,0,12159035,32520,297.85,86.46,111365.67,1,9.44,10.66,8.59
1289,0,12191563,32528,297.93,111663.60,2,12191563,0,12191563,32528,297.93,86.63,111663.60,0,9.81,10.66,8.50
1290,0,12223308,31745,290.76,111954.35,2,12223308,0,12223308,31745,290.76,86.79,111954.35,1,10.32,10.66,8.57
1291,0,12255312,32004,293.13,112247.48,2,12255312,0,12255312,32004,293.13,86.95,112247.48,0,10.25,10.66,8.48
1292,0,12255312,0,0.00,112247.48,2,12265563,10251,12255312,0,0.00,86.88,112247.48,1,13.36,12.36,8.55
1293,0,12255312,0,0.00,112247.48,2,12271225,15913,12255312,0,0.00,86.81,112247.48,0,14.40,13.40,8.41
1294,0,12255312,0,0.00,112247.48,2,12275477,20165,12255312,0,0.00,86.74,112247.48,1,14.79,13.79,8.48
1295,0,12263514,8202,75.12,112322.61,2,12279578,16064,12263514,8202,75.12,86.74,112322.61,0,13.46,13.79,8.41
1296,0,12263514,0,0.00,112322.61,2,12283443,19929,12263514,0,0.00,86.67,112322.61,1,14.10,13.10,8.48
1297,0,12270552,7038,64.46,112387.07,2,12286962,16410,12270552,7038,64.46,86.65,112387.07,0,12.50,13.10,8.35
1298,0,12278004,7452,68.25,112455.32,2,12290688,12684,12278004,7452,68.25,86.64,112455.32,0,12.95,13.10,8.42
1299,0,12278004,0,0.00,112455.32,2,12294668,16664,12278004,0,0.00,86.57,112455.32,1,13.11,12.11,8.49
1300,0,12286442,8438,77.28,112532.60,2,12298887,12445,12286442,8438,77.28,86.56,112532.60,0,11.46,12.11,8.39
1301,0,12303026,16584,151.89,112684.50,2,12307179,4153,12303026,16584,151.89,86.61,112684.50,1,11.79,12.11,8.46
1302,0,12334244,31218,285.93,112970.43,2,12334244,0,12334244,31218,285.93,86.77,112970.43,0,10.84,12.11,8.34
1303,0,12366357,32113,294.13,113264.55,2,12366357,0,12366357,32113,294.13,86.93,113264.55,1,11.82,12.11,8.41
1304,0,12398875,32518,297.84,113562.39,2,12398875,0,12398875,32518,297.84,87.09,113562.39,1,11.31,12.11,8.32
1305,0,12431170,32295,295.79,113858.18,2,12431170,0,12431170,32295,295.79,87.25,113858.18,0,11.95,12.11,8.23
1306,0,12431170,0,0.00,113858.18,2,12441638,10468,12431170,0,0.00,87.18,113858.18,1,14.49,13.49,8.30
1307,0,12431170,0,0.00,113858.18,2,12447425,16255,12431170,0,0.00,87.11,113858.18,0,14.93,13.93,8.20
1308,0,12431170,0,0.00,113858.18,2,12451467,20297,12431170,0,0.00,87.05,113858.18,0,16.99,15.99,8.27
1309,0,12431170,0,0.00,113858.18,2,12455031,23861,12431170,0,0.00,86.98,113858.18,1,16.99,15.99,8.34
1310,0,12438058,6888,63.09,113921.27,2,12458475,20417,12438058,6888,63.09,86.96,113921.27,1,14.82,15.99,8.19
1311,0,12445052,6994,64.06,113985.33,2,12461972,16920,12445052,6994,64.06,86.95,113985.33,0,14.12,15.99,8.15
1312,0,12452648,7596,69.57,114054.90,2,12465770,13122,12452648,7596,69.57,86.93,114054.90,1,15.04,15.99,8.22
1313,0,12462750,10102,92.53,114147.42,2,12470821,8071,12462750,10102,92.53,86.94,114147.42,0,13.26,15.99,8.10
1314,0,12488135,25385,232.50,114379.93,2,12488135,0,12488135,25385,232.50,87.05,114379.93,1,13.53,15.99,8.17
1315,0,12519657,31522,288.71,114668.64,2,12519657,0,12519657,31522,288.71,87.20,114668.64,0,12.92,15.99,8.09
1316,0,12551187,31530,288.79,114957.43,2,12551187,0,12551187,31530,288.79,87.35,114957.43,1,14.24,15.99,8.16
1317,0,12583203,32016,293.24,115250.66,2,12583203,0,12583203,32016,293.24,87.51,115250.66,0,13.21,15.99,8.01
1318,0,12614836,31633,289.73,115540.40,2,12614836,0,12614836,31633,289.73,87.66,115540.40,0,13.50,15.99,8.08
1319,0,12646436,31600,289.43,115829.82,2,12646436,0,12646436,31600,289.43,87.82,115829.82,1,14.93,15.99,8.15
1320,0,12646436,0,0.00,115829.82,2,12656976,10540,12646436,0,0.00,87.75,115829.82,0,17.87,16.87,8.08
1321,0,12646436,0,0.00,115829.82,2,12663069,16633,12646436,0,0.00,87.68,115829.82,1,20.22,19.22,8.15
1322,0,12657006,10570,96.81,115926.63,2,12668354,11348,12657006,10570,96.81,87.69,115926.63,0,18.49,19.22,8.02
1323,0,12673250,16244,148.78,116075.41,2,12676476,3226,12673250,16244,148.78,87.74,116075.41,1,18.58,19.22,8.09
1324,0,12704570,31320,286.86,116362.27,2,12704570,0,12704570,31320,286.86,87.89,116362.27,0,17.29,19.22,7.97
1325,0,12735993,31423,287.81,116650.09,2,12735993,0,12735993,31423,287.81,88.04,116650.09,1,19.18,19.22,8.04
1326,0,12735993,0,0.00,116650.09,2,12746368,10375,12735993,0,0.00,87.97,116650.09,0,20.19,19.19,8.00
1327,0,12735993,0,0.00,116650.09,2,12752246,16253,12735993,0,0.00,87.91,116650.09,1,21.34,19.00,8.07
1328,0,12735993,0,0.00,116650.09,2,12756744,20751,12735993,0,0.00,87.84,116650.09,1,20.83,19.83,7.96
1329,0,12744381,8388,76.83,116726.91,2,12760938,16557,12744381,8388,76.83,87.83,116726.91,0,19.38,19.83,7.88
1330,0,12744381,0,0.00,116726.91,2,12764896,20515,12744381,0,0.00,87.76,116726.91,1,20.03,19.03,7.95
1331,0,12744381,0,0.00,116726.91,2,12768177,23796,12744381,0,0.00,87.70,116726.91,0,19.64,18.64,7.86
1332,0,12744381,0,0.00,116726.91,2,12770962,26581,12744381,0,0.00,87.63,116726.91,1,19.64,18.64,7.93
1333,0,12750085,5704,52.24,116779.15,2,12773814,23729,12750085,5704,52.24,87.61,116779.15,0,18.02,18.64,7.79
1334,0,12755897,5812,53.23,116832.38,2,12776720,20823,12755897,5812,53.23,87.58,116832.38,1,18.07,18.64,7.86
1335,0,12761799,5902,54.06,116886.45,2,12779671,17872,12761799,5902,54.06,87.56,116886.45,0,17.26,18.64,7.78
1336,0,12768539,6740,61.73,116948.17,2,12783041,14502,12768539,6740,61.73,87.54,116948.17,1,17.84,18.64,7.85
1337,0,12777805,9266,84.87,117033.04,2,12787674,9869,12777805,9266,84.87,87.53,117033.04,0,16.37,18.64,7.73
1338,0,12800002,22197,203.30,117236.34,2,12800002,0,12800002,22197,203.30,87.62,117236.34,0,17.43,18.64,7.80
1339,0,12831197,31195,285.72,117522.06,2,12831197,0,12831197,31195,285.72,87.77,117522.06,1,18.49,18.64,7.87
1340,0,12831197,0,0.00,117522.06,2,12841500,10303,12831197,0,0.00,87.70,117522.06,0,18.79,17.79,7.79
1341,0,12831197,0,0.00,117522.06,2,12847278,16081,12831197,0,0.00,87.64,117522.06,1,19.82,18.82,7.86
1342,0,12841359,10162,93.07,117615.14,2,12852359,11000,12841359,10162,93.07,87.64,117615.14,0,18.34,18.82,7.78
1343,0,12841359,0,0.00,117615.14,2,12857171,15812,12841359,0,0.00,87.58,117615.14,1,19.29,18.29,7.85
1344,0,12850953,9594,87.87,117703.01,2,12861968,11015,12850953,9594,87.87,87.58,117703.01,0,18.13,18.29,7.78
1345,0,12850953,0,0.00,117703.01,2,12866841,15888,12850953,0,0.00,87.51,117703.01,1,18.32,17.32,7.84
1346,0,12850953,0,0.00,117703.01,2,12870048,19095,12850953,0,0.00,87.45,117703.01,1,18.07,17.07,7.80
1347,0,12850953,0,0.00,117703.01,2,12872734,21781,12850953,0,0.00,87.38,117703.01,0,17.23,16.23,7.71
1348,0,12850953,0,0.00,117703.01,2,12875230,24277,12850953,0,0.00,87.32,117703.01,1,17.23,16.23,7.78
1349,0,12855937,4984,45.65,117748.66,2,12877722,21785,12855937,4984,45.65,87.29,117748.66,0,15.82,16.23,7.71
1350,0,12861605,5668,51.91,117800.57,2,12880556,18951,12861605,5668,51.91,87.26,117800.57,1,15.86,16.23,7.77
1351,0,12868743,7138,65.38,117865.95,2,12884125,15382,12868743,7138,65.38,87.24,117865.95,0,14.74,16.23,7.65
1352,0,12878485,9742,89.23,117955.18,2,12888996,10511,12878485,9742,89.23,87.24,117955.18,1,15.98,16.23,7.72
1353,0,12896469,17984,164.72,118119.90,2,12897988,1519,12896469,17984,164.72,87.30,118119.90,0,14.82,16.23,7.65
1354,0,12927975,31506,288.57,118408.46,2,12927975,0,12927975,31506,288.57,87.45,118408.46,0,15.51,16.23,7.72
1355,0,12927975,0,0.00,118408.46,2,12938196,10221,12927975,0,0.00,87.39,118408.46,1,16.55,15.55,7.79
1356,0,12948209,20234,185.32,118593.79,2,12948313,104,12948209,20234,185.32,87.46,118593.79,1,14.76,15.55,7.63
1357,0,12979711,31502,288.53,118882.32,2,12979711,0,12979711,31502,288.53,87.61,118882.32,0,14.74,15.55,7.58
1358,0,12979711,0,0.00,118882.32,2,12990145,10434,12979711,0,0.00,87.54,118882.32,0,16.12,15.12,7.65
1359,0,12979711,0,0.00,118882.32,2,12995629,15918,12979711,0,0.00,87.48,118882.32,1,16.78,15.78,7.72
1360,0,12979711,0,0.00,118882.32,2,12999828,20117,12979711,0,0.00,87.41,118882.32,1,16.62,15.62,7.63
1361,0,12987507,7796,71.40,118953.72,2,13003726,16219,12987507,7796,71.40,87.40,118953.72,0,15.43,15.62,7.57
1362,0,12995841,8334,76.33,119030.05,2,13007893,12052,12995841,8334,76.33,87.39,119030.05,1,15.50,15.62,7.64
1363,0,13008795,12954,118.65,119148.70,2,13014370,5575,13008795,12954,118.65,87.42,119148.70,0,15.61,15.62,7.60
1364,0,13008795,0,0.00,119148.70,2,13021863,13068,13008795,0,0.00,87.35,119148.70,1,15.94,14.94,7.67
1365,0,13022759,13964,127.90,119276.59,2,13028845,6086,13022759,13964,127.90,87.38,119276.59,0,14.77,14.94,7.60
1366,0,13022759,0,0.00,119276.59,2,13035673,12914,13022759,0,0.00,87.32,119276.59,1,15.34,14.34,7.66
1367,0,13037759,15000,137.39,119413.98,2,13043173,5414,13037759,15000,137.39,87.35,119413.98,0,14.07,14.34,7.57
1368,0,13037759,0,0.00,119413.98,2,13050552,12793,13037759,0,0.00,87.29,119413.98,1,14.63,13.63,7.64
1369,0,13037759,0,0.00,119413.98,2,13055244,17485,13037759,0,0.00,87.23,119413.98,0,13.66,12.66,7.58
1370,0,13037759,0,0.00,119413.98,2,13058167,20408,13037759,0,0.00,87.16,119413.98,1,14.00,13.00,7.65
1371,0,13043901,6142,56.26,119470.24,2,13061238,17337,13043901,6142,56.26,87.14,119470.24,0,12.31,13.00,7.53
1372,0,13052479,8578,78.57,119548.80,2,13065527,13048,13052479,8578,78.57,87.13,119548.80,1,12.52,13.00,7.60
1373,0,13066697,14218,130.22,119679.03,2,13072636,5939,13066697,14218,130.22,87.17,119679.03,0,11.49,13.00,7.54
1374,0,13094699,28002,256.47,119935.50,2,13094699,0,13094699,28002,256.47,87.29,119935.50,1,12.60,13.00,7.61
1375,0,13126176,31477,288.30,120223.80,2,13126176,0,13126176,31477,288.30,87.44,120223.80,0,11.67,13.00,7.53
1376,0,13126176,0,0.00,120223.80,2,13136530,10354,13126176,0,0.00,87.37,120223.80,1,14.65,13.65,7.60
1377,0,13126176,0,0.00,120223.80,2,13142273,16097,13126176,0,0.00,87.31,120223.80,0,14.17,13.17,7.56
1378,0,13126176,0,0.00,120223.80,2,13146655,20479,13126176,0,0.00,87.25,120223.80,0,14.69,13.69,7.63
1379,0,13126176,0,0.00,120223.80,2,13150448,24272,13126176,0,0.00,87.18,120223.80,1,14.98,13.98,7.70
1380,0,13132790,6614,60.58,120284.38,2,13153755,20965,13132790,6614,60.58,87.16,120284.38,0,13.25,13.98,7.59
1381,0,13139710,6920,63.38,120347.77,2,13157215,17505,13139710,6920,63.38,87.15,120347.77,1,13.31,13.98,7.66
1382,0,13146946,7236,66.28,120414.04,2,13160833,13887,13146946,7236,66.28,87.13,120414.04,1,12.46,13.98,7.64
1383,0,13156098,9152,83.82,120497.86,2,13165409,9311,13156098,9152,83.82,87.13,120497.86,0,12.17,13.98,7.58
1384,0,13179618,23520,215.42,120713.28,2,13179618,0,13179618,23520,215.42,87.22,120713.28,1,12.25,13.98,7.65
1385,0,13211454,31836,291.59,121004.88,2,13211454,0,13211454,31836,291.59,87.37,121004.88,0,12.36,13.98,7.59
1386,0,13243091,31637,289.77,121294.64,2,13243091,0,13243091,31637,289.77,87.51,121294.64,1,13.63,13.98,7.66
1387,0,13274818,31727,290.59,121585.23,2,13274818,0,13274818,31727,290.59,87.66,121585.23,0,13.67,13.98,7.59
1388,0,13274818,0,0.00,121585.23,2,13285220,10402,13274818,0,0.00,87.60,121585.23,1,14.87,13.87,7.66
1389,0,13274818,0,0.00,121585.23,2,13291189,16371,13274818,0,0.00,87.53,121585.23,0,14.38,13.38,7.60
1390,0,13274818,0,0.00,121585.23,2,13295693,20875,13274818,0,0.00,87.47,121585.23,1,15.60,14.60,7.67
1391,0,13274818,0,0.00,121585.23,2,13299606,24788,13274818,0,0.00,87.41,121585.23,0,14.72,13.72,7.61
1392,0,13274818,0,0.00,121585.23,2,13303258,28440,13274818,0,0.00,87.35,121585.23,0,14.72,13.72,7.68
1393,0,13274818,0,0.00,121585.23,2,13306581,31763,13274818,0,0.00,87.28,121585.23,1,15.94,14.94,7.75
1394,0,13281038,6220,56.97,121642.20,2,13309691,28653,13281038,6220,56.97,87.26,121642.20,0,14.37,14.94,7.63
1395,0,13287002,5964,54.62,121696.82,2,13312673,25671,13287002,5964,54.62,87.24,121696.82,1,14.52,14.94,7.70
1396,0,13292876,5874,53.80,121750.62,2,13315610,22734,13292876,5874,53.80,87.21,121750.62,0,13.17,14.94,7.63
1397,0,13298846,5970,54.68,121805.30,2,13318595,19749,13298846,5970,54.68,87.19,121805.30,1,13.22,14.94,7.69
1398,0,13304702,5856,53.64,121858.94,2,13321523,16821,13304702,5856,53.64,87.17,121858.94,0,12.56,14.94,7.60
1399,0,13310832,6130,56.15,121915.09,2,13324588,13756,13310832,6130,56.15,87.14,121915.09,1,12.77,14.94,7.67
1400,0,13320068,9236,84.59,121999.68,2,13329206,9138,13320068,9236,84.59,87.14,121999.68,0,11.58,14.94,7.59
1401,0,13342936,22868,209.45,122209.12,2,13342936,0,13342936,22868,209.45,87.23,122209.12,1,11.76,14.94,7.66
1402,0,13371228,28292,259.13,122468.26,2,13371228,0,13371228,28292,259.13,87.35,122468.26,0,11.06,14.94,7.58
1403,0,13403251,32023,293.30,122761.55,2,13403251,0,13403251,32023,293.30,87.50,122761.55,1,12.20,14.94,7.65
1404,0,13435228,31977,292.88,123054.44,2,13435228,0,13435228,31977,292.88,87.65,123054.44,1,11.46,14.94,7.58
1405,0,13467045,31817,291.41,123345.85,2,13467045,0,13467045,31817,291.41,87.79,123345.85,0,11.44,14.94,7.54
1406,0,13467045,0,0.00,123345.85,2,13477319,10274,13467045,0,0.00,87.73,123345.85,1,15.17,14.17,7.60
1407,0,13467045,0,0.00,123345.85,2,13483265,16220,13467045,0,0.00,87.67,123345.85,0,16.51,15.51,7.55
1408,0,13467045,0,0.00,123345.85,2,13487746,20701,13467045,0,0.00,87.60,123345.85,1,16.69,15.69,7.61
1409,0,13467045,0,0.00,123345.85,2,13491563,24518,13467045,0,0.00,87.54,123345.85,0,16.05,15.05,7.56
1410,0,13467045,0,0.00,123345.85,2,13494886,27841,13467045,0,0.00,87.48,123345.85,0,16.13,15.13,7.63
1411,0,13467045,0,0.00,123345.85,2,13497991,30946,13467045,0,0.00,87.42,123345.85,1,16.13,15.13,7.69
1412,0,13473059,6014,55.08,123400.94,2,13500998,27939,13473059,6014,55.08,87.39,123400.94,0,14.31,15.13,7.58
1413,0,13479043,5984,54.81,123455.74,2,13503990,24947,13479043,5984,54.81,87.37,123455.74,1,14.37,15.13,7.65
1414,0,13484745,5702,52.23,123507.97,2,13506841,22096,13484745,5702,52.23,87.35,123507.97,0,13.21,15.13,7.59
1415,0,13490809,6064,55.54,123563.51,2,13509873,19064,13490809,6064,55.54,87.32,123563.51,1,13.60,15.13,7.66
1416,0,13496895,6086,55.74,123619.25,2,13512916,16021,13496895,6086,55.74,87.30,123619.25,1,12.28,15.13,7.57
1417,0,13503423,6528,59.79,123679.04,2,13516180,12757,13503423,6528,59.79,87.28,123679.04,0,11.06,15.13,7.50
1418,0,13516017,12594,115.35,123794.39,2,13522477,6460,13516017,12594,115.35,87.30,123794.39,0,11.26,15.13,7.57
1419,0,13544404,28387,260.00,124054.39,2,13544404,0,13544404,28387,260.00,87.42,124054.39,1,12.28,15.13,7.64
1420,0,13576526,32122,294.21,124348.60,2,13576526,0,13576526,32122,294.21,87.57,124348.60,0,12.40,15.13,7.59
1421,0,13608523,31997,293.06,124641.66,2,13608523,0,13608523,31997,293.06,87.71,124641.66,1,14.08,15.13,7.66
1422,0,13640281,31758,290.87,124932.54,2,13640281,0,13640281,31758,290.87,87.86,124932.54,1,13.47,15.13,7.61
1423,0,13672437,32156,294.52,125227.05,2,13672437,0,13672437,32156,294.52,88.00,125227.05,0,15.06,15.13,7.56
1424,0,13672437,0,0.00,125227.05,2,13682803,10366,13672437,0,0.00,87.94,125227.05,1,19.62,18.62,7.62
1425,0,13672437,0,0.00,125227.05,2,13688677,16240,13672437,0,0.00,87.88,125227.05,0,18.68,17.68,7.59
1426,0,13672437,0,0.00,125227.05,2,13692912,20475,13672437,0,0.00,87.82,125227.05,0,19.54,18.54,7.66
1427,0,13672437,0,0.00,125227.05,2,13696534,24097,13672437,0,0.00,87.76,125227.05,0,19.63,18.63,7.72
1428,0,13672437,0,0.00,125227.05,2,13699681,27244,13672437,0,0.00,87.69,125227.05,1,19.63,18.63,7.78
1429,0,13678539,6102,55.89,125282.95,2,13702732,24193,13678539,6102,55.89,87.67,125282.95,1,17.95,18.63,7.68
1430,0,13684921,6382,58.45,125341.40,2,13705923,21002,13684921,6382,58.45,87.65,125341.40,0,17.38,18.63,7.67
1431,0,13691099,6178,56.58,125397.98,2,13709012,17913,13691099,6178,56.58,87.63,125397.98,1,17.59,18.63,7.74
1432,0,13697257,6158,56.40,125454.38,2,13712091,14834,13697257,6158,56.40,87.61,125454.38,1,16.21,18.63,7.67
1433,0,13704709,7452,68.25,125522.64,2,13715817,11108,13704709,7452,68.25,87.59,125522.64,0,15.65,18.63,7.65
1434,0,13721923,17214,157.66,125680.30,2,13724424,2501,13721923,17214,157.66,87.64,125680.30,1,15.94,18.63,7.72
1435,0,13753171,31248,286.20,125966.51,2,13753171,0,13753171,31248,286.20,87.78,125966.51,0,15.70,18.63,7.68
1436,0,13784581,31410,287.69,126254.20,2,13784581,0,13784581,31410,287.69,87.92,126254.20,1,16.81,18.63,7.74
1437,0,13816001,31420,287.78,126541.97,2,13816001,0,13816001,31420,287.78,88.06,126541.97,0,16.22,18.63,7.69
1438,0,13847290,31289,286.58,126828.55,2,13847290,0,13847290,31289,286.58,88.20,126828.55,0,18.25,18.63,7.76
1439,0,13847290,0,0.00,126828.55,2,13857489,10199,13847290,0,0.00,88.14,126828.55,1,20.86,19.86,7.82
1440,0,13847290,0,0.00,126828.55,2,13863147,15857,13847290,0,0.00,88.08,126828.55,1,20.92,19.92,7.75
1441,0,13847290,0,0.00,126828.55,2,13867418,20128,13847290,0,0.00,88.01,126828.55,0,20.70,19.70,7.75
1442,0,13847290,0,0.00,126828.55,2,13871029,23739,13847290,0,0.00,87.95,126828.55,1,20.70,19.70,7.81
1443,0,13854474,7184,65.80,126894.35,2,13874621,20147,13854474,7184,65.80,87.94,126894.35,0,19.41,19.70,7.75
1444,0,13854474,0,0.00,126894.35,2,13878016,23542,13854474,0,0.00,87.88,126894.35,0,22.78,19.00,7.82
1445,0,13854474,0,0.00,126894.35,2,13881002,26528,13854474,0,0.00,87.82,126894.35,1,23.08,19.00,7.88
1446,0,13854474,0,0.00,126894.35,2,13883774,29300,13854474,0,0.00,87.76,126894.35,1,21.56,19.00,7.79
1447,0,13854474,0,0.00,126894.35,2,13886474,32000,13854474,0,0.00,87.69,126894.35,0,20.10,19.10,7.71
1448,0,13854474,0,0.00,126894.35,2,13888859,34385,13854474,0,0.00,87.63,126894.35,1,20.18,19.18,7.77
1449,0,13859078,4604,42.17,126936.52,2,13891161,32083,13859078,4604,42.17,87.60,126936.52,0,18.52,19.18,7.68
1450,0,13863862,4784,43.82,126980.34,2,13893553,29691,13863862,4784,43.82,87.57,126980.34,1,18.77,19.18,7.74
1451,0,13868600,4738,43.40,127023.73,2,13895922,27322,13868600,4738,43.40,87.54,127023.73,0,17.52,19.18,7.66
1452,0,13873440,4840,44.33,127068.06,2,13898342,24902,13873440,4840,44.33,87.51,127068.06,1,17.57,19.18,7.72
1453,0,13878360,4920,45.06,127113.12,2,13900802,22442,13878360,4920,45.06,87.48,127113.12,0,16.19,19.18,7.63
1454,0,13883560,5200,47.63,127160.75,2,13903402,19842,13883560,5200,47.63,87.46,127160.75,1,16.41,19.18,7.70
1455,0,13888750,5190,47.54,127208.29,2,13905997,17247,13888750,5190,47.54,87.43,127208.29,0,15.44,19.18,7.64
1456,0,13894622,5872,53.78,127262.07,2,13908933,14311,13894622,5872,53.78,87.41,127262.07,1,15.65,19.18,7.70
1457,0,13903978,9356,85.69,127347.76,2,13913611,9633,13903978,9356,85.69,87.40,127347.76,0,14.20,19.18,7.62
1458,0,13924632,20654,189.17,127536.93,2,13924632,0,13924632,20654,189.17,87.47,127536.93,0,14.66,19.18,7.68
1459,0,13956071,31439,287.95,127824.88,2,13956071,0,13956071,31439,287.95,87.61,127824.88,1,15.52,19.18,7.74
1460,0,13987581,31510,288.60,128113.48,2,13987581,0,13987581,31510,288.60,87.75,128113.48,1,15.36,19.18,7.70
1461,0,14019729,32148,294.45,128407.93,2,14019729,0,14019729,32148,294.45,87.89,128407.93,0,15.89,19.18,7.70
1462,0,14050956,31227,286.01,128693.95,2,14050956,0,14050956,31227,286.01,88.03,128693.95,1,18.56,19.18,7.76
1463,0,14050956,0,0.00,128693.95,2,14061246,10290,14050956,0,0.00,87.97,128693.95,0,20.67,19.67,7.68
1464,0,14050956,0,0.00,128693.95,2,14067053,16097,14050956,0,0.00,87.91,128693.95,1,21.24,19.00,7.74
1465,0,14050956,0,0.00,128693.95,2,14071455,20499,14050956,0,0.00,87.85,128693.95,0,20.52,19.52,7.68
1466,0,14050956,0,0.00,128693.95,2,14075228,24272,14050956,0,0.00,87.79,128693.95,1,20.57,19.57,7.75
1467,0,14058242,7286,66.73,128760.68,2,14078871,20629,14058242,7286,66.73,87.77,128760.68,0,19.01,19.57,7.66
1468,0,14065058,6816,62.43,128823.11,2,14082279,17221,14065058,6816,62.43,87.75,128823.11,0,19.26,19.57,7.72
1469,0,14072472,7414,67.91,128891.01,2,14085986,13514,14072472,7414,67.91,87.74,128891.01,1,19.39,19.57,7.79
1470,0,14081714,9242,84.65,128975.66,2,14090607,8893,14081714,9242,84.65,87.74,128975.66,1,17.80,19.57,7.66
1471,0,14105493,23779,217.79,129193.45,2,14105493,0,14105493,23779,217.79,87.83,129193.45,0,17.14,19.57,7.65
1472,0,14136923,31430,287.87,129481.32,2,14136923,0,14136923,31430,287.87,87.96,129481.32,0,17.81,19.57,7.71
1473,0,14167752,30829,282.37,129763.69,2,14167752,0,14167752,30829,282.37,88.09,129763.69,1,19.51,19.57,7.77
1474,0,14167752,0,0.00,129763.69,2,14177655,9903,14167752,0,0.00,88.04,129763.69,1,19.89,18.89,7.66
1475,0,14167752,0,0.00,129763.69,2,14183236,15484,14167752,0,0.00,87.98,129763.69,0,20.47,19.47,7.67
1476,0,14167752,0,0.00,129763.69,2,14187545,19793,14167752,0,0.00,87.92,129763.69,1,21.56,19.00,7.73
1477,0,14167752,0,0.00,129763.69,2,14191273,23521,14167752,0,0.00,87.86,129763.69,0,20.33,19.33,7.66
1478,0,14167752,0,0.00,129763.69,2,14194660,26908,14167752,0,0.00,87.80,129763.69,0,20.63,19.63,7.72
1479,0,14167752,0,0.00,129763.69,2,14197863,30111,14167752,0,0.00,87.74,129763.69,1,20.92,19.92,7.78
1480,0,14167752,0,0.00,129763.69,2,14200791,33039,14167752,0,0.00,87.68,129763.69,1,20.31,19.31,7.72
1481,0,14167752,0,0.00,129763.69,2,14203469,35717,14167752,0,0.00,87.62,129763.69,0,19.75,18.75,7.71
1482,0,14167752,0,0.00,129763.69,2,14206000,38248,14167752,0,0.00,87.56,129763.69,1,20.01,19.01,7.77
1483,0,14172476,4724,43.27,129806.95,2,14208362,35886,14172476,4724,43.27,87.53,129806.95,0,18.81,19.01,7.72
1484,0,14177080,4604,42.17,129849.12,2,14210664,33584,14177080,4604,42.17,87.50,129849.12,1,18.85,19.01,7.78
1485,0,14181968,4888,44.77,129893.90,2,14213108,31140,14181968,4888,44.77,87.47,129893.90,0,17.86,19.01,7.72
1486,0,14181968,0,0.00,129893.90,2,14215461,33493,14181968,0,0.00,87.41,129893.90,1,19.83,18.83,7.79
1487,0,14186440,4472,40.96,129934.85,2,14217697,31257,14186440,4472,40.96,87.38,129934.85,0,18.73,18.83,7.71
1488,0,14190918,4478,41.01,129975.87,2,14219936,29018,14190918,4478,41.01,87.35,129975.87,1,18.77,18.83,7.78
1489,0,14195408,4490,41.12,130016.99,2,14222181,26773,14195408,4490,41.12,87.32,130016.99,0,17.37,18.83,7.71
1490,0,14199900,4492,41.14,130058.13,2,14224427,24527,14199900,4492,41.14,87.29,130058.13,0,17.41,18.83,7.77
1491,0,14204402,4502,41.23,130099.37,2,14226678,22276,14204402,4502,41.23,87.26,130099.37,1,17.45,18.83,7.83
1492,0,14208964,4562,41.78,130141.16,2,14228959,19995,14208964,4562,41.78,87.23,130141.16,1,16.29,18.83,7.75
1493,0,14213830,4866,44.57,130185.72,2,14231392,17562,14213830,4866,44.57,87.20,130185.72,0,15.88,18.83,7.71
1494,0,14219378,5548,50.81,130236.54,2,14234166,14788,14219378,5548,50.81,87.17,130236.54,1,16.14,18.83,7.77
1495,0,14228246,8868,81.22,130317.76,2,14238600,10354,14228246,8868,81.22,87.17,130317.76,0,15.09,18.83,7.73
1496,0,14244984,16738,153.30,130471.06,2,14246969,1985,14244984,16738,153.30,87.21,130471.06,1,15.27,18.83,7.80
1497,0,14275576,30592,280.19,130751.26,2,14275576,0,14275576,30592,280.19,87.34,130751.26,0,14.37,18.83,7.72
1498,0,14305320,29744,272.43,131023.69,2,14305320,0,14305320,29744,272.43,87.47,131023.69,0,15.42,18.83,7.78
1499,0,14335471,30151,276.16,131299.84,2,14335471,0,14335471,30151,276.16,87.59,131299.84,1,16.83,18.83,7.84
1500,0,14365232,29761,272.58,131572.42,2,14365232,0,14365232,29761,272.58,87.71,131572.42,0,17.75,18.83,7.81
1501,0,14365232,0,0.00,131572.42,2,14375227,9995,14365232,0,0.00,87.66,131572.42,1,20.43,19.43,7.87
1502,0,14384906,19674,180.20,131752.62,2,14385064,158,14384906,19674,180.20,87.72,131752.62,0,19.21,19.43,7.78
1503,0,14384906,0,0.00,131752.62,2,14395465,10559,14384906,0,0.00,87.66,131752.62,1,19.46,18.46,7.84
1504,0,14403500,18594,170.30,131922.92,2,14404762,1262,14403500,18594,170.30,87.71,131922.92,0,17.90,18.46,7.76
1505,0,14403500,0,0.00,131922.92,2,14414050,10550,14403500,0,0.00,87.66,131922.92,1,18.62,17.62,7.82
1506,0,14403500,0,0.00,131922.92,2,14419581,16081,14403500,0,0.00,87.60,131922.92,0,18.03,17.03,7.79
1507,0,14403500,0,0.00,131922.92,2,14423049,19549,14403500,0,0.00,87.54,131922.92,1,18.95,17.95,7.85
1508,0,14410352,6852,62.76,131985.69,2,14426475,16123,14410352,6852,62.76,87.52,131985.69,0,17.61,17.95,7.79
1509,0,14419932,9580,87.74,132073.42,2,14431265,11333,14419932,9580,87.74,87.52,132073.42,1,17.73,17.95,7.85
1510,0,14434248,14316,131.12,132204.55,2,14438423,4175,14434248,14316,131.12,87.55,132204.55,0,17.23,17.95,7.80
1511,0,14434248,0,0.00,132204.55,2,14446325,12077,14434248,0,0.00,87.49,132204.55,1,18.58,17.58,7.86
1512,0,14434248,0,0.00,132204.55,2,14451525,17277,14434248,0,0.00,87.44,132204.55,1,17.69,16.69,7.81
1513,0,14434248,0,0.00,132204.55,2,14454972,20724,14434248,0,0.00,87.38,132204.55,0,18.24,17.24,7.76
1514,0,14434248,0,0.00,132204.55,2,14457573,23325,14434248,0,0.00,87.32,132204.55,1,18.24,17.24,7.82
1515,0,14439310,5062,46.36,132250.91,2,14460104,20794,14439310,5062,46.36,87.29,132250.91,0,17.14,17.24,7.79
1516,0,14445446,6136,56.20,132307.11,2,14463172,17726,14445446,6136,56.20,87.27,132307.11,1,17.18,17.24,7.85
1517,0,14452602,7156,65.54,132372.66,2,14466750,14148,14452602,7156,65.54,87.26,132372.66,0,16.46,17.24,7.79
1518,0,14452602,0,0.00,132372.66,2,14470623,18021,14452602,0,0.00,87.20,132372.66,0,17.67,16.67,7.85
1519,0,14452602,0,0.00,132372.66,2,14473683,21081,14452602,0,0.00,87.14,132372.66,1,17.67,16.67,7.91
1520,0,14458676,6074,55.63,132428.28,2,14476720,18044,14458676,6074,55.63,87.12,132428.28,0,16.44,16.67,7.86
1521,0,14466636,7960,72.91,132501.19,2,14480700,14064,14466636,7960,72.91,87.11,132501.19,1,16.50,16.67,7.92
1522,0,14466636,0,0.00,132501.19,2,14484631,17995,14466636,0,0.00,87.06,132501.19,0,16.80,15.80,7.87
1523,0,14466636,0,0.00,132501.19,2,14487695,21059,14466636,0,0.00,87.00,132501.19,1,17.08,16.08,7.93
1524,0,14472666,6030,55.23,132556.42,2,14490710,18044,14472666,6030,55.23,86.98,132556.42,1,15.91,16.08,7.89
1525,0,14480898,8232,75.40,132631.83,2,14494826,13928,14480898,8232,75.40,86.97,132631.83,0,14.99,16.08,7.86
1526,0,14491898,11000,100.75,132732.58,2,14500326,8428,14491898,11000,100.75,86.98,132732.58,1,15.64,16.08,7.92
1527,0,14513523,21625,198.07,132930.64,2,14513523,0,14513523,21625,198.07,87.05,132930.64,0,15.34,16.08,7.87
1528,0,14513523,0,0.00,132930.64,2,14524218,10695,14513523,0,0.00,87.00,132930.64,1,16.31,15.31,7.93
1529,0,14513523,0,0.00,132930.64,2,14529714,16191,14513523,0,0.00,86.94,132930.64,0,16.41,15.41,7.86
1530,0,14513523,0,0.00,132930.64,2,14533821,20298,14513523,0,0.00,86.88,132930.64,1,16.59,15.59,7.92
1531,0,14521589,8066,73.88,133004.52,2,14537854,16265,14521589,8066,73.88,86.87,133004.52,0,15.42,15.59,7.88
1532,0,14521589,0,0.00,133004.52,2,14541655,20066,14521589,0,0.00,86.82,133004.52,1,16.10,15.10,7.94
1533,0,14528553,6964,63.78,133068.30,2,14545137,16584,14528553,6964,63.78,86.80,133068.30,0,14.67,15.10,7.85
1534,0,14536449,7896,72.32,133140.62,2,14549085,12636,14536449,7896,72.32,86.79,133140.62,1,14.76,15.10,7.91
1535,0,14551977,15528,142.22,133282.84,2,14556849,4872,14551977,15528,142.22,86.83,133282.84,0,13.81,15.10,7.85
1536,0,14581145,29168,267.15,133549.98,2,14581145,0,14581145,29168,267.15,86.95,133549.98,1,14.50,15.10,7.91
1537,0,14613476,32331,296.12,133846.11,2,14613476,0,14613476,32331,296.12,87.08,133846.11,0,14.10,15.10,7.84
1538,0,14613476,0,0.00,133846.11,2,14624185,10709,14613476,0,0.00,87.03,133846.11,0,15.37,14.37,7.90
1539,0,14613476,0,0.00,133846.11,2,14629843,16367,14613476,0,0.00,86.97,133846.11,1,15.79,14.79,7.96
1540,0,14624732,11256,103.09,133949.20,2,14635471,10739,14624732,11256,103.09,86.98,133949.20,0,14.62,14.79,7.90
1541,0,14624732,0,0.00,133949.20,2,14640805,16073,14624732,0,0.00,86.92,133949.20,1,14.79,13.79,7.96
1542,0,14624732,0,0.00,133949.20,2,14644548,19816,14624732,0,0.00,86.87,133949.20,0,13.81,12.81,7.89
1543,0,14624732,0,0.00,133949.20,2,14647702,22970,14624732,0,0.00,86.81,133949.20,1,13.97,12.97,7.95
1544,0,14630610,5878,53.84,134003.05,2,14650641,20031,14630610,5878,53.84,86.79,134003.05,0,12.80,12.97,7.89
1545,0,14630610,0,0.00,134003.05,2,14653499,22889,14630610,0,0.00,86.73,134003.05,1,13.18,12.18,7.95
1546,0,14630610,0,0.00,134003.05,2,14656019,25409,14630610,0,0.00,86.68,134003.05,0,12.26,11.26,7.90
1547,0,14630610,0,0.00,134003.05,2,14658269,27659,14630610,0,0.00,86.62,134003.05,1,12.43,11.43,7.96
1548,0,14635266,4656,42.64,134045.69,2,14660597,25331,14635266,4656,42.64,86.59,134045.69,1,11.24,11.43,7.90
1549,0,14640220,4954,45.37,134091.06,2,14663074,22854,14640220,4954,45.37,86.57,134091.06,0,10.53,11.43,7.87
1550,0,14645586,5366,49.15,134140.22,2,14665757,20171,14645586,5366,49.15,86.54,134140.22,1,10.66,11.43,7.93
1551,0,14651428,5842,53.51,134193.72,2,14668678,17250,14651428,5842,53.51,86.52,134193.72,0,9.60,11.43,7.88
1552,0,14658656,7228,66.20,134259.92,2,14672292,13636,14658656,7228,66.20,86.51,134259.92,0,9.77,11.43,7.94
1553,0,14671222,12566,115.09,134375.02,2,14678575,7353,14671222,12566,115.09,86.53,134375.02,1,9.83,11.43,8.00
1554,0,14698864,27642,253.18,134628.19,2,14698864,0,14698864,27642,253.18,86.63,134628.19,1,8.74,11.43,7.89
1555,0,14731225,32361,296.40,134924.59,2,14731225,0,14731225,32361,296.40,86.77,134924.59,0,8.39,11.43,7.87
1556,0,14763387,32162,294.57,135219.16,2,14763387,0,14763387,32162,294.57,86.90,135219.16,1,10.04,11.43,7.93
1557,0,14795218,31831,291.54,135510.70,2,14795218,0,14795218,31831,291.54,87.03,135510.70,0,10.47,11.43,7.85
1558,0,14795218,0,0.00,135510.70,2,14805560,10342,14795218,0,0.00,86.98,135510.70,0,12.57,11.57,7.91
1559,0,14795218,0,0.00,135510.70,2,14811600,16382,14795218,0,0.00,86.92,135510.70,1,13.75,12.75,7.97
1560,0,14805718,10500,96.17,135606.88,2,14816850,11132,14805718,10500,96.17,86.93,135606.88,0,12.46,12.75,7.92
1561,0,14821968,16250,148.84,135755.72,2,14824975,3007,14821968,16250,148.84,86.97,135755.72,0,12.61,12.75,7.98
1562,0,14821968,0,0.00,135755.72,2,14833874,11906,14821968,0,0.00,86.91,135755.72,1,13.60,12.60,8.04
1563,0,14821968,0,0.00,135755.72,2,14839157,17189,14821968,0,0.00,86.86,135755.72,0,12.97,11.97,7.96
1564,0,14821968,0,0.00,135755.72,2,14842503,20535,14821968,0,0.00,86.80,135755.72,1,13.28,12.28,8.02
1565,0,14821968,0,0.00,135755.72,2,14845166,23198,14821968,0,0.00,86.74,135755.72,0,12.06,11.06,7.96
1566,0,14821968,0,0.00,135755.72,2,14847507,25539,14821968,0,0.00,86.69,135755.72,1,12.11,11.11,8.02
1567,0,14821968,0,0.00,135755.72,2,14849513,27545,14821968,0,0.00,86.63,135755.72,1,11.24,10.24,8.00
1568,0,14821968,0,0.00,135755.72,2,14851528,29560,14821968,0,0.00,86.58,135755.72,0,10.51,9.51,7.98
1569,0,14821968,0,0.00,135755.72,2,14853503,31535,14821968,0,0.00,86.52,135755.72,1,10.51,9.51,8.04
1570,0,14821968,0,0.00,135755.72,2,14855415,33447,14821968,0,0.00,86.47,135755.72,1,9.67,8.67,8.02
1571,0,14821968,0,0.00,135755.72,2,14857269,35301,14821968,0,0.00,86.41,135755.72,0,9.07,8.07,8.02
1572,0,14821968,0,0.00,135755.72,2,14859069,37101,14821968,0,0.00,86.36,135755.72,1,9.18,8.18,8.08
1573,0,14821968,0,0.00,135755.72,2,14860823,38855,14821968,0,0.00,86.30,135755.72,0,8.25,8.00,8.06
1574,0,14825496,3528,32.31,135788.03,2,14862587,37091,14825496,3528,32.31,86.27,135788.03,1,8.76,9.76,8.12
1575,0,14829222,3726,34.13,135822.16,2,14864450,35228,14829222,3726,34.13,86.24,135822.16,0,7.87,9.76,8.09
1576,0,14833222,4000,36.64,135858.78,2,14866450,33228,14833222,4000,36.64,86.20,135858.78,1,8.02,9.76,8.15
1577,0,14837508,4286,39.26,135898.05,2,14868593,31085,14837508,4286,39.26,86.18,135898.05,0,6.86,9.76,8.11
1578,0,14842058,4550,41.67,135939.72,2,14870868,28810,14842058,4550,41.67,86.15,135939.72,0,7.23,9.76,8.16
1579,0,14846596,4538,41.56,135981.28,2,14873137,26541,14846596,4538,41.56,86.12,135981.28,1,7.27,9.76,8.22
1580,0,14851020,4424,40.52,136021.80,2,14875349,24329,14851020,4424,40.52,86.09,136021.80,1,6.17,9.76,8.18
1581,0,14855572,4552,41.69,136063.50,2,14877625,22053,14855572,4552,41.69,86.06,136063.50,0,5.73,9.76,8.14
1582,0,14860034,4462,40.87,136104.36,2,14879856,19822,14860034,4462,40.87,86.03,136104.36,1,5.77,9.76,8.19
1583,0,14864526,4492,41.14,136145.50,2,14882102,17576,14864526,4492,41.14,86.00,136145.50,0,4.77,9.76,8.16
1584,0,14869880,5354,49.04,136194.55,2,14884779,14899,14869880,5354,49.04,85.98,136194.55,1,4.81,9.76,8.22
1585,0,14878048,8168,74.81,136269.36,2,14888863,10815,14878048,8168,74.81,85.97,136269.36,0,3.73,9.76,8.15
1586,0,14897066,19018,174.19,136443.55,2,14898372,1306,14897066,19018,174.19,86.03,136443.55,0,4.30,9.76,8.21
1587,0,14931553,34487,315.87,136759.41,2,14931553,0,14931553,34487,315.87,86.17,136759.41,1,5.14,9.76,8.26
1588,0,14965902,34349,314.61,137074.02,2,14965902,0,14965902,34349,314.61,86.32,137074.02,1,6.27,9.76,8.17
1589,0,14999699,33797,309.55,137383.56,2,14999699,0,14999699,33797,309.55,86.46,137383.56,0,8.25,9.76,8.13
1590,0,15033631,33932,310.79,137694.34,2,15033631,0,15033631,33932,310.79,86.60,137694.34,1,9.53,9.76,8.19
1591,0,15067607,33976,311.19,138005.55,2,15067607,0,15067607,33976,311.19,86.74,138005.55,0,9.56,9.76,8.10
1592,0,15067607,0,0.00,138005.55,2,15078153,10546,15067607,0,0.00,86.69,138005.55,1,10.37,9.37,8.16
1593,0,15067607,0,0.00,138005.55,2,15084152,16545,15067607,0,0.00,86.63,138005.55,0,9.47,8.47,8.10
1594,0,15067607,0,0.00,138005.55,2,15088627,21020,15067607,0,0.00,86.58,138005.55,1,9.47,8.47,8.16
1595,0,15076001,8394,76.88,138082.42,2,15092824,16823,15076001,8394,76.88,86.57,138082.42,0,8.32,8.47,8.09
1596,0,15076001,0,0.00,138082.42,2,15096764,20763,15076001,0,0.00,86.52,138082.42,1,8.83,8.00,8.15
1597,0,15083025,7024,64.33,138146.75,2,15100276,17251,15083025,7024,64.33,86.50,138146.75,0,7.03,8.00,8.05
1598,0,15090187,7162,65.60,138212.36,2,15103857,13670,15090187,7162,65.60,86.49,138212.36,0,7.09,8.00,8.11
1599,0,15100209,10022,91.79,138304.14,2,15108868,8659,15100209,10022,91.79,86.49,138304.14,1,8.27,9.27,8.17
1600,0,15126988,26779,245.27,138549.42,2,15126988,0,15126988,26779,245.27,86.59,138549.42,0,7.61,9.27,8.11
1601,0,15126988,0,0.00,138549.42,2,15137889,10901,15126988,0,0.00,86.54,138549.42,1,9.57,8.57,8.17
1602,0,15126988,0,0.00,138549.42,2,15143483,16495,15126988,0,0.00,86.49,138549.42,0,8.62,8.00,8.07
1603,0,15137176,10188,93.31,138642.73,2,15148577,11401,15137176,10188,93.31,86.49,138642.73,0,9.76,10.76,8.13
1604,0,15153148,15972,146.29,138789.02,2,15156563,3415,15153148,15972,146.29,86.53,138789.02,1,10.14,10.76,8.18
1605,0,15184950,31802,291.28,139080.30,2,15184950,0,15184950,31802,291.28,86.65,139080.30,1,9.98,10.76,8.09
1606,0,15184950,0,0.00,139080.30,2,15195618,10668,15184950,0,0.00,86.60,139080.30,0,11.60,10.60,8.09
1607,0,15184950,0,0.00,139080.30,2,15201428,16478,15184950,0,0.00,86.55,139080.30,1,12.17,11.17,8.15
1608,0,15184950,0,0.00,139080.30,2,15205694,20744,15184950,0,0.00,86.49,139080.30,0,12.62,11.62,8.12
1609,0,15184950,0,0.00,139080.30,2,15209563,24613,15184950,0,0.00,86.44,139080.30,1,13.20,12.20,8.18
1610,0,15192056,7106,65.08,139145.38,2,15213116,21060,15192056,7106,65.08,86.43,139145.38,1,12.10,12.20,8.14
1611,0,15199206,7150,65.49,139210.88,2,15216691,17485,15199206,7150,65.49,86.41,139210.88,0,11.18,12.20,8.12
1612,0,15199206,0,0.00,139210.88,2,15219990,20784,15199206,0,0.00,86.36,139210.88,1,12.68,11.68,8.18
1613,0,15205308,6102,55.89,139266.75,2,15223041,17733,15205308,6102,55.89,86.34,139266.75,0,11.60,11.68,8.14
1614,0,15205308,0,0.00,139266.75,2,15225937,20629,15205308,0,0.00,86.29,139266.75,1,11.97,10.97,8.20
1615,0,15210736,5428,49.72,139316.47,2,15228651,17915,15210736,5428,49.72,86.26,139316.47,0,10.43,10.97,8.12
1616,0,15217218,6482,59.37,139375.84,2,15231892,14674,15217218,6482,59.37,86.25,139375.84,0,10.58,10.97,8.18
1617,0,15217218,0,0.00,139375.84,2,15234985,17767,15217218,0,0.00,86.19,139375.84,1,11.21,10.21,8.24
1618,0,15224122,6904,63.23,139439.08,2,15238437,14315,15224122,6904,63.23,86.18,139439.08,1,10.05,10.21,8.17
1619,0,15237178,13056,119.58,139558.66,2,15244965,7787,15237178,13056,119.58,86.20,139558.66,0,9.29,10.21,8.15
1620,0,15264348,27170,248.85,139807.52,2,15264348,0,15264348,27170,248.85,86.30,139807.52,1,9.53,10.21,8.21
1621,0,15297400,33052,302.73,140110.23,2,15297400,0,15297400,33052,302.73,86.43,140110.23,0,8.94,10.21,8.15
1622,0,15330576,33176,303.86,140414.09,2,15330576,0,15330576,33176,303.86,86.57,140414.09,1,9.52,10.21,8.20
1623,0,15330576,0,0.00,140414.09,2,15341308,10732,15330576,0,0.00,86.52,140414.09,0,10.59,9.59,8.19
1624,0,15330576,0,0.00,140414.09,2,15347259,16683,15330576,0,0.00,86.46,140414.09,1,11.25,10.25,8.24
1625,0,15330576,0,0.00,140414.09,2,15351796,21220,15330576,0,0.00,86.41,140414.09,0,10.97,9.97,8.16
1626,0,15330576,0,0.00,140414.09,2,15355648,25072,15330576,0,0.00,86.36,140414.09,1,11.38,10.38,8.22
1627,0,15337952,7376,67.56,140481.66,2,15359336,21384,15337952,7376,67.56,86.34,140481.66,0,9.88,10.38,8.15
1628,0,15337952,0,0.00,140481.66,2,15362500,24548,15337952,0,0.00,86.29,140481.66,0,10.60,9.60,8.21
1629,0,15337952,0,0.00,140481.66,2,15365497,27545,15337952,0,0.00,86.24,140481.66,1,10.69,9.69,8.26
1630,0,15343770,5818,53.29,140534.94,2,15368406,24636,15343770,5818,53.29,86.22,140534.94,1,8.57,9.69,8.14
1631,0,15349544,5774,52.88,140587.83,2,15371293,21749,15349544,5774,52.88,86.20,140587.83,0,7.71,9.69,8.12
1632,0,15355270,5726,52.44,140640.27,2,15374156,18886,15355270,5726,52.44,86.18,140640.27,0,8.04,9.69,8.18
1633,0,15361206,5936,54.37,140694.64,2,15377124,15918,15361206,5936,54.37,86.16,140694.64,1,8.09,9.69,8.23
1634,0,15368590,7384,67.63,140762.27,2,15380816,12226,15368590,7384,67.63,86.15,140762.27,1,5.90,9.69,8.10
1635,0,15384458,15868,145.34,140907.61,2,15388750,4292,15384458,15868,145.34,86.18,140907.61,0,4.90,9.69,8.07
1636,0,15416302,31844,291.66,141199.27,2,15416302,0,15416302,31844,291.66,86.31,141199.27,0,5.61,9.69,8.12
1637,0,15450415,34113,312.44,141511.72,2,15450415,0,15450415,34113,312.44,86.45,141511.72,1,7.32,9.69,8.18
1638,0,15484512,34097,312.30,141824.02,2,15484512,0,15484512,34097,312.30,86.58,141824.02,0,6.58,9.69,8.05
1639,0,15518598,34086,312.20,142136.20,2,15518598,0,15518598,34086,312.20,86.72,142136.20,1,8.99,9.69,8.10
1640,0,15518598,0,0.00,142136.20,2,15529115,10517,15518598,0,0.00,86.67,142136.20,0,10.36,9.36,8.09
1641,0,15518598,0,0.00,142136.20,2,15534733,16135,15518598,0,0.00,86.62,142136.20,1,12.05,11.05,8.14
1642,0,15528796,10198,93.40,142229.61,2,15539832,11036,15528796,10198,93.40,86.62,142229.61,1,10.30,11.05,8.05
1643,0,15547878,19082,174.77,142404.39,2,15549373,1495,15547878,19082,174.77,86.67,142404.39,0,9.91,11.05,7.98
1644,0,15579786,31908,292.25,142696.64,2,15579786,0,15579786,31908,292.25,86.80,142696.64,1,10.24,11.05,8.04
1645,0,15612511,32725,299.73,142996.36,2,15612511,0,15612511,32725,299.73,86.93,142996.36,0,10.02,11.05,7.99
1646,0,15612511,0,0.00,142996.36,2,15622648,10137,15612511,0,0.00,86.88,142996.36,0,11.57,10.57,8.05
1647,0,15612511,0,0.00,142996.36,2,15628281,15770,15612511,0,0.00,86.82,142996.36,1,12.34,11.34,8.10
1648,0,15622747,10236,93.75,143090.11,2,15633399,10652,15622747,10236,93.75,86.83,143090.11,1,10.29,11.34,7.98
1649,0,15641547,18800,172.19,143262.31,2,15642799,1252,15641547,18800,172.19,86.88,143262.31,0,9.66,11.34,7.96
1650,0,15674512,32965,301.93,143564.23,2,15674512,0,15674512,32965,301.93,87.01,143564.23,0,9.83,11.34,8.01
1651,0,15706639,32127,294.25,143858.48,2,15706639,0,15706639,32127,294.25,87.13,143858.48,1,11.18,11.34,8.07
1652,0,15738934,32295,295.79,144154.28,2,15738934,0,15738934,32295,295.79,87.26,144154.28,1,11.33,11.34,7.95
1653,0,15738934,0,0.00,144154.28,2,15749265,10331,15738934,0,0.00,87.21,144154.28,0,14.26,13.26,7.91
1654,0,15738934,0,0.00,144154.28,2,15755308,16374,15738934,0,0.00,87.15,144154.28,0,14.76,13.76,7.97
1655,0,15738934,0,0.00,144154.28,2,15759956,21022,15738934,0,0.00,87.10,144154.28,1,15.90,14.90,8.03
1656,0,15747314,8380,76.75,144231.03,2,15764146,16832,15747314,8380,76.75,87.10,144231.03,1,14.44,14.90,7.88
1657,0,15756126,8812,80.71,144311.75,2,15768552,12426,15756126,8812,80.71,87.09,144311.75,0,13.64,14.90,7.87
1658,0,15769094,12968,118.78,144430.52,2,15775036,5942,15769094,12968,118.78,87.11,144430.52,0,14.13,14.90,7.92
1659,0,15769094,0,0.00,144430.52,2,15782079,12985,15769094,0,0.00,87.06,144430.52,1,15.08,14.08,7.98
1660,0,15769094,0,0.00,144430.52,2,15786614,17520,15769094,0,0.00,87.01,144430.52,0,14.10,13.10,7.85
1661,0,15769094,0,0.00,144430.52,2,15789719,20625,15769094,0,0.00,86.95,144430.52,1,14.10,13.10,7.91
1662,0,15769094,0,0.00,144430.52,2,15792169,23075,15769094,0,0.00,86.90,144430.52,1,13.68,12.68,7.88
1663,0,15769094,0,0.00,144430.52,2,15794329,25235,15769094,0,0.00,86.85,144430.52,0,13.25,12.25,7.82
1664,0,15769094,0,0.00,144430.52,2,15796296,27202,15769094,0,0.00,86.80,144430.52,1,13.25,12.25,7.88
1665,0,15773010,3916,35.87,144466.39,2,15798254,25244,15773010,3916,35.87,86.77,144466.39,0,11.43,12.25,7.76
1666,0,15777230,4220,38.65,144505.05,2,15800364,23134,15777230,4220,38.65,86.74,144505.05,1,11.48,12.25,7.81
1667,0,15782000,4770,43.69,144548.73,2,15802749,20749,15782000,4770,43.69,86.71,144548.73,0,10.47,12.25,7.78
1668,0,15787700,5700,52.21,144600.94,2,15805599,17899,15787700,5700,52.21,86.69,144600.94,0,10.51,12.25,7.84
1669,0,15794450,6750,61.82,144662.77,2,15808974,14524,15794450,6750,61.82,86.68,144662.77,1,11.13,12.25,7.89
1670,0,15804164,9714,88.97,144751.73,2,15813831,9667,15804164,9714,88.97,86.68,144751.73,1,9.32,12.25,7.75
1671,0,15823919,19755,180.94,144932.67,2,15823919,0,15823919,19755,180.94,86.73,144932.67,0,8.39,12.25,7.72
1672,0,15856871,32952,301.81,145234.48,2,15856871,0,15856871,32952,301.81,86.86,145234.48,0,9.03,12.25,7.77
1673,0,15889882,33011,302.35,145536.83,2,15889882,0,15889882,33011,302.35,86.99,145536.83,1,9.99,12.25,7.83
1674,0,15922207,32325,296.07,145832.89,2,15922207,0,15922207,32325,296.07,87.12,145832.89,1,10.25,12.25,7.72
1675,0,15922207,0,0.00,145832.89,2,15933056,10849,15922207,0,0.00,87.06,145832.89,0,13.19,12.19,7.71
1676,0,15922207,0,0.00,145832.89,2,15938606,16399,15922207,0,0.00,87.01,145832.89,0,13.51,12.51,7.76
1677,0,15922207,0,0.00,145832.89,2,15942880,20673,15922207,0,0.00,86.96,145832.89,1,14.51,13.51,7.82
1678,0,15930277,8070,73.91,145906.81,2,15946915,16638,15930277,8070,73.91,86.95,145906.81,0,12.57,13.51,7.72
1679,0,15939211,8934,81.83,145988.64,2,15951382,12171,15939211,8934,81.83,86.95,145988.64,1,12.87,13.51,7.77
1680,0,15953597,14386,131.76,146120.41,2,15958575,4978,15953597,14386,131.76,86.98,146120.41,1,12.09,13.51,7.75
1681,0,15983922,30325,277.75,146398.16,2,15983922,0,15983922,30325,277.75,87.09,146398.16,0,11.25,13.51,7.69
1682,0,16016060,32138,294.35,146692.50,2,16016060,0,16016060,32138,294.35,87.21,146692.50,1,12.46,13.51,7.75
1683,0,16048087,32027,293.34,146985.84,2,16048087,0,16048087,32027,293.34,87.34,146985.84,0,12.36,13.51,7.70
1684,0,16080236,32149,294.46,147280.30,2,16080236,0,16080236,32149,294.46,87.46,147280.30,1,13.35,13.51,7.76
1685,0,16112468,32232,295.22,147575.52,2,16112468,0,16112468,32232,295.22,87.58,147575.52,0,12.85,13.51,7.67
1686,0,16112468,0,0.00,147575.52,2,16123020,10552,16112468,0,0.00,87.53,147575.52,1,13.93,12.93,7.72
1687,0,16112468,0,0.00,147575.52,2,16129042,16574,16112468,0,0.00,87.48,147575.52,0,14.47,13.47,7.68
1688,0,16112468,0,0.00,147575.52,2,16133449,20981,16112468,0,0.00,87.43,147575.52,1,16.54,15.54,7.73
1689,0,16120906,8438,77.28,147652.80,2,16137668,16762,16120906,8438,77.28,87.42,147652.80,0,14.72,15.54,7.61
1690,0,16129500,8594,78.71,147731.52,2,16141965,12465,16129500,8594,78.71,87.42,147731.52,1,14.80,15.54,7.67
1691,0,16142434,12934,118.46,147849.97,2,16148432,5998,16142434,12934,118.46,87.43,147849.97,0,13.61,15.54,7.62
1692,0,16171618,29184,267.30,148117.28,2,16171618,0,16171618,29184,267.30,87.54,148117.28,0,14.71,15.54,7.68
1693,0,16203372,31754,290.84,148408.11,2,16203372,0,16203372,31754,290.84,87.66,148408.11,1,15.48,15.54,7.73
1694,0,16235447,32075,293.78,148701.89,2,16235447,0,16235447,32075,293.78,87.78,148701.89,0,15.11,15.54,7.63
1695,0,16235447,0,0.00,148701.89,2,16246100,10653,16235447,0,0.00,87.73,148701.89,1,17.01,16.01,7.69
1696,0,16235447,0,0.00,148701.89,2,16251986,16539,16235447,0,0.00,87.68,148701.89,0,16.62,15.62,7.62
1697,0,16235447,0,0.00,148701.89,2,16256455,21008,16235447,0,0.00,87.63,148701.89,1,17.94,16.94,7.67
1698,0,16235447,0,0.00,148701.89,2,16260032,24585,16235447,0,0.00,87.57,148701.89,0,17.25,16.25,7.62
1699,0,16235447,0,0.00,148701.89,2,16263460,28013,16235447,0,0.00,87.52,148701.89,1,19.40,18.40,7.68
1700,0,16235447,0,0.00,148701.89,2,16266638,31191,16235447,0,0.00,87.47,148701.89,0,18.40,17.40,7.63
1701,0,16235447,0,0.00,148701.89,2,16269581,34134,16235447,0,0.00,87.42,148701.89,1,18.72,17.72,7.68
1702,0,16241019,5572,51.03,148752.92,2,16272367,31348,16241019,5572,51.03,87.40,148752.92,0,17.44,17.72,7.63
1703,0,16241019,0,0.00,148752.92,2,16275059,34040,16241019,0,0.00,87.35,148752.92,1,18.09,17.09,7.69
1704,0,16241019,0,0.00,148752.92,2,16277558,36539,16241019,0,0.00,87.30,148752.92,1,17.52,16.52,7.63
1705,0,16245783,4764,43.63,148796.56,2,16279940,34157,16245783,4764,43.63,87.27,148796.56,0,16.37,16.52,7.59
1706,0,16245783,0,0.00,148796.56,2,16282147,36364,16245783,0,0.00,87.22,148796.56,0,16.77,15.77,7.64
1707,0,16245783,0,0.00,148796.56,2,16284353,38570,16245783,0,0.00,87.17,148796.56,1,16.81,15.81,7.70
1708,0,16250089,4306,39.44,148836.00,2,16286506,36417,16250089,4306,39.44,87.14,148836.00,1,14.67,15.81,7.58
1709,0,16254155,4066,37.24,148873.23,2,16288539,34384,16254155,4066,37.24,87.11,148873.23,0,13.95,15.81,7.57
1710,0,16258123,3968,36.34,148909.58,2,16290523,32400,16258123,3968,36.34,87.08,148909.58,1,14.56,15.81,7.63
1711,0,16262313,4190,38.38,148947.95,2,16292618,30305,16262313,4190,38.38,87.05,148947.95,0,13.29,15.81,7.55
1712,0,16266515,4202,38.49,148986.44,2,16294719,28204,16266515,4202,38.49,87.02,148986.44,1,13.33,15.81,7.61
1713,0,16270723,4208,38.54,149024.98,2,16296823,26100,16270723,4208,38.54,87.00,149024.98,0,12.09,15.81,7.55
1714,0,16274989,4266,39.07,149064.06,2,16298956,23967,16274989,4266,39.07,86.97,149064.06,1,12.13,15.81,7.60
1715,0,16279415,4426,40.54,149104.59,2,16301169,21754,16279415,4426,40.54,86.94,149104.59,0,11.20,15.81,7.58
1716,0,16283981,4566,41.82,149146.42,2,16303452,19471,16283981,4566,41.82,86.92,149146.42,1,11.24,15.81,7.63
1717,0,16288851,4870,44.60,149191.02,2,16305887,17036,16288851,4870,44.60,86.89,149191.02,0,9.90,15.81,7.56
1718,0,16294727,5876,53.82,149244.84,2,16308825,14098,16294727,5876,53.82,86.87,149244.84,1,9.95,15.81,7.61
1719,0,16305623,10896,99.80,149344.64,2,16314273,8650,16305623,10896,99.80,86.88,149344.64,0,9.26,15.81,7.61
1720,0,16328907,23284,213.26,149557.89,2,16328907,0,16328907,23284,213.26,86.95,149557.89,1,9.85,15.81,7.66
1721,0,16361877,32970,301.98,149859.88,2,16361877,0,16361877,32970,301.98,87.08,149859.88,0,9.75,15.81,7.61
1722,0,16393659,31782,291.09,150150.97,2,16393659,0,16393659,31782,291.09,87.20,150150.97,1,12.15,15.81,7.66
1723,0,16425501,31842,291.64,150442.61,2,16425501,0,16425501,31842,291.64,87.31,150442.61,0,13.84,15.81,7.65
1724,0,16425501,0,0.00,150442.61,2,16436140,10639,16425501,0,0.00,87.26,150442.61,0,15.90,14.90,7.71
1725,0,16425501,0,0.00,150442.61,2,16442142,16641,16425501,0,0.00,87.21,150442.61,1,16.62,15.62,7.76
1726,0,16435743,10242,93.81,150536.42,2,16447263,11520,16435743,10242,93.81,87.22,150536.42,0,14.85,15.62,7.65
1727,0,16451689,15946,146.05,150682.47,2,16455236,3547,16451689,15946,146.05,87.25,150682.47,1,14.94,15.62,7.70
1728,0,16482351,30662,280.84,150963.31,2,16482351,0,16482351,30662,280.84,87.36,150963.31,0,13.60,15.62,7.64
1729,0,16514071,31720,290.53,151253.83,2,16514071,0,16514071,31720,290.53,87.48,151253.83,1,14.25,15.62,7.69
1730,0,16545845,31774,291.02,151544.86,2,16545845,0,16545845,31774,291.02,87.60,151544.86,0,14.35,15.62,7.61
1731,0,16545845,0,0.00,151544.86,2,16556176,10331,16545845,0,0.00,87.55,151544.86,1,16.35,15.35,7.66
1732,0,16545845,0,0.00,151544.86,2,16562267,16422,16545845,0,0.00,87.50,151544.86,0,15.61,14.61,7.60
1733,0,16545845,0,0.00,151544.86,2,16566727,20882,16545845,0,0.00,87.45,151544.86,1,16.20,15.20,7.65
1734,0,16545845,0,0.00,151544.86,2,16570556,24711,16545845,0,0.00,87.40,151544.86,1,16.07,15.07,7.62
1735,0,16553237,7392,67.70,151612.56,2,16574252,21015,16553237,7392,67.70,87.38,151612.56,0,14.61,15.07,7.55
1736,0,16553237,0,0.00,151612.56,2,16577489,24252,16553237,0,0.00,87.33,151612.56,1,15.29,14.29,7.60
1737,0,16553237,0,0.00,151612.56,2,16580447,27210,16553237,0,0.00,87.28,151612.56,0,14.62,13.62,7.55
1738,0,16553237,0,0.00,151612.56,2,16583204,29967,16553237,0,0.00,87.23,151612.56,0,15.22,14.22,7.60
1739,0,16553237,0,0.00,151612.56,2,16585858,32621,16553237,0,0.00,87.18,151612.56,1,15.28,14.28,7.65
1740,0,16558307,5070,46.44,151659.00,2,16588393,30086,16558307,5070,46.44,87.16,151659.00,0,13.78,14.28,7.57
1741,0,16563351,5044,46.20,151705.19,2,16590915,27564,16563351,5044,46.20,87.14,151705.19,1,14.11,14.28,7.62
1742,0,16568325,4974,45.56,151750.75,2,16593402,25077,16568325,4974,45.56,87.11,151750.75,1,12.99,14.28,7.58
1743,0,16573339,5014,45.92,151796.67,2,16595909,22570,16573339,5014,45.92,87.09,151796.67,0,12.97,14.28,7.56
1744,0,16578537,5198,47.61,151844.28,2,16598508,19971,16578537,5198,47.61,87.07,151844.28,1,13.30,14.28,7.61
1745,0,16584021,5484,50.23,151894.52,2,16601250,17229,16584021,5484,50.23,87.05,151894.52,0,12.74,14.28,7.62
1746,0,16589847,5826,53.36,151947.88,2,16604163,14316,16589847,5826,53.36,87.03,151947.88,1,13.08,14.28,7.67
1747,0,16599035,9188,84.15,152032.03,2,16608757,9722,16599035,9188,84.15,87.02,152032.03,0,12.21,14.28,7.65
1748,0,16618731,19696,180.40,152212.42,2,16618731,0,16618731,19696,180.40,87.08,152212.42,1,13.01,14.28,7.71
1749,0,16650345,31614,289.56,152501.98,2,16650345,0,16650345,31614,289.56,87.19,152501.98,0,12.97,14.28,7.69
1750,0,16682052,31707,290.41,152792.39,2,16682052,0,16682052,31707,290.41,87.31,152792.39,1,14.06,14.28,7.74
1751,0,16682052,0,0.00,152792.39,2,16692737,10685,16682052,0,0.00,87.26,152792.39,0,14.51,13.51,7.68
1752,0,16682052,0,0.00,152792.39,2,16698783,16731,16682052,0,0.00,87.21,152792.39,1,15.38,14.38,7.73
1753,0,16682052,0,0.00,152792.39,2,16703398,21346,16682052,0,0.00,87.16,152792.39,0,14.98,13.98,7.70
1754,0,16682052,0,0.00,152792.39,2,16707113,25061,16682052,0,0.00,87.11,152792.39,1,15.04,14.04,7.76
1755,0,16682052,0,0.00,152792.39,2,16710632,28580,16682052,0,0.00,87.06,152792.39,0,15.93,14.93,7.69
1756,0,16682052,0,0.00,152792.39,2,16713822,31770,16682052,0,0.00,87.01,152792.39,1,16.00,15.00,7.75
1757,0,16682052,0,0.00,152792.39,2,16716730,34678,16682052,0,0.00,86.96,152792.39,0,15.24,14.24,7.72
1758,0,16682052,0,0.00,152792.39,2,16719381,37329,16682052,0,0.00,86.91,152792.39,0,15.31,14.31,7.77
1759,0,16682052,0,0.00,152792.39,2,16721859,39807,16682052,0,0.00,86.86,152792.39,0,15.41,14.41,7.82
1760,0,16682052,0,0.00,152792.39,2,16724193,42141,16682052,0,0.00,86.81,152792.39,1,16.27,15.27,7.87
1761,0,16686676,4624,42.35,152834.73,2,16726505,39829,16686676,4624,42.35,86.79,152834.73,0,14.44,15.27,7.78
1762,0,16691386,4710,43.14,152877.88,2,16728860,37474,16691386,4710,43.14,86.76,152877.88,1,14.55,15.27,7.84
1763,0,16696090,4704,43.08,152920.95,2,16731212,35122,16696090,4704,43.08,86.74,152920.95,0,13.46,15.27,7.80
1764,0,16700794,4704,43.08,152964.05,2,16733564,32770,16700794,4704,43.08,86.71,152964.05,1,13.63,15.27,7.85
1765,0,16700794,0,0.00,152964.05,2,16735811,35017,16700794,0,0.00,86.67,152964.05,0,12.28,11.28,7.80
1766,0,16700794,0,0.00,152964.05,2,16737720,36926,16700794,0,0.00,86.62,152964.05,1,12.28,11.28,7.85
1767,0,16704688,3894,35.67,152999.70,2,16739667,34979,16704688,3894,35.67,86.59,152999.70,1,11.07,11.28,7.81
1768,0,16708630,3942,36.11,153035.81,2,16741638,33008,16708630,3942,36.11,86.56,153035.81,0,10.51,11.28,7.80
1769,0,16712578,3948,36.16,153071.97,2,16743612,31034,16712578,3948,36.16,86.53,153071.97,1,10.54,11.28,7.85
1770,0,16716444,3866,35.41,153107.39,2,16745545,29101,16716444,3866,35.41,86.50,153107.39,1,9.64,11.28,7.83
1771,0,16720370,3926,35.96,153143.34,2,16747508,27138,16720370,3926,35.96,86.47,153143.34,0,9.01,11.28,7.82
1772,0,16724334,3964,36.31,153179.66,2,16749490,25156,16724334,3964,36.31,86.44,153179.66,1,9.05,11.28,7.87
1773,0,16728432,4098,37.53,153217.19,2,16751539,23107,16728432,4098,37.53,86.42,153217.19,0,8.07,11.28,7.84
1774,0,16732742,4310,39.48,153256.66,2,16753694,20952,16732742,4310,39.48,86.39,153256.66,1,8.17,11.28,7.90
1775,0,16737352,4610,42.22,153298.88,2,16755999,18647,16737352,4610,42.22,