timestamp,socket_0,socket_0_TSENT,socket_0_TSENTSEC,socket_0_TTHSENTSEC,socket_0_TTHSENT,socket_status_0,TMSG,TOSEND,SENT,TMSGSEC,TTHMSGSEC,AVG,THtotalsent,ackSent,state,globalState,THloss
1,0,0,0,0.00,0.00,2,0,0,0,0,0.00,0.00,0.00,0,0.00,8.00,0.00
2,0,0,0,0.00,0.00,2,0,0,0,0,0.00,0.00,0.00,0,0.00,8.00,0.00
3,0,0,0,0.00,0.00,2,0,0,0,0,0.00,0.00,0.00,0,0.00,8.00,0.00
4,0,0,0,0.00,0.00,2,0,0,0,0,0.00,0.00,0.00,0,0.00,8.00,0.00
5,0,0,0,0.00,0.00,2,0,0,0,0,0.00,0.00,0.00,0,0.00,8.00,0.00
6,0,0,0,0.00,0.00,2,0,0,0,0,0.00,0.00,0.00,0,0.00,8.00,0.00
7,0,0,0,0.00,0.00,2,0,0,0,0,0.00,0.00,0.00,0,0.00,8.00,0.00
8,0,0,0,0.00,0.00,2,0,0,0,0,0.00,0.00,0.00,0,0.00,8.00,0.00
9,0,0,0,0.00,0.00,2,0,0,0,0,0.00,0.00,0.00,0,0.00,8.00,0.00
10,0,0,0,0.00,0.00,2,0,0,0,0,0.00,0.00,0.00,0,0.00,8.00,0.00
11,0,0,0,0.00,0.00,2,0,0,0,0,0.00,0.00,0.00,0,0.00,8.00,0.00
12,0,0,0,0.00,0.00,2,0,0,0,0,0.00,0.00,0.00,0,0.00,8.00,0.00
13,0,0,0,0.00,0.00,2,0,0,0,0,0.00,0.00,0.00,0,0.00,8.00,0.00
14,0,0,0,0.00,0.00,2,0,0,0,0,0.00,0.00,0.00,0,0.00,8.00,0.00
15,0,0,0,0.00,0.00,2,0,0,0,0,0.00,0.00,0.00,0,0.00,8.00,0.00
16,0,0,0,0.00,0.00,2,0,0,0,0,0.00,0.00,0.00,0,0.00,8.00,0.00
17,0,0,0,0.00,0.00,2,0,0,0,0,0.00,0.00,0.00,0,0.00,8.00,0.00
18,0,7220,7220,66.13,66.13,2,7220,0,7220,7220,66.13,3.67,66.13,0,0.00,8.00,0.00
19,0,41193,33973,311.16,377.29,2,41193,0,41193,33973,311.16,19.86,377.29,0,1.44,8.00,0.00
20,0,77180,35987,329.61,706.90,2,77180,0,77180,35987,329.61,35.34,706.90,1,2.56,8.00,0.00
21,0,112663,35483,324.99,1031.89,2,112663,0,112663,35483,324.99,49.14,1031.89,1,2.74,8.00,0.00
22,0,148389,35726,327.22,1359.11,2,148389,0,148389,35726,327.22,61.78,1359.11,0,3.06,8.00,4.76
23,0,180789,32400,296.75,1655.86,2,180789,0,180789,32400,296.75,71.99,1655.86,1,7.33,8.00,9.09
24,0,190397,9608,88.00,1743.86,2,197379,6982,190397,9608,88.00,72.66,1743.86,0,14.07,13.07,9.09
25,0,190397,0,0.00,1743.86,2,204140,13743,190397,0,0.00,69.75,1743.86,1,14.16,13.16,4.17
26,0,190397,0,0.00,1743.86,2,208471,18074,190397,0,0.00,67.07,1743.86,0,15.78,14.78,4.17
27,0,190397,0,0.00,1743.86,2,212440,22043,190397,0,0.00,64.59,1743.86,1,15.78,14.78,3.85
28,0,190397,0,0.00,1743.86,2,215955,25558,190397,0,0.00,62.28,1743.86,0,15.32,14.32,3.85
29,0,190397,0,0.00,1743.86,2,219152,28755,190397,0,0.00,60.13,1743.86,1,15.32,14.32,3.57
30,0,190397,0,0.00,1743.86,2,222114,31717,190397,0,0.00,58.13,1743.86,0,14.93,13.93,3.57
31,0,190397,0,0.00,1743.86,2,224779,34382,190397,0,0.00,56.25,1743.86,1,14.93,13.93,3.33
32,0,190397,0,0.00,1743.86,2,227203,36806,190397,0,0.00,54.50,1743.86,0,14.77,13.77,3.33
33,0,190397,0,0.00,1743.86,2,229627,39230,190397,0,0.00,52.84,1743.86,0,14.77,13.77,3.12
34,0,190397,0,0.00,1743.86,2,231875,41478,190397,0,0.00,51.29,1743.86,1,15.05,14.05,6.06
35,0,194973,4576,41.91,1785.77,2,234163,39190,194973,4576,41.91,51.02,1785.77,0,13.59,14.05,6.06
36,0,199647,4674,42.81,1828.58,2,236500,36853,199647,4674,42.81,50.79,1828.58,1,13.63,14.05,2.86
37,0,204357,4710,43.14,1871.72,2,238855,34498,204357,4710,43.14,50.59,1871.72,0,11.98,14.05,2.86
38,0,209131,4774,43.73,1915.45,2,241242,32111,209131,4774,43.73,50.41,1915.45,0,12.02,14.05,2.70
39,0,213867,4736,43.38,1958.83,2,243610,29743,213867,4736,43.38,50.23,1958.83,0,13.50,14.05,5.26
40,0,218601,4734,43.36,2002.19,2,245977,27376,218601,4734,43.36,50.05,2002.19,1,13.54,14.05,7.69
41,0,223309,4708,43.12,2045.31,2,248331,25022,223309,4708,43.12,49.89,2045.31,0,13.44,14.05,7.69
42,0,228023,4714,43.18,2088.48,2,250688,22665,228023,4714,43.18,49.73,2088.48,1,13.48,14.05,2.44
43,0,232631,4608,42.21,2130.69,2,252992,20361,232631,4608,42.21,49.55,2130.69,0,12.12,14.05,2.44
44,0,237551,4920,45.06,2175.75,2,255452,17901,237551,4920,45.06,49.45,2175.75,1,12.17,14.05,2.33
45,0,242523,4972,45.54,2221.29,2,257938,15415,242523,4972,45.54,49.36,2221.29,1,9.40,14.05,2.33
46,0,249499,6976,63.89,2285.18,2,261426,11927,249499,6976,63.89,49.68,2285.18,0,9.45,14.05,2.22
47,0,267283,17784,162.89,2448.07,2,270318,3035,267283,17784,162.89,52.09,2448.07,1,10.45,14.05,4.35
48,0,299184,31901,292.18,2740.25,2,299184,0,299184,31901,292.18,57.09,2740.25,0,11.26,14.05,4.35
49,0,328778,29594,271.05,3011.31,2,328778,0,328778,29594,271.05,61.46,3011.31,1,11.55,14.05,2.08
50,0,358135,29357,268.88,3280.19,2,358135,0,358135,29357,268.88,65.60,3280.19,0,13.04,14.05,2.08
51,0,387696,29561,270.75,3550.94,2,387696,0,387696,29561,270.75,69.63,3550.94,1,13.30,14.05,2.00
52,0,387696,0,0.00,3550.94,2,397779,10083,387696,0,0.00,68.29,3550.94,0,15.81,14.81,2.00
53,0,387696,0,0.00,3550.94,2,403551,15855,387696,0,0.00,67.00,3550.94,0,15.81,14.81,1.92
54,0,387696,0,0.00,3550.94,2,407819,20123,387696,0,0.00,65.76,3550.94,1,16.09,15.09,3.77
55,0,389096,1400,12.82,3563.76,2,411615,22519,389096,1400,12.82,64.80,3563.76,1,14.64,14.90,3.77
56,0,396166,7070,64.75,3628.52,2,415150,18984,396166,7070,64.75,64.79,3628.52,0,14.66,14.90,1.82
57,0,397724,1558,14.27,3642.79,2,418359,20635,397724,1558,14.27,63.91,3642.79,1,14.94,13.94,3.57
58,0,403738,6014,55.08,3697.87,2,421366,17628,403738,6014,55.08,63.76,3697.87,0,13.88,13.94,0.78
59,0,403738,0,0.00,3697.87,2,424368,20630,403738,0,0.00,62.68,3697.87,1,14.42,13.42,2.50
60,0,403738,0,0.00,3697.87,2,427045,23307,403738,0,0.00,61.63,3697.87,0,14.15,13.15,2.50
61,0,403738,0,0.00,3697.87,2,429509,25771,403738,0,0.00,60.62,3697.87,1,14.15,13.15,1.67
62,0,408508,4770,43.69,3741.56,2,431894,23386,408508,4770,43.69,60.35,3741.56,1,11.69,13.15,1.67
63,0,413224,4716,43.19,3784.76,2,434252,21028,413224,4716,43.19,60.08,3784.76,1,11.73,13.15,1.61
64,0,418200,4976,45.58,3830.33,2,436740,18540,418200,4976,45.58,59.85,3830.33,0,11.73,13.15,1.61
65,0,423730,5530,50.65,3880.98,2,439505,15775,423730,5530,50.65,59.71,3880.98,0,11.73,13.15,1.61
66,0,430450,6720,61.55,3942.53,2,442865,12415,430450,6720,61.55,59.74,3942.53,1,11.73,13.15,1.61
67,0,443350,12900,118.15,4060.68,2,449315,5965,443350,12900,118.15,60.61,4060.68,0,11.08,13.15,1.61
68,0,468510,25160,230.44,4291.12,2,468510,0,468510,25160,230.44,63.10,4291.12,1,11.20,13.15,1.49
69,0,497179,28669,262.58,4553.71,2,497179,0,497179,28669,262.58,66.00,4553.71,0,9.90,13.15,1.49
70,0,521031,23852,218.46,4772.17,2,521031,0,521031,23852,218.46,68.17,4772.17,1,10.16,13.15,1.45
71,0,547635,26604,243.67,5015.84,2,547635,0,547635,26604,243.67,70.65,5015.84,0,8.88,13.15,1.45
72,0,574819,27184,248.98,5264.82,2,574819,0,574819,27184,248.98,73.12,5264.82,0,9.12,13.15,1.41
73,0,602190,27371,250.69,5515.51,2,602190,0,602190,27371,250.69,75.55,5515.51,1,9.68,13.15,2.78
74,0,629555,27365,250.64,5766.15,2,629555,0,629555,27365,250.64,77.92,5766.15,0,7.61,13.15,2.78
75,0,656805,27250,249.59,6015.73,2,656805,0,656805,27250,249.59,80.21,6015.73,0,7.90,13.15,1.35
76,0,683568,26763,245.12,6260.86,2,683568,0,683568,26763,245.12,82.38,6260.86,1,8.83,13.15,2.67
77,0,710558,26990,247.20,6508.06,2,710558,0,710558,26990,247.20,84.52,6508.06,0,7.10,13.15,2.67
78,0,742324,31766,290.95,6799.01,2,742324,0,742324,31766,290.95,87.17,6799.01,0,7.34,13.15,1.30
79,0,777232,34908,319.73,7118.74,2,777232,0,777232,34908,319.73,90.11,7118.74,1,8.90,13.15,2.56
80,0,812556,35324,323.54,7442.27,2,812556,0,812556,35324,323.54,93.03,7442.27,0,7.99,13.15,2.56
81,0,847235,34679,317.63,7759.90,2,847235,0,847235,34679,317.63,95.80,7759.90,0,8.31,13.15,1.25
82,0,880946,33711,308.76,8068.66,2,880946,0,880946,33711,308.76,98.40,8068.66,1,10.92,13.15,2.47
83,0,880946,0,0.00,8068.66,2,891710,10764,880946,0,0.00,97.21,8068.66,0,13.38,12.38,0.15
84,0,880946,0,0.00,8068.66,2,897410,16464,880946,0,0.00,96.06,8068.66,0,13.38,12.38,1.36
85,0,880946,0,0.00,8068.66,2,901837,20891,880946,0,0.00,94.93,8068.66,1,13.38,12.38,2.53
86,0,880946,0,0.00,8068.66,2,905699,24753,880946,0,0.00,93.82,8068.66,1,12.59,11.59,0.45
87,0,880946,0,0.00,8068.66,2,909273,28327,880946,0,0.00,92.74,8068.66,0,14.98,13.98,0.45
88,0,880946,0,0.00,8068.66,2,912656,31710,880946,0,0.00,91.69,8068.66,1,14.98,13.98,1.15
89,0,880946,0,0.00,8068.66,2,915810,34864,880946,0,0.00,90.66,8068.66,1,15.10,14.10,1.15
90,0,880946,0,0.00,8068.66,2,918752,37806,880946,0,0.00,89.65,8068.66,1,15.10,14.10,1.12
91,0,880946,0,0.00,8068.66,2,921513,40567,880946,0,0.00,88.67,8068.66,1,14.40,13.40,0.81
92,0,885613,4667,42.75,8111.41,2,924158,38545,885613,4667,42.75,88.17,8111.41,0,13.67,12.67,0.81
93,0,885613,0,0.00,8111.41,2,926700,41087,885613,0,0.00,87.22,8111.41,1,13.71,12.71,1.09
94,0,885613,0,0.00,8111.41,2,928903,43290,885613,0,0.00,86.29,8111.41,1,13.46,12.46,0.01
95,0,885613,0,0.00,8111.41,2,931172,45559,885613,0,0.00,85.38,8111.41,0,13.57,12.57,0.01
96,0,885613,0,0.00,8111.41,2,933373,47760,885613,0,0.00,84.49,8111.41,1,13.57,12.57,1.05
97,0,888949,3336,30.55,8141.96,2,935516,46567,888949,3336,30.55,83.94,8141.96,0,12.74,11.74,1.05
98,0,888949,0,0.00,8141.96,2,937583,48634,888949,0,0.00,83.08,8141.96,0,12.77,11.77,1.03
99,0,888949,0,0.00,8141.96,2,939564,50615,888949,0,0.00,82.24,8141.96,1,12.77,11.77,2.04
100,0,892599,3650,33.43,8175.39,2,941389,48790,892599,3650,33.43,81.75,8175.39,1,11.46,11.77,0.62
101,0,896379,3780,34.62,8210.01,2,943279,46900,896379,3780,34.62,81.29,8210.01,0,11.68,11.77,0.62
102,0,900179,3800,34.80,8244.82,2,945179,45000,900179,3800,34.80,80.83,8244.82,1,11.72,11.77,0.99
103,0,903963,3784,34.66,8279.48,2,947071,43108,903963,3784,34.66,80.38,8279.48,0,10.89,11.77,0.99
104,0,907717,3754,34.38,8313.86,2,948948,41231,907717,3754,34.38,79.94,8313.86,1,10.93,11.77,0.97
105,0,911445,3728,34.15,8348.00,2,950812,39367,911445,3728,34.15,79.50,8348.00,0,9.49,11.77,0.97
106,0,915149,3704,33.93,8381.93,2,952664,37515,915149,3704,33.93,79.07,8381.93,1,9.52,11.77,0.95
107,0,918823,3674,33.65,8415.58,2,954501,35678,918823,3674,33.65,78.65,8415.58,0,8.36,11.77,0.95
108,0,922321,3498,32.04,8447.62,2,956250,33929,922321,3498,32.04,78.22,8447.62,1,8.39,11.77,0.93
109,0,925923,3602,32.99,8480.61,2,958051,32128,925923,3602,32.99,77.80,8480.61,0,6.99,11.77,0.93
110,0,929633,3710,33.98,8514.59,2,959906,30273,929633,3710,33.98,77.41,8514.59,1,7.02,11.77,0.92
111,0,933123,3490,31.97,8546.56,2,961651,28528,933123,3490,31.97,77.00,8546.56,0,5.68,11.77,0.92
112,0,936847,3724,34.11,8580.66,2,963513,26666,936847,3724,34.11,76.61,8580.66,0,5.71,11.77,0.90
113,0,940675,3828,35.06,8615.73,2,965427,24752,940675,3828,35.06,76.25,8615.73,1,5.74,11.77,1.79
114,0,944653,3978,36.43,8652.16,2,967416,22763,944653,3978,36.43,75.90,8652.16,0,4.12,11.77,1.79
115,0,948833,4180,38.28,8690.45,2,969506,20673,948833,4180,38.28,75.57,8690.45,0,4.15,11.77,0.88
116,0,953215,4382,40.14,8730.58,2,971697,18482,953215,4382,40.14,75.26,8730.58,1,4.19,11.77,1.74
117,0,958257,5042,46.18,8776.76,2,974218,15961,958257,5042,46.18,75.02,8776.76,0,2.90,11.77,1.74
118,0,965717,7460,68.33,8845.09,2,977948,12231,965717,7460,68.33,74.96,8845.09,1,2.94,11.77,0.85
119,0,981615,15898,145.61,8990.70,2,985897,4282,981615,15898,145.61,75.55,8990.70,0,2.35,11.77,0.85
120,0,1013962,32347,296.27,9286.97,2,1013962,0,1013962,32347,296.27,77.39,9286.97,0,2.49,11.77,0.84
121,0,1048886,34924,319.87,9606.84,2,1048886,0,1048886,34924,319.87,79.40,9606.84,0,5.93,11.77,1.67
122,0,1083078,34192,313.17,9920.01,2,1083078,0,1083078,34192,313.17,81.31,9920.01,1,8.25,11.77,2.48
123,0,1117453,34375,314.84,10234.85,2,1117453,0,1117453,34375,314.84,83.21,10234.85,0,8.04,11.77,0.53
124,0,1151706,34253,313.73,10548.58,2,1151706,0,1151706,34253,313.73,85.07,10548.58,1,9.44,11.77,1.33
125,0,1185893,34187,313.12,10861.70,2,1185893,0,1185893,34187,313.12,86.89,10861.70,1,9.42,11.77,0.16
126,0,1219478,33585,307.61,11169.31,2,1219478,0,1219478,33585,307.61,88.65,11169.31,0,11.63,11.77,0.16
127,0,1219478,0,0.00,11169.31,2,1230247,10769,1219478,0,0.00,87.95,11169.31,1,11.93,10.93,0.79
128,0,1219478,0,0.00,11169.31,2,1236204,16726,1219478,0,0.00,87.26,11169.31,0,13.20,12.20,0.79
129,0,1219478,0,0.00,11169.31,2,1240931,21453,1219478,0,0.00,86.58,11169.31,1,13.20,12.20,0.78
130,0,1219478,0,0.00,11169.31,2,1244972,25494,1219478,0,0.00,85.92,11169.31,1,12.60,11.60,0.04
131,0,1219478,0,0.00,11169.31,2,1248579,29101,1219478,0,0.00,85.26,11169.31,0,12.61,11.61,0.04
132,0,1219478,0,0.00,11169.31,2,1251737,32259,1219478,0,0.00,84.62,11169.31,1,12.61,11.61,0.76
133,0,1219478,0,0.00,11169.31,2,1254822,35344,1219478,0,0.00,83.98,11169.31,1,11.99,10.99,0.30
134,0,1219478,0,0.00,11169.31,2,1257646,38168,1219478,0,0.00,83.35,11169.31,0,11.76,10.76,0.30
135,0,1219478,0,0.00,11169.31,2,1260399,40921,1219478,0,0.00,82.74,11169.31,1,11.76,10.76,0.75
136,0,1219478,0,0.00,11169.31,2,1263014,43536,1219478,0,0.00,82.13,11169.31,1,11.04,10.04,0.25
137,0,1219478,0,0.00,11169.31,2,1265504,46026,1219478,0,0.00,81.53,11169.31,0,10.17,9.17,0.25
138,0,1219478,0,0.00,11169.31,2,1267890,48412,1219478,0,0.00,80.94,11169.31,0,10.17,9.17,0.73
139,0,1219478,0,0.00,11169.31,2,1270175,50697,1219478,0,0.00,80.35,11169.31,0,10.17,9.17,1.45
140,0,1219478,0,0.00,11169.31,2,1272374,52896,1219478,0,0.00,79.78,11169.31,1,11.07,10.07,2.16
141,0,1219478,0,0.00,11169.31,2,1274490,55012,1219478,0,0.00,79.21,11169.31,0,10.07,9.07,0.86
142,0,1219478,0,0.00,11169.31,2,1276540,57062,1219478,0,0.00,78.66,11169.31,1,10.36,9.36,1.56
143,0,1219478,0,0.00,11169.31,2,1278535,59057,1219478,0,0.00,78.11,11169.31,0,9.60,8.60,1.05
144,0,1219478,0,0.00,11169.31,2,1280353,60875,1219478,0,0.00,77.56,11169.31,1,9.60,8.60,1.74
145,0,1223040,3562,32.62,11201.93,2,1282134,59094,1223040,3562,32.62,77.25,11201.93,1,8.24,8.60,0.87
146,0,1226798,3758,34.42,11236.35,2,1284013,57215,1226798,3758,34.42,76.96,11236.35,1,7.02,8.60,0.14
147,0,1230568,3770,34.53,11270.88,2,1285898,55330,1230568,3770,34.53,76.67,11270.88,0,6.93,8.60,0.14
148,0,1234298,3730,34.16,11305.04,2,1287763,53465,1234298,3730,34.16,76.39,11305.04,1,6.96,8.60,0.68
149,0,1238000,3702,33.91,11338.95,2,1289614,51614,1238000,3702,33.91,76.10,11338.95,0,6.60,8.60,0.68
150,0,1241668,3668,33.60,11372.55,2,1291448,49780,1241668,3668,33.60,75.82,11372.55,1,6.64,8.60,0.67
151,0,1245304,3636,33.30,11405.85,2,1293266,47962,1245304,3636,33.30,75.54,11405.85,0,5.63,8.60,0.67
152,0,1248914,3610,33.06,11438.91,2,1295071,46157,1248914,3610,33.06,75.26,11438.91,1,5.66,8.60,0.66
153,0,1252494,3580,32.79,11471.70,2,1296861,44367,1252494,3580,32.79,74.98,11471.70,0,4.30,8.60,0.66
154,0,1256050,3556,32.57,11504.27,2,1298639,42589,1256050,3556,32.57,74.70,11504.27,1,4.33,8.60,0.65
155,0,1259584,3534,32.37,11536.64,2,1300406,40822,1259584,3534,32.37,74.43,11536.64,0,2.31,8.60,0.65
156,0,1263094,3510,32.15,11568.79,2,1302161,39067,1263094,3510,32.15,74.16,11568.79,1,2.34,8.60,0.65
157,0,1266578,3484,31.91,11600.70,2,1303903,37325,1266578,3484,31.91,73.89,11600.70,0,1.73,8.60,0.65
158,0,1270030,3452,31.62,11632.32,2,1305629,35599,1270030,3452,31.62,73.62,11632.32,0,1.76,8.60,0.64
159,0,1273462,3432,31.43,11663.75,2,1307345,33883,1273462,3432,31.43,73.36,11663.75,1,2.09,8.60,1.27
160,0,1276862,3400,31.14,11694.89,2,1309045,32183,1276862,3400,31.14,73.09,11694.89,0,0.39,8.60,1.27
161,0,1280242,3380,30.96,11725.85,2,1310735,30493,1280242,3380,30.96,72.83,11725.85,1,0.42,8.60,0.63
162,0,1283506,3264,29.90,11755.74,2,1312367,28861,1283506,3264,29.90,72.57,11755.74,0,0.42,8.60,0.63
163,0,1286924,3418,31.31,11787.05,2,1314076,27152,1286924,3418,31.31,72.31,11787.05,1,0.42,8.60,0.62
164,0,1290628,3704,33.93,11820.98,2,1315928,25300,1290628,3704,33.93,72.08,11820.98,1,0.42,8.60,0.62
165,0,1294488,3860,35.35,11856.33,2,1317858,23370,1294488,3860,35.35,71.86,11856.33,0,0.42,8.60,0.61
166,0,1298524,4036,36.97,11893.30,2,1319876,21352,1298524,4036,36.97,71.65,11893.30,0,0.42,8.60,1.21
167,0,1302768,4244,38.87,11932.17,2,1321998,19230,1302768,4244,38.87,71.45,11932.17,1,0.42,8.60,1.81
168,0,1307398,4630,42.41,11974.57,2,1324313,16915,1307398,4630,42.41,71.28,11974.57,1,0.42,8.60,0.85
169,0,1313774,6376,58.40,12032.97,2,1327501,13727,1313774,6376,58.40,71.20,12032.97,0,0.42,8.60,0.93
170,0,1325646,11872,108.74,12141.71,2,1333437,7791,1325646,11872,108.74,71.42,12141.71,1,0.42,8.60,1.52
171,0,1352463,26817,245.62,12387.33,2,1352463,0,1352463,26817,245.62,72.44,12387.33,1,0.42,8.60,1.87
172,0,1388173,35710,327.07,12714.40,2,1388173,0,1388173,35710,327.07,73.92,12714.40,0,0.42,8.60,2.13
173,0,1423683,35510,325.24,13039.64,2,1423683,0,1423683,35510,325.24,75.37,13039.64,1,0.42,8.60,2.70
174,0,1459297,35614,326.19,13365.83,2,1459297,0,1459297,35614,326.19,76.82,13365.83,0,0.77,8.60,3.03
175,0,1495474,36177,331.35,13697.18,2,1495474,0,1495474,36177,331.35,78.27,13697.18,0,2.36,8.60,3.59
176,0,1531633,36159,331.18,14028.36,2,1531633,0,1531633,36159,331.18,79.71,14028.36,1,4.15,8.60,4.14
177,0,1566033,34400,315.07,14343.43,2,1566033,0,1566033,34400,315.07,81.04,14343.43,0,3.78,8.60,3.41
178,0,1599866,33833,309.88,14653.31,2,1599866,0,1599866,33833,309.88,82.32,14653.31,0,6.33,8.60,3.95
179,0,1631347,31481,288.34,14941.65,2,1631347,0,1631347,31481,288.34,83.47,14941.65,0,8.25,8.60,4.49
180,0,1631347,0,0.00,14941.65,2,1641820,10473,1631347,0,0.00,83.01,14941.65,1,10.74,9.74,5.03
181,0,1631347,0,0.00,14941.65,2,1648125,16778,1631347,0,0.00,82.55,14941.65,1,11.20,10.20,4.67
182,0,1631347,0,0.00,14941.65,2,1652882,21535,1631347,0,0.00,82.10,14941.65,0,11.15,10.15,4.18
183,0,1631347,0,0.00,14941.65,2,1656956,25609,1631347,0,0.00,81.65,14941.65,1,11.72,10.72,4.71
184,0,1638803,7456,68.29,15009.94,2,1660684,21881,1638803,7456,68.29,81.58,15009.94,1,10.65,10.72,4.05
185,0,1645835,7032,64.41,15074.35,2,1664200,18365,1645835,7032,64.41,81.48,15074.35,0,10.01,10.72,3.97
186,0,1645835,0,0.00,15074.35,2,1667414,21579,1645835,0,0.00,81.04,15074.35,1,10.76,9.76,4.49
187,0,1645835,0,0.00,15074.35,2,1670396,24561,1645835,0,0.00,80.61,15074.35,0,10.31,9.31,3.50
188,0,1645835,0,0.00,15074.35,2,1673097,27262,1645835,0,0.00,80.18,15074.35,1,10.31,9.31,4.02
189,0,1645835,0,0.00,15074.35,2,1675615,29780,1645835,0,0.00,79.76,15074.35,0,9.69,8.69,3.76
190,0,1645835,0,0.00,15074.35,2,1677981,32146,1645835,0,0.00,79.34,15074.35,1,9.69,8.69,4.27
191,0,1650377,4542,41.60,15115.95,2,1680252,29875,1650377,4542,41.60,79.14,15115.95,0,8.27,8.69,3.60
192,0,1654921,4544,41.62,15157.57,2,1682524,27603,1654921,4544,41.62,78.95,15157.57,0,8.60,8.69,4.10
193,0,1654921,0,0.00,15157.57,2,1684736,29815,1654921,0,0.00,78.54,15157.57,1,8.92,8.00,4.60
194,0,1659201,4280,39.20,15196.77,2,1686876,27675,1659201,4280,39.20,78.33,15196.77,1,8.91,9.91,4.00
195,0,1663593,4392,40.23,15237.00,2,1689072,25479,1663593,4392,40.23,78.14,15237.00,0,7.50,9.91,3.32
196,0,1668239,4646,42.55,15279.55,2,1691395,23156,1668239,4646,42.55,77.96,15279.55,1,7.50,9.91,3.32
197,0,1673193,4954,45.37,15324.92,2,1693872,20679,1673193,4954,45.37,77.79,15324.92,0,7.50,9.91,3.32
198,0,1678339,5146,47.13,15372.05,2,1696445,18106,1678339,5146,47.13,77.64,15372.05,0,6.59,9.91,3.74
199,0,1683857,5518,50.54,15422.59,2,1699204,15347,1683857,5518,50.54,77.50,15422.59,0,7.21,9.91,4.22
200,0,1692869,9012,82.54,15505.14,2,1703710,10841,1692869,9012,82.54,77.53,15505.14,1,7.86,9.91,4.70
201,0,1713631,20762,190.16,15695.30,2,1714091,460,1713631,20762,190.16,78.09,15695.30,1,6.86,9.91,3.86
202,0,1749538,35907,328.88,16024.17,2,1749538,0,1749538,35907,328.88,79.33,16024.17,0,6.39,9.91,3.60
203,0,1784083,34545,316.40,16340.57,2,1784083,0,1784083,34545,316.40,80.50,16340.57,1,8.51,9.91,4.08
204,0,1818660,34577,316.69,16657.27,2,1818660,0,1818660,34577,316.69,81.65,16657.27,1,9.32,9.91,3.59
205,0,1818660,0,0.00,16657.27,2,1829306,10646,1818660,0,0.00,81.25,16657.27,0,10.39,9.39,3.39
206,0,1818660,0,0.00,16657.27,2,1835572,16912,1818660,0,0.00,80.86,16657.27,1,10.43,9.43,3.86
207,0,1818660,0,0.00,16657.27,2,1840609,21949,1818660,0,0.00,80.47,16657.27,0,10.81,9.81,3.70
208,0,1818660,0,0.00,16657.27,2,1844883,26223,1818660,0,0.00,80.08,16657.27,1,10.81,9.81,4.16
209,0,1826688,8028,73.53,16730.80,2,1848897,22209,1826688,8028,73.53,80.05,16730.80,1,9.22,9.81,3.42
210,0,1834368,7680,70.34,16801.14,2,1852737,18369,1834368,7680,70.34,80.01,16801.14,0,8.36,9.81,3.18
211,0,1841718,7350,67.32,16868.46,2,1856412,14694,1841718,7350,67.32,79.95,16868.46,0,8.43,9.81,3.64
212,0,1841718,0,0.00,16868.46,2,1859645,17927,1841718,0,0.00,79.57,16868.46,1,9.94,8.94,4.09
213,0,1848432,6714,61.49,16929.95,2,1863002,14570,1848432,6714,61.49,79.48,16929.95,0,8.50,8.94,3.47
214,0,1859668,11236,102.91,17032.86,2,1868620,8952,1859668,11236,102.91,79.59,17032.86,1,8.56,8.94,3.93
215,0,1887019,27351,250.51,17283.37,2,1887019,0,1887019,27351,250.51,80.39,17283.37,0,7.08,8.94,3.20
216,0,1887019,0,0.00,17283.37,2,1897640,10621,1887019,0,0.00,80.02,17283.37,1,10.04,9.04,3.65
217,0,1887019,0,0.00,17283.37,2,1903730,16711,1887019,0,0.00,79.65,17283.37,0,9.05,8.05,2.45
218,0,1887019,0,0.00,17283.37,2,1908402,21383,1887019,0,0.00,79.28,17283.37,0,9.37,8.37,2.90
219,0,1887019,0,0.00,17283.37,2,1912584,25565,1887019,0,0.00,78.92,17283.37,0,9.66,8.66,3.34
220,0,1887019,0,0.00,17283.37,2,1916351,29332,1887019,0,0.00,78.56,17283.37,1,9.94,8.94,3.78
221,0,1893843,6824,62.50,17345.88,2,1919763,25920,1893843,6824,62.50,78.49,17345.88,0,8.89,8.94,3.24
222,0,1893843,0,0.00,17345.88,2,1922552,28709,1893843,0,0.00,78.13,17345.88,1,8.95,8.00,3.68
223,0,1899959,6116,56.02,17401.89,2,1925610,25651,1899959,6116,56.02,78.04,17401.89,0,6.97,8.00,2.71
224,0,1906283,6324,57.92,17459.81,2,1928772,22489,1906283,6324,57.92,77.95,17459.81,1,7.03,8.00,3.14
225,0,1912525,6242,57.17,17516.98,2,1931893,19368,1912525,6242,57.17,77.85,17516.98,1,5.97,8.00,2.68
226,0,1918841,6316,57.85,17574.83,2,1935051,16210,1918841,6316,57.85,77.76,17574.83,0,5.38,8.00,2.55
227,0,1925797,6956,63.71,17638.54,2,1938529,12732,1925797,6956,63.71,77.70,17638.54,0,5.70,8.00,2.98
228,0,1939959,14162,129.71,17768.26,2,1945610,5651,1939959,14162,129.71,77.93,17768.26,1,5.76,8.00,3.41
229,0,1970529,30570,279.99,18048.25,2,1970529,0,1970529,30570,279.99,78.81,18048.25,1,6.53,8.00,2.80
230,0,2001376,30847,282.53,18330.78,2,2001376,0,2001376,30847,282.53,79.70,18330.78,0,7.52,8.00,2.54
231,0,2030330,28954,265.19,18595.97,2,2030330,0,2030330,28954,265.19,80.50,18595.97,1,9.61,10.61,2.97
232,0,2062734,32404,296.79,18892.76,2,2062734,0,2062734,32404,296.79,81.43,18892.76,0,9.24,10.61,2.69
233,0,2095515,32781,300.24,19193.01,2,2095515,0,2095515,32781,300.24,82.37,19193.01,1,10.00,10.61,3.11
234,0,2128273,32758,300.03,19493.04,2,2128273,0,2128273,32758,300.03,83.30,19493.04,1,10.41,10.61,2.83
235,0,2128273,0,0.00,19493.04,2,2139300,11027,2128273,0,0.00,82.95,19493.04,0,11.73,10.73,2.46
236,0,2128273,0,0.00,19493.04,2,2145331,17058,2128273,0,0.00,82.60,19493.04,1,12.82,11.82,2.88
237,0,2128273,0,0.00,19493.04,2,2149723,21450,2128273,0,0.00,82.25,19493.04,0,12.06,11.06,2.44
238,0,2128273,0,0.00,19493.04,2,2153717,25444,2128273,0,0.00,81.90,19493.04,0,12.06,11.06,2.86
239,0,2128273,0,0.00,19493.04,2,2157467,29194,2128273,0,0.00,81.56,19493.04,0,12.06,11.06,3.26
240,0,2128273,0,0.00,19493.04,2,2160886,32613,2128273,0,0.00,81.22,19493.04,1,12.74,11.74,3.67
241,0,2134451,6178,56.58,19549.62,2,2163975,29524,2134451,6178,56.58,81.12,19549.62,0,11.72,11.74,3.16
242,0,2134451,0,0.00,19549.62,2,2166872,32421,2134451,0,0.00,80.78,19549.62,1,11.78,10.78,3.57
243,0,2134451,0,0.00,19549.62,2,2169679,35228,2134451,0,0.00,80.45,19549.62,1,10.92,9.92,3.15
244,0,2139785,5334,48.85,19598.48,2,2172346,32561,2139785,5334,48.85,80.32,19598.48,0,9.54,9.92,2.65
245,0,2144857,5072,46.45,19644.93,2,2174882,30025,2144857,5072,46.45,80.18,19644.93,1,9.88,9.92,3.05
246,0,2149589,4732,43.34,19688.28,2,2177248,27659,2149589,4732,43.34,80.03,19688.28,1,9.74,9.92,2.93
247,0,2154703,5114,46.84,19735.12,2,2179805,25102,2154703,5114,46.84,79.90,19735.12,0,8.84,9.92,2.70
248,0,2159881,5178,47.43,19782.54,2,2182394,22513,2159881,5178,47.43,79.77,19782.54,0,8.98,9.92,3.10
249,0,2165059,5178,47.43,19829.97,2,2184983,19924,2165059,5178,47.43,79.64,19829.97,1,9.34,9.92,3.49
250,0,2170507,5448,49.90,19879.87,2,2187707,17200,2170507,5448,49.90,79.52,19879.87,1,8.06,9.92,3.04
251,0,2176541,6034,55.27,19935.13,2,2190724,14183,2176541,6034,55.27,79.42,19935.13,0,7.77,9.92,2.75
252,0,2186981,10440,95.62,20030.75,2,2195944,8963,2186981,10440,95.62,79.49,20030.75,1,9.03,9.92,3.14
253,0,2213161,26180,239.78,20270.54,2,2213161,0,2213161,26180,239.78,80.12,20270.54,0,7.90,9.92,2.75
254,0,2213554,393,3.60,20274.14,2,2224030,10476,2213554,393,3.60,79.82,20274.14,1,10.20,9.20,3.13
255,0,2213554,0,0.00,20274.14,2,2230027,16473,2213554,0,0.00,79.51,20274.14,0,9.60,8.60,2.51
256,0,2213554,0,0.00,20274.14,2,2234627,21073,2213554,0,0.00,79.20,20274.14,1,9.60,8.60,2.89
257,0,2221870,8316,76.17,20350.30,2,2238785,16915,2221870,8316,76.17,79.18,20350.30,0,8.24,8.60,2.39
258,0,2221870,0,0.00,20350.30,2,2242411,20541,2221870,0,0.00,78.88,20350.30,0,8.77,8.00,2.77
259,0,2229160,7290,66.77,20417.07,2,2246056,16896,2229160,7290,66.77,78.83,20417.07,1,9.54,10.54,3.15
260,0,2237124,7964,72.94,20490.02,2,2250038,12914,2237124,7964,72.94,78.81,20490.02,0,8.28,10.54,2.68
261,0,2250812,13688,125.37,20615.38,2,2256882,6070,2250812,13688,125.37,78.99,20615.38,1,8.35,10.54,3.05
262,0,2281798,30986,283.80,20899.19,2,2281798,0,2281798,30986,283.80,79.77,20899.19,0,7.88,10.54,2.53
263,0,2314831,33033,302.55,21201.74,2,2314831,0,2314831,33033,302.55,80.61,21201.74,1,9.27,10.54,2.90
264,0,2348890,34059,311.95,21513.69,2,2348890,0,2348890,34059,311.95,81.49,21513.69,0,9.86,10.54,2.31
265,0,2348890,0,0.00,21513.69,2,2359900,11010,2348890,0,0.00,81.18,21513.69,1,11.27,10.27,2.68
266,0,2348890,0,0.00,21513.69,2,2366204,17314,2348890,0,0.00,80.88,21513.69,0,10.39,9.39,2.41
267,0,2348890,0,0.00,21513.69,2,2370550,21660,2348890,0,0.00,80.58,21513.69,1,10.39,9.39,2.78
268,0,2357726,8836,80.93,21594.62,2,2374968,17242,2357726,8836,80.93,80.58,21594.62,1,9.21,9.39,2.45
269,0,2366858,9132,83.64,21678.26,2,2379534,12676,2366858,9132,83.64,80.59,21678.26,0,8.31,9.39,2.05
270,0,2379706,12848,117.68,21795.94,2,2385958,6252,2379706,12848,117.68,80.73,21795.94,1,9.01,9.39,2.41
271,0,2411447,31741,290.72,22086.66,2,2411447,0,2411447,31741,290.72,81.50,22086.66,0,8.30,9.39,2.03
272,0,2411447,0,0.00,22086.66,2,2422388,10941,2411447,0,0.00,81.20,22086.66,1,10.88,9.88,2.39
273,0,2411447,0,0.00,22086.66,2,2428681,17234,2411447,0,0.00,80.90,22086.66,0,10.31,9.31,1.71
274,0,2411447,0,0.00,22086.66,2,2433246,21799,2411447,0,0.00,80.61,22086.66,1,10.89,9.89,2.07
275,0,2419175,7728,70.78,22157.44,2,2437110,17935,2419175,7728,70.78,80.57,22157.44,0,9.36,9.89,1.35
276,0,2419175,0,0.00,22157.44,2,2440944,21769,2419175,0,0.00,80.28,22157.44,1,9.89,8.89,1.70
277,0,2426113,6938,63.55,22220.98,2,2444413,18300,2426113,6938,63.55,80.22,22220.98,0,8.49,8.89,1.26
278,0,2426113,0,0.00,22220.98,2,2447761,21648,2426113,0,0.00,79.93,22220.98,0,8.92,8.00,1.62
279,0,2432277,6164,56.46,22277.44,2,2450843,18566,2432277,6164,56.46,79.85,22277.44,1,9.13,10.13,1.97
280,0,2438891,6614,60.58,22338.02,2,2454150,15259,2438891,6614,60.58,79.78,22338.02,0,8.07,10.13,1.53
281,0,2448225,9334,85.49,22423.51,2,2458817,10592,2448225,9334,85.49,79.80,22423.51,1,8.53,10.13,1.88
282,0,2466559,18334,167.92,22591.43,2,2467984,1425,2466559,18334,167.92,80.11,22591.43,1,7.38,10.13,1.33
283,0,2501464,34905,319.70,22911.13,2,2501464,0,2501464,34905,319.70,80.96,22911.13,0,6.80,10.13,1.03
284,0,2533845,32381,296.58,23207.71,2,2533845,0,2533845,32381,296.58,81.72,23207.71,1,9.09,10.13,1.38
285,0,2533845,0,0.00,23207.71,2,2544313,10468,2533845,0,0.00,81.43,23207.71,0,10.55,9.55,1.26
286,0,2533845,0,0.00,23207.71,2,2550059,16214,2533845,0,0.00,81.15,23207.71,1,11.27,10.27,1.60
287,0,2544381,10536,96.50,23304.21,2,2555327,10946,2544381,10536,96.50,81.20,23304.21,0,10.26,10.27,1.05
288,0,2544381,0,0.00,23304.21,2,2560186,15805,2544381,0,0.00,80.92,23304.21,1,10.48,9.48,1.40
289,0,2544381,0,0.00,23304.21,2,2563631,19250,2544381,0,0.00,80.64,23304.21,0,9.61,8.61,1.21
290,0,2544381,0,0.00,23304.21,2,2566759,22378,2544381,0,0.00,80.36,23304.21,1,9.64,8.64,1.55
291,0,2550333,5952,54.51,23358.72,2,2569735,19402,2550333,5952,54.51,80.27,23358.72,0,8.34,8.64,1.08
292,0,2557505,7172,65.69,23424.41,2,2573321,15816,2557505,7172,65.69,80.22,23424.41,1,8.60,8.64,1.42
293,0,2567113,9608,88.00,23512.41,2,2578125,11012,2567113,9608,88.00,80.25,23512.41,0,7.59,8.64,1.11
294,0,2585363,18250,167.15,23679.57,2,2587250,1887,2585363,18250,167.15,80.54,23679.57,1,8.06,8.64,1.44
295,0,2619349,33986,311.28,23990.85,2,2619349,0,2619349,33986,311.28,81.32,23990.85,0,7.57,8.64,0.81
296,0,2619349,0,0.00,23990.85,2,2629837,10488,2619349,0,0.00,81.05,23990.85,1,9.03,8.03,1.15
297,0,2619349,0,0.00,23990.85,2,2635752,16403,2619349,0,0.00,80.78,23990.85,0,9.61,8.61,0.92
298,0,2619349,0,0.00,23990.85,2,2640539,21190,2619349,0,0.00,80.51,23990.85,0,9.65,8.65,1.25
299,0,2619349,0,0.00,23990.85,2,2644704,25355,2619349,0,0.00,80.24,23990.85,0,9.65,8.65,1.58
300,0,2619349,0,0.00,23990.85,2,2648423,29074,2619349,0,0.00,79.97,23990.85,1,9.74,8.74,1.91
301,0,2626371,7022,64.32,24055.16,2,2651934,25563,2626371,7022,64.32,79.92,24055.16,0,8.01,8.74,1.29
302,0,2633159,6788,62.17,24117.34,2,2655328,22169,2633159,6788,62.17,79.86,24117.34,1,8.12,8.74,1.61
303,0,2639049,5890,53.95,24171.28,2,2658273,19224,2639049,5890,53.95,79.77,24171.28,0,7.77,8.74,1.33
304,0,2645661,6612,60.56,24231.84,2,2661579,15918,2645661,6612,60.56,79.71,24231.84,1,7.97,8.74,1.66
305,0,2652645,6984,63.97,24295.81,2,2665071,12426,2652645,6984,63.97,79.66,24295.81,1,7.63,8.74,1.43
306,0,2666289,13644,124.97,24420.78,2,2671893,5604,2666289,13644,124.97,79.81,24420.78,0,6.96,8.74,1.30
307,0,2698725,32436,297.08,24717.86,2,2698725,0,2698725,32436,297.08,80.51,24717.86,1,7.23,8.74,1.62
308,0,2731172,32447,297.18,25015.04,2,2731172,0,2731172,32447,297.18,81.22,25015.04,1,7.64,8.74,1.39
309,0,2731172,0,0.00,25015.04,2,2741880,10708,2731172,0,0.00,80.95,25015.04,0,9.87,8.87,1.40
310,0,2731172,0,0.00,25015.04,2,2747576,16404,2731172,0,0.00,80.69,25015.04,1,10.32,9.32,1.72
311,0,2741430,10258,93.95,25109.00,2,2752705,11275,2741430,10258,93.95,80.74,25109.00,0,9.25,9.32,1.48
312,0,2741430,0,0.00,25109.00,2,2757168,15738,2741430,0,0.00,80.48,25109.00,1,9.75,8.75,1.80
313,0,2741430,0,0.00,25109.00,2,2760939,19509,2741430,0,0.00,80.22,25109.00,0,9.45,8.45,1.60
314,0,2741430,0,0.00,25109.00,2,2764127,22697,2741430,0,0.00,79.96,25109.00,1,9.51,8.51,1.91
315,0,2741430,0,0.00,25109.00,2,2767033,25603,2741430,0,0.00,79.71,25109.00,0,8.58,8.00,1.75
316,0,2747204,5774,52.88,25161.88,2,2769920,22716,2747204,5774,52.88,79.63,25161.88,1,8.64,9.64,2.07
317,0,2753030,5826,53.36,25215.24,2,2772833,19803,2753030,5826,53.36,79.54,25215.24,0,7.37,9.64,1.57
318,0,2759540,6510,59.63,25274.87,2,2776088,16548,2759540,6510,59.63,79.48,25274.87,0,7.57,9.64,1.88
319,0,2767210,7670,70.25,25345.12,2,2779923,12713,2767210,7670,70.25,79.45,25345.12,1,7.88,9.64,2.18
320,0,2780684,13474,123.41,25468.53,2,2786660,5976,2780684,13474,123.41,79.59,25468.53,0,7.34,9.64,2.01
321,0,2809753,29069,266.25,25734.78,2,2809753,0,2809753,29069,266.25,80.17,25734.78,1,8.40,9.64,2.32
322,0,2842282,32529,297.94,26032.71,2,2842282,0,2842282,32529,297.94,80.85,26032.71,0,8.41,9.64,1.98
323,0,2842282,0,0.00,26032.71,2,2852472,10190,2842282,0,0.00,80.60,26032.71,1,10.96,9.96,2.29
324,0,2842282,0,0.00,26032.71,2,2857985,15703,2842282,0,0.00,80.35,26032.71,1,10.43,9.43,2.03
325,0,2842282,0,0.00,26032.71,2,2862486,20204,2842282,0,0.00,80.10,26032.71,0,9.81,8.81,1.94
326,0,2842282,0,0.00,26032.71,2,2866176,23894,2842282,0,0.00,79.85,26032.71,1,9.88,8.88,2.24
327,0,2842282,0,0.00,26032.71,2,2869587,27305,2842282,0,0.00,79.61,26032.71,0,9.12,8.12,2.01
328,0,2842282,0,0.00,26032.71,2,2872670,30388,2842282,0,0.00,79.37,26032.71,1,9.38,8.38,2.31
329,0,2848218,5936,54.37,26087.08,2,2875638,27420,2848218,5936,54.37,79.29,26087.08,0,8.07,8.38,1.89
330,0,2854120,5902,54.06,26141.14,2,2878589,24469,2854120,5902,54.06,79.22,26141.14,1,8.22,8.38,2.19
331,0,2859830,5710,52.30,26193.44,2,2881444,21614,2859830,5710,52.30,79.13,26193.44,0,7.19,8.38,1.86
332,0,2866002,6172,56.53,26249.96,2,2884530,18528,2866002,6172,56.53,79.07,26249.96,1,7.40,8.38,2.16
333,0,2872298,6296,57.67,26307.63,2,2887678,15380,2872298,6296,57.67,79.00,26307.63,0,6.04,8.38,1.68
334,0,2879282,6984,63.97,26371.60,2,2891170,11888,2879282,6984,63.97,78.96,26371.60,0,6.19,8.38,1.97
335,0,2895282,16000,146.55,26518.14,2,2899170,3888,2895282,16000,146.55,79.16,26518.14,1,6.54,8.38,2.27
336,0,2927042,31760,290.89,26809.04,2,2927042,0,2927042,31760,290.89,79.79,26809.04,0,6.64,8.38,1.90
337,0,2927042,0,0.00,26809.04,2,2937249,10207,2927042,0,0.00,79.55,26809.04,0,8.61,8.00,2.19
338,0,2949713,22671,207.65,27016.68,2,2949713,0,2949713,22671,207.65,79.93,27016.68,1,9.43,10.43,2.48
339,0,2983307,33594,307.69,27324.37,2,2983307,0,2983307,33594,307.69,80.60,27324.37,0,9.27,10.43,2.19
340,0,3015654,32347,296.27,27620.64,2,3015654,0,3015654,32347,296.27,81.24,27620.64,0,10.31,10.43,2.48
341,0,3015654,0,0.00,27620.64,2,3025687,10033,3015654,0,0.00,81.00,27620.64,1,11.39,10.39,2.77
342,0,3015654,0,0.00,27620.64,2,3032154,16500,3015654,0,0.00,80.76,27620.64,0,11.72,10.72,2.59
343,0,3015654,0,0.00,27620.64,2,3037266,21612,3015654,0,0.00,80.53,27620.64,1,12.11,11.11,2.88
344,0,3015654,0,0.00,27620.64,2,3041244,25590,3015654,0,0.00,80.29,27620.64,1,11.71,10.71,2.69
345,0,3015654,0,0.00,27620.64,2,3044730,29076,3015654,0,0.00,80.06,27620.64,0,11.76,10.76,2.61
346,0,3015654,0,0.00,27620.64,2,3048231,32577,3015654,0,0.00,79.83,27620.64,1,11.76,10.76,2.89
347,0,3015654,0,0.00,27620.64,2,3051539,35885,3015654,0,0.00,79.60,27620.64,1,11.12,10.12,2.80
348,0,3015654,0,0.00,27620.64,2,3054631,38977,3015654,0,0.00,79.37,27620.64,1,11.05,10.05,2.77
349,0,3015654,0,0.00,27620.64,2,3057482,41828,3015654,0,0.00,79.14,27620.64,1,10.59,9.59,2.67
350,0,3015654,0,0.00,27620.64,2,3060084,44430,3015654,0,0.00,78.92,27620.64,0,9.94,8.94,2.51
351,0,3015654,0,0.00,27620.64,2,3062537,46883,3015654,0,0.00,78.69,27620.64,1,9.94,8.94,2.79
352,0,3015654,0,0.00,27620.64,2,3064865,49211,3015654,0,0.00,78.47,27620.64,0,9.04,8.04,2.59
353,0,3015654,0,0.00,27620.64,2,3067089,51435,3015654,0,0.00,78.25,27620.64,0,9.04,8.04,2.86
354,0,3015654,0,0.00,27620.64,2,3069221,53567,3015654,0,0.00,78.02,27620.64,1,9.04,8.04,3.14
355,0,3019824,4170,38.19,27658.83,2,3071306,51482,3019824,4170,38.19,77.91,27658.83,0,7.86,8.04,2.88
356,0,3023282,3458,31.67,27690.51,2,3073035,49753,3023282,3458,31.67,77.78,27690.51,1,7.89,8.04,3.16
357,0,3027238,3956,36.23,27726.74,2,3075013,47775,3027238,3956,36.23,77.67,27726.74,0,6.97,8.04,2.80
358,0,3031280,4042,37.02,27763.76,2,3077034,45754,3031280,4042,37.02,77.55,27763.76,0,7.01,8.04,3.07
359,0,3035312,4032,36.93,27800.69,2,3079050,43738,3035312,4032,36.93,77.44,27800.69,0,7.31,8.04,3.34
360,0,3039286,3974,36.40,27837.09,2,3081037,41751,3039286,3974,36.40,77.33,27837.09,1,7.58,8.04,3.61
361,0,3043246,3960,36.27,27873.36,2,3083017,39771,3043246,3960,36.27,77.21,27873.36,0,6.07,8.04,3.13
362,0,3047036,3790,34.71,27908.07,2,3084912,37876,3047036,3790,34.71,77.09,27908.07,1,6.10,8.04,3.39
363,0,3050892,3856,35.32,27943.39,2,3086840,35948,3050892,3856,35.32,76.98,27943.39,0,4.58,8.04,2.93
364,0,3054830,3938,36.07,27979.46,2,3088809,33979,3054830,3938,36.07,76.87,27979.46,1,5.25,8.04,3.20
365,0,3058692,3862,35.37,28014.83,2,3090740,32048,3058692,3862,35.37,76.75,28014.83,1,4.13,8.04,2.89
366,0,3062412,3720,34.07,28048.90,2,3092600,30188,3062412,3720,34.07,76.64,28048.90,0,3.12,8.04,2.70
367,0,3066294,3882,35.56,28084.46,2,3094541,28247,3066294,3882,35.56,76.52,28084.46,1,3.42,8.04,2.97
368,0,3070094,3800,34.80,28119.26,2,3096441,26347,3070094,3800,34.80,76.41,28119.26,1,2.64,8.04,2.88
369,0,3073976,3882,35.56,28154.82,2,3098382,24406,3073976,3882,35.56,76.30,28154.82,1,2.75,8.04,2.97
370,0,3078048,4072,37.30,28192.11,2,3100418,22370,3078048,4072,37.30,76.19,28192.11,0,2.38,8.04,3.06
371,0,3082332,4284,39.24,28231.35,2,3102560,20228,3082332,4284,39.24,76.10,28231.35,1,2.42,8.04,3.33
372,0,3086718,4386,40.17,28271.52,2,3104753,18035,3086718,4386,40.17,76.00,28271.52,0,2.47,8.04,3.47
373,0,3091636,4918,45.04,28316.57,2,3107212,15576,3091636,4918,45.04,75.92,28316.57,1,2.85,8.04,3.73
374,0,3099514,7878,72.16,28388.72,2,3111151,11637,3099514,7878,72.16,75.91,28388.72,0,2.35,8.04,3.76
375,0,3116242,16728,153.21,28541.94,2,3119515,3273,3116242,16728,153.21,76.11,28541.94,0,2.57,8.04,4.02
376,0,3148425,32183,294.77,28836.70,2,3148425,0,3148425,32183,294.77,76.69,28836.70,1,3.01,8.04,4.27
377,0,3180813,32388,296.64,29133.35,2,3180813,0,3180813,32388,296.64,77.28,29133.35,0,2.29,8.04,3.90
378,0,3213816,33003,302.28,29435.62,2,3213816,0,3213816,33003,302.28,77.87,29435.62,0,4.25,8.04,4.16
379,0,3246575,32759,300.04,29735.67,2,3246575,0,3246575,32759,300.04,78.46,29735.67,1,5.82,8.04,4.41
380,0,3276768,30193,276.54,30012.21,2,3276768,0,3276768,30193,276.54,78.98,30012.21,0,5.74,8.04,4.11
381,0,3305972,29204,267.48,30279.69,2,3305972,0,3305972,29204,267.48,79.47,30279.69,1,7.08,8.04,4.36
382,0,3335730,29758,272.56,30552.24,2,3335730,0,3335730,29758,272.56,79.98,30552.24,0,7.62,8.04,4.00
383,0,3335730,0,0.00,30552.24,2,3346742,11012,3335730,0,0.00,79.77,30552.24,0,9.33,8.33,4.25
384,0,3335730,0,0.00,30552.24,2,3353090,17360,3335730,0,0.00,79.56,30552.24,1,10.04,9.04,4.50
385,0,3335730,0,0.00,30552.24,2,3358083,22353,3335730,0,0.00,79.36,30552.24,1,10.13,9.13,4.24
386,0,3343886,8156,74.70,30626.95,2,3362161,18275,3343886,8156,74.70,79.34,30626.95,0,9.09,9.13,4.07
387,0,3343886,0,0.00,30626.95,2,3366216,22330,3343886,0,0.00,79.14,30626.95,1,9.74,8.74,4.32
388,0,3343886,0,0.00,30626.95,2,3369718,25832,3343886,0,0.00,78.94,30626.95,0,8.82,8.00,3.99
389,0,3350318,6432,58.91,30685.86,2,3372934,22616,3350318,6432,58.91,78.88,30685.86,1,9.67,10.67,4.24
390,0,3356642,6324,57.92,30743.78,2,3376096,19454,3356642,6324,57.92,78.83,30743.78,1,9.02,10.67,4.19
391,0,3363180,6538,59.88,30803.66,2,3379365,16185,3363180,6538,59.88,78.78,30803.66,0,8.63,10.67,3.96
392,0,3370738,7558,69.22,30872.89,2,3383144,12406,3370738,7558,69.22,78.76,30872.89,1,8.68,10.67,4.21
393,0,3387008,16270,149.02,31021.90,2,3391279,4271,3387008,16270,149.02,78.94,31021.90,0,7.91,10.67,4.00
394,0,3415741,28733,263.17,31285.07,2,3415741,0,3415741,28733,263.17,79.40,31285.07,1,9.65,10.67,4.24
395,0,3447432,31691,290.26,31575.33,2,3447432,0,3447432,31691,290.26,79.94,31575.33,0,10.08,10.67,3.96
396,0,3447432,0,0.00,31575.33,2,3458159,10727,3447432,0,0.00,79.74,31575.33,1,12.37,11.37,4.20
397,0,3467750,20318,186.09,31761.43,2,3468318,568,3467750,20318,186.09,80.00,31761.43,0,11.01,11.37,3.67
398,0,3467750,0,0.00,31761.43,2,3479219,11469,3467750,0,0.00,79.80,31761.43,0,11.48,10.48,3.92
399,0,3467750,0,0.00,31761.43,2,3484698,16948,3467750,0,0.00,79.60,31761.43,0,13.35,12.35,4.16
400,0,3467750,0,0.00,31761.43,2,3488581,20831,3467750,0,0.00,79.40,31761.43,1,13.76,12.76,4.40
401,0,3474948,7198,65.93,31827.36,2,3492180,17232,3474948,7198,65.93,79.37,31827.36,0,12.52,12.76,4.14
402,0,3474948,0,0.00,31827.36,2,3495945,20997,3474948,0,0.00,79.17,31827.36,0,13.16,12.16,4.38
403,0,3474948,0,0.00,31827.36,2,3499123,24175,3474948,0,0.00,78.98,31827.36,1,13.87,12.87,4.62
404,0,3480890,5942,54.42,31881.78,2,3502094,21204,3480890,5942,54.42,78.92,31881.78,0,12.08,12.87,4.16
405,0,3486768,5878,53.84,31935.62,2,3505033,18265,3486768,5878,53.84,78.85,31935.62,1,12.13,12.87,4.39
406,0,3493012,6244,57.19,31992.80,2,3508155,15143,3493012,6244,57.19,78.80,31992.80,0,10.89,12.87,3.95
407,0,3501434,8422,77.14,32069.94,2,3512366,10932,3501434,8422,77.14,78.80,32069.94,1,12.23,12.87,4.18
408,0,3519904,18470,169.17,32239.11,2,3521601,1697,3519904,18470,169.17,79.02,32239.11,1,11.49,12.87,4.02
409,0,3549209,29305,268.41,32507.52,2,3549209,0,3549209,29305,268.41,79.48,32507.52,1,11.72,12.87,4.01
410,0,3579702,30493,279.29,32786.80,2,3579702,0,3579702,30493,279.29,79.97,32786.80,1,12.13,12.87,3.93
411,0,3611101,31399,287.59,33074.39,2,3611101,0,3611101,31399,287.59,80.47,33074.39,0,12.52,12.87,3.85
412,0,3611101,0,0.00,33074.39,2,3621111,10010,3611101,0,0.00,80.28,33074.39,1,14.29,13.29,4.08
413,0,3611101,0,0.00,33074.39,2,3627033,15932,3611101,0,0.00,80.08,33074.39,0,14.12,13.12,3.97
414,0,3611101,0,0.00,33074.39,2,3631440,20339,3611101,0,0.00,79.89,33074.39,1,14.53,13.53,4.20
415,0,3611101,0,0.00,33074.39,2,3635274,24173,3611101,0,0.00,79.70,33074.39,0,13.68,12.68,3.95
416,0,3611101,0,0.00,33074.39,2,3638453,27352,3611101,0,0.00,79.51,33074.39,1,13.86,12.86,4.18
417,0,3611101,0,0.00,33074.39,2,3641652,30551,3611101,0,0.00,79.32,33074.39,0,12.87,11.87,3.89
418,0,3611101,0,0.00,33074.39,2,3644708,33607,3611101,0,0.00,79.13,33074.39,0,13.06,12.06,4.12
419,0,3611101,0,0.00,33074.39,2,3647546,36445,3611101,0,0.00,78.94,33074.39,1,13.83,12.83,4.35
420,0,3615887,4786,43.84,33118.23,2,3649939,34052,3615887,4786,43.84,78.85,33118.23,1,12.33,12.83,3.96
421,0,3621445,5558,50.91,33169.13,2,3652718,31273,3621445,5558,50.91,78.79,33169.13,0,11.16,12.83,3.69
422,0,3626947,5502,50.39,33219.53,2,3655469,28522,3626947,5502,50.39,78.72,33219.53,1,11.21,12.83,3.92
423,0,3632343,5396,49.42,33268.95,2,3658167,25824,3632343,5396,49.42,78.65,33268.95,0,9.75,12.83,3.58
424,0,3637759,5416,49.61,33318.55,2,3660875,23116,3637759,5416,49.61,78.58,33318.55,1,9.80,12.83,3.81
425,0,3643079,5320,48.73,33367.28,2,3663535,20456,3643079,5320,48.73,78.51,33367.28,0,7.97,12.83,3.34
426,0,3648461,5382,49.29,33416.57,2,3666226,17765,3648461,5382,49.29,78.44,33416.57,1,8.02,12.83,3.57
427,0,3654343,5882,53.87,33470.45,2,3669167,14824,3654343,5882,53.87,78.39,33470.45,0,6.36,12.83,3.16
428,0,3662483,8140,74.55,33545.00,2,3673237,10754,3662483,8140,74.55,78.38,33545.00,1,6.41,12.83,3.39
429,0,3682901,20418,187.01,33732.02,2,3683446,545,3682901,20418,187.01,78.63,33732.02,0,6.50,12.83,3.12
430,0,3712092,29191,267.36,33999.38,2,3712092,0,3712092,29191,267.36,79.07,33999.38,1,8.42,12.83,3.34
431,0,3744022,31930,292.45,34291.83,2,3744022,0,3744022,31930,292.45,79.56,34291.83,0,9.43,12.83,3.29
432,0,3776467,32445,297.17,34588.99,2,3776467,0,3776467,32445,297.17,80.07,34588.99,1,10.56,12.83,3.51
433,0,3809359,32892,301.26,34890.25,2,3809359,0,3809359,32892,301.26,80.58,34890.25,0,9.30,12.83,3.16
434,0,3841286,31927,292.42,35182.68,2,3841286,0,3841286,31927,292.42,81.07,35182.68,1,11.84,12.83,3.39
435,0,3873120,31834,291.57,35474.25,2,3873120,0,3873120,31834,291.57,81.55,35474.25,0,12.32,12.83,3.11
436,0,3873120,0,0.00,35474.25,2,3883653,10533,3873120,0,0.00,81.36,35474.25,1,14.13,13.13,3.33
437,0,3873120,0,0.00,35474.25,2,3889856,16736,3873120,0,0.00,81.18,35474.25,0,13.13,12.13,2.99
438,0,3873120,0,0.00,35474.25,2,3894407,21287,3873120,0,0.00,80.99,35474.25,0,13.99,12.99,3.21
439,0,3873120,0,0.00,35474.25,2,3898467,25347,3873120,0,0.00,80.81,35474.25,1,14.31,13.31,3.43
440,0,3880794,7674,70.29,35544.54,2,3902304,21510,3880794,7674,70.29,80.78,35544.54,0,12.54,13.31,3.01
441,0,3888032,7238,66.29,35610.83,2,3905923,17891,3888032,7238,66.29,80.75,35610.83,1,13.18,13.31,3.23
442,0,3895456,7424,68.00,35678.82,2,3909635,14179,3895456,7424,68.00,80.72,35678.82,0,12.21,13.31,2.98
443,0,3903830,8374,76.70,35755.52,2,3913822,9992,3903830,8374,76.70,80.71,35755.52,1,13.15,13.31,3.20
444,0,3922090,18260,167.24,35922.77,2,3922952,862,3922090,18260,167.24,80.91,35922.77,0,11.62,13.31,2.84
445,0,3955197,33107,303.23,36226.00,2,3955197,0,3955197,33107,303.23,81.41,36226.00,1,12.64,13.31,3.06
446,0,3955197,0,0.00,36226.00,2,3965769,10572,3955197,0,0.00,81.22,36226.00,0,13.62,12.62,2.81
447,0,3955197,0,0.00,36226.00,2,3971417,16220,3955197,0,0.00,81.04,36226.00,1,15.31,14.31,3.03
448,0,3955197,0,0.00,36226.00,2,3975790,20593,3955197,0,0.00,80.86,36226.00,0,14.34,13.34,2.70
449,0,3955197,0,0.00,36226.00,2,3979719,24522,3955197,0,0.00,80.68,36226.00,1,15.22,14.22,2.92
450,0,3962493,7296,66.82,36292.82,2,3983367,20874,3962493,7296,66.82,80.65,36292.82,1,13.62,14.22,2.57
451,0,3969965,7472,68.44,36361.26,2,3987103,17138,3969965,7472,68.44,80.62,36361.26,0,12.36,14.22,2.32
452,0,3977385,7420,67.96,36429.22,2,3990813,13428,3977385,7420,67.96,80.60,36429.22,0,12.43,14.22,2.54
453,0,3986273,8888,81.41,36510.62,2,3995257,8984,3986273,8888,81.41,80.60,36510.62,0,13.55,14.22,2.75
454,0,4008466,22193,203.27,36713.89,2,4008466,0,4008466,22193,203.27,80.87,36713.89,1,13.63,14.22,2.97
455,0,4041735,33269,304.71,37018.61,2,4041735,0,4041735,33269,304.71,81.36,37018.61,1,13.74,14.22,2.65
456,0,4041735,0,0.00,37018.61,2,4052490,10755,4041735,0,0.00,81.18,37018.61,0,14.40,13.40,2.38
457,0,4041735,0,0.00,37018.61,2,4058252,16517,4041735,0,0.00,81.00,37018.61,0,14.98,13.98,2.59
458,0,4041735,0,0.00,37018.61,2,4062587,20852,4041735,0,0.00,80.83,37018.61,1,16.41,15.41,2.80
459,0,4049665,7930,72.63,37091.24,2,4066552,16887,4049665,7930,72.63,80.81,37091.24,0,15.26,15.41,2.52
460,0,4049665,0,0.00,37091.24,2,4070517,20852,4049665,0,0.00,80.63,37091.24,1,15.70,14.70,2.73
461,0,4049665,0,0.00,37091.24,2,4073853,24188,4049665,0,0.00,80.46,37091.24,0,14.77,13.77,2.56
462,0,4049665,0,0.00,37091.24,2,4076848,27183,4049665,0,0.00,80.28,37091.24,1,14.77,13.77,2.77
463,0,4055341,5676,51.99,37143.23,2,4079686,24345,4055341,5676,51.99,80.22,37143.23,1,13.63,13.77,2.49
464,0,4060987,5646,51.71,37194.94,2,4082509,21522,4060987,5646,51.71,80.16,37194.94,0,12.63,13.77,2.34
465,0,4066693,5706,52.26,37247.20,2,4085362,18669,4066693,5706,52.26,80.10,37247.20,1,12.68,13.77,2.55
466,0,4072787,6094,55.82,37303.02,2,4088409,15622,4072787,6094,55.82,80.05,37303.02,0,12.13,13.77,2.48
467,0,4080387,7600,69.61,37372.62,2,4092209,11822,4080387,7600,69.61,80.03,37372.62,1,12.19,13.77,2.69
468,0,4095085,14698,134.62,37507.25,2,4099558,4473,4095085,14698,134.62,80.14,37507.25,1,11.48,13.77,2.57
469,0,4126985,31900,292.17,37799.42,2,4126985,0,4126985,31900,292.17,80.60,37799.42,0,11.28,13.77,2.46
470,0,4159879,32894,301.28,38100.70,2,4159879,0,4159879,32894,301.28,81.07,38100.70,1,13.39,13.77,2.67
471,0,4159879,0,0.00,38100.70,2,4170518,10639,4159879,0,0.00,80.89,38100.70,0,14.63,13.63,2.48
472,0,4159879,0,0.00,38100.70,2,4176496,16617,4159879,0,0.00,80.72,38100.70,1,15.36,14.36,2.69
473,0,4170709,10830,99.19,38199.89,2,4181911,11202,4170709,10830,99.19,80.76,38199.89,0,14.24,14.36,2.52
474,0,4170709,0,0.00,38199.89,2,4186833,16124,4170709,0,0.00,80.59,38199.89,1,14.38,13.38,2.72
475,0,4179705,8996,82.40,38282.29,2,4191331,11626,4179705,8996,82.40,80.59,38282.29,0,12.99,13.38,2.41
476,0,4195413,15708,143.87,38426.16,2,4199185,3772,4195413,15708,143.87,80.73,38426.16,1,13.11,13.38,2.61
477,0,4226038,30625,280.50,38706.66,2,4226038,0,4226038,30625,280.50,81.15,38706.66,0,12.81,13.38,2.39
478,0,4226039,1,0.01,38706.66,2,4236632,10593,4226039,1,0.01,80.98,38706.66,0,14.59,13.59,2.60
479,0,4226039,0,0.00,38706.66,2,4242463,16424,4226039,0,0.00,80.81,38706.66,0,15.47,14.47,2.80
480,0,4226039,0,0.00,38706.66,2,4247095,21056,4226039,0,0.00,80.64,38706.66,1,16.05,15.05,3.00
481,0,4234641,8602,78.79,38785.45,2,4251396,16755,4234641,8602,78.79,80.64,38785.45,0,14.87,15.05,2.72
482,0,4243299,8658,79.30,38864.75,2,4255725,12426,4243299,8658,79.30,80.63,38864.75,1,14.95,15.05,2.93
483,0,4255023,11724,107.38,38972.13,2,4261587,6564,4255023,11724,107.38,80.69,38972.13,0,13.82,15.05,2.56
484,0,4284912,29889,273.76,39245.89,2,4284912,0,4284912,29889,273.76,81.09,39245.89,1,13.93,15.05,2.77
485,0,4317856,32944,301.74,39547.62,2,4317856,0,4317856,32944,301.74,81.54,39547.62,1,13.17,15.05,2.33
486,0,4350916,33060,302.80,39850.42,2,4350916,0,4350916,33060,302.80,82.00,39850.42,0,14.77,15.05,2.33
487,0,4350916,0,0.00,39850.42,2,4361502,10586,4350916,0,0.00,81.83,39850.42,1,16.72,15.72,2.53
488,0,4350916,0,0.00,39850.42,2,4367509,16593,4350916,0,0.00,81.66,39850.42,0,15.96,14.96,2.36
489,0,4350916,0,0.00,39850.42,2,4372149,21233,4350916,0,0.00,81.49,39850.42,1,15.96,14.96,2.56
490,0,4359284,8368,76.64,39927.07,2,4376333,17049,4359284,8368,76.64,81.48,39927.07,1,14.63,14.96,2.33
491,0,4368240,8956,82.03,40009.09,2,4380811,12571,4368240,8956,82.03,81.48,40009.09,0,13.62,14.96,2.18
492,0,4378490,10250,93.88,40102.98,2,4385936,7446,4378490,10250,93.88,81.51,40102.98,1,13.98,14.96,2.37
493,0,4405974,27484,251.73,40354.70,2,4405974,0,4405974,27484,251.73,81.86,40354.70,0,13.07,14.96,2.16
494,0,4405974,0,0.00,40354.70,2,4416994,11020,4405974,0,0.00,81.69,40354.70,1,15.89,14.89,2.36
495,0,4405974,0,0.00,40354.70,2,4422610,16636,4405974,0,0.00,81.52,40354.70,0,15.45,14.45,2.05
496,0,4405974,0,0.00,40354.70,2,4427150,21176,4405974,0,0.00,81.36,40354.70,1,16.60,15.60,2.25
497,0,4405974,0,0.00,40354.70,2,4431210,25236,4405974,0,0.00,81.20,40354.70,0,15.78,14.78,1.95
498,0,4405974,0,0.00,40354.70,2,4434883,28909,4405974,0,0.00,81.03,40354.70,0,15.91,14.91,2.14
499,0,4405974,0,0.00,40354.70,2,4438202,32228,4405974,0,0.00,80.87,40354.70,0,16.02,15.02,2.34
500,0,4405974,0,0.00,40354.70,2,4441261,35287,4405974,0,0.00,80.71,40354.70,1,16.02,15.02,2.53
501,0,4405974,0,0.00,40354.70,2,4443996,38022,4405974,0,0.00,80.55,40354.70,0,15.20,14.20,2.24
502,0,4405974,0,0.00,40354.70,2,4446530,40556,4405974,0,0.00,80.39,40354.70,1,15.25,14.25,2.43
503,0,4410572,4598,42.11,40396.82,2,4448829,38257,4410572,4598,42.11,80.31,40396.82,1,13.41,14.25,2.05
504,0,4415256,4684,42.90,40439.72,2,4451171,35915,4415256,4684,42.90,80.24,40439.72,1,11.95,14.25,1.77
505,0,4420122,4866,44.57,40484.29,2,4453604,33482,4420122,4866,44.57,80.17,40484.29,0,11.31,14.25,1.75
506,0,4424968,4846,44.38,40528.67,2,4456027,31059,4424968,4846,44.38,80.10,40528.67,1,11.35,14.25,1.95
507,0,4429778,4810,44.06,40572.73,2,4458432,28654,4429778,4810,44.06,80.03,40572.73,0,10.49,14.25,1.86
508,0,4434606,4828,44.22,40616.95,2,4460846,26240,4434606,4828,44.22,79.95,40616.95,1,11.10,14.25,2.05
509,0,4439434,4828,44.22,40661.17,2,4463260,23826,4439434,4828,44.22,79.88,40661.17,1,9.96,14.25,1.79
510,0,4444248,4814,44.09,40705.26,2,4465667,21419,4444248,4814,44.09,79.81,40705.26,0,9.30,14.25,1.76
511,0,4449108,4860,44.51,40749.77,2,4468097,18989,4449108,4860,44.51,79.75,40749.77,1,9.35,14.25,1.95
512,0,4454384,5276,48.32,40798.09,2,4470735,16351,4454384,5276,48.32,79.68,40798.09,0,8.26,14.25,1.80
513,0,4460522,6138,56.22,40854.31,2,4473804,13282,4460522,6138,56.22,79.64,40854.31,1,8.59,14.25,1.99
514,0,4473162,12640,115.77,40970.09,2,4480124,6962,4473162,12640,115.77,79.71,40970.09,0,8.14,14.25,1.85
515,0,4500640,27478,251.67,41221.76,2,4500640,0,4500640,27478,251.67,80.04,41221.76,0,9.35,14.25,2.04
516,0,4533975,33335,305.32,41527.08,2,4533975,0,4533975,33335,305.32,80.48,41527.08,1,11.30,14.25,2.23
517,0,4566288,32313,295.96,41823.04,2,4566288,0,4566288,32313,295.96,80.90,41823.04,0,11.43,14.25,1.96
518,0,4595422,29134,266.84,42089.88,2,4595422,0,4595422,29134,266.84,81.25,42089.88,0,12.05,14.25,2.15
519,0,4624615,29193,267.38,42357.26,2,4624615,0,4624615,29193,267.38,81.61,42357.26,0,12.31,14.25,2.34
520,0,4653558,28943,265.09,42622.35,2,4653558,0,4653558,28943,265.09,81.97,42622.35,1,13.76,14.25,2.53
521,0,4682830,29272,268.10,42890.45,2,4682830,0,4682830,29272,268.10,82.32,42890.45,0,12.92,14.25,2.23
522,0,4711961,29131,266.81,43157.27,2,4711961,0,4711961,29131,266.81,82.68,43157.27,1,13.59,14.25,2.42
523,0,4740896,28935,265.02,43422.29,2,4740896,0,4740896,28935,265.02,83.03,43422.29,0,12.94,14.25,2.30
524,0,4767308,26412,241.91,43664.20,2,4767308,0,4767308,26412,241.91,83.33,43664.20,1,12.94,14.25,2.30
525,0,4794251,26943,246.77,43910.97,2,4794251,0,4794251,26943,246.77,83.64,43910.97,1,13.22,14.25,2.31
526,0,4820851,26600,243.63,44154.60,2,4820851,0,4820851,26600,243.63,83.94,44154.60,0,12.86,14.25,2.17
527,0,4847787,26936,246.71,44401.31,2,4847787,0,4847787,26936,246.71,84.25,44401.31,0,13.66,14.25,2.35
528,0,4875178,27391,250.88,44652.18,2,4875178,0,4875178,27391,250.88,84.57,44652.18,1,13.95,14.25,2.54
529,0,4902670,27492,251.80,44903.99,2,4902670,0,4902670,27492,251.80,84.88,44903.99,1,14.17,14.25,2.48
530,0,4928832,26162,239.62,45143.61,2,4928832,0,4928832,26162,239.62,85.18,45143.61,0,13.45,14.25,2.36
531,0,4960729,31897,292.15,45435.75,2,4960729,0,4960729,31897,292.15,85.57,45435.75,1,14.19,14.25,2.54
532,0,4994885,34156,312.84,45748.59,2,4994885,0,4994885,34156,312.84,85.99,45748.59,1,13.25,14.25,2.30
533,0,5028928,34043,311.80,46060.39,2,5028928,0,5028928,34043,311.80,86.42,46060.39,0,14.21,14.25,2.27
534,0,5028928,0,0.00,46060.39,2,5039698,10770,5028928,0,0.00,86.26,46060.39,1,15.36,14.36,2.46
535,0,5028928,0,0.00,46060.39,2,5045400,16472,5028928,0,0.00,86.09,46060.39,0,16.87,15.87,2.25
536,0,5028928,0,0.00,46060.39,2,5049727,20799,5028928,0,0.00,85.93,46060.39,1,16.87,15.87,2.43
537,0,5036936,8008,73.35,46133.74,2,5053731,16795,5036936,8008,73.35,85.91,46133.74,0,15.51,15.87,2.22
538,0,5045102,8166,74.79,46208.54,2,5057814,12712,5045102,8166,74.79,85.89,46208.54,0,15.59,15.87,2.40
539,0,5045102,0,0.00,46208.54,2,5061524,16422,5045102,0,0.00,85.73,46208.54,0,17.25,16.25,2.58
540,0,5045102,0,0.00,46208.54,2,5064639,19537,5045102,0,0.00,85.57,46208.54,1,17.25,16.25,2.76
541,0,5051002,5900,54.04,46262.57,2,5067589,16587,5051002,5900,54.04,85.51,46262.57,0,15.65,16.25,2.47
542,0,5059076,8074,73.95,46336.52,2,5071626,12550,5059076,8074,73.95,85.49,46336.52,1,15.70,16.25,2.65
543,0,5076108,17032,156.00,46492.52,2,5080142,4034,5076108,17032,156.00,85.62,46492.52,0,14.42,16.25,2.44
544,0,5076108,0,0.00,46492.52,2,5088541,12433,5076108,0,0.00,85.46,46492.52,1,17.06,16.06,2.62
545,0,5090990,14882,136.31,46628.82,2,5095982,4992,5090990,14882,136.31,85.56,46628.82,0,15.36,16.06,2.30
546,0,5090990,0,0.00,46628.82,2,5103749,12759,5090990,0,0.00,85.40,46628.82,0,17.05,16.05,2.48
547,0,5090990,0,0.00,46628.82,2,5108558,17568,5090990,0,0.00,85.24,46628.82,1,19.06,18.06,2.66
548,0,5090990,0,0.00,46628.82,2,5111680,20690,5090990,0,0.00,85.09,46628.82,1,19.66,18.66,2.52
549,0,5090990,0,0.00,46628.82,2,5114091,23101,5090990,0,0.00,84.93,46628.82,0,20.30,19.30,2.40
550,0,5090990,0,0.00,46628.82,2,5116222,25232,5090990,0,0.00,84.78,46628.82,1,21.00,19.00,2.57
551,0,5090990,0,0.00,46628.82,2,5118192,27202,5090990,0,0.00,84.63,46628.82,0,19.64,18.64,2.36
552,0,5090990,0,0.00,46628.82,2,5120036,29046,5090990,0,0.00,84.47,46628.82,1,19.64,18.64,2.54
553,0,5094558,3568,32.68,46661.50,2,5121820,27262,5094558,3568,32.68,84.38,46661.50,1,18.40,18.64,2.36
554,0,5098530,3972,36.38,46697.89,2,5123806,25276,5098530,3972,36.38,84.29,46697.89,0,17.55,18.64,2.28
555,0,5102990,4460,40.85,46738.73,2,5126036,23046,5102990,4460,40.85,84.21,46738.73,1,17.59,18.64,2.46
556,0,5107936,4946,45.30,46784.04,2,5128509,20573,5107936,4946,45.30,84.14,46784.04,1,16.42,18.64,2.29
557,0,5113720,5784,52.98,46837.01,2,5131401,17681,5113720,5784,52.98,84.09,46837.01,0,15.52,18.64,2.20
558,0,5120304,6584,60.30,46897.32,2,5134693,14389,5120304,6584,60.30,84.05,46897.32,0,15.57,18.64,2.37
559,0,5130710,10406,95.31,46992.62,2,5139896,9186,5130710,10406,95.31,84.07,46992.62,0,15.63,18.64,2.55
560,0,5154266,23556,215.75,47208.38,2,5154266,0,5154266,23556,215.75,84.30,47208.38,1,17.53,18.64,2.72
561,0,5154266,0,0.00,47208.38,2,5165007,10741,5154266,0,0.00,84.15,47208.38,1,19.04,18.04,2.55
562,0,5154266,0,0.00,47208.38,2,5170928,16662,5154266,0,0.00,84.00,47208.38,0,19.94,18.94,2.35
563,0,5154266,0,0.00,47208.38,2,5175667,21401,5154266,0,0.00,83.85,47208.38,1,20.35,19.35,2.53
564,0,5162954,8688,79.57,47287.95,2,5180011,17057,5162954,8688,79.57,83.84,47287.95,1,19.34,19.35,2.30
565,0,5162954,0,0.00,47287.95,2,5183910,20956,5162954,0,0.00,83.70,47287.95,0,20.70,19.70,2.29
566,0,5162954,0,0.00,47287.95,2,5187031,24077,5162954,0,0.00,83.55,47287.95,1,20.70,19.70,2.46
567,0,5169066,6112,55.98,47343.93,2,5190087,21021,5169066,6112,55.98,83.50,47343.93,0,19.67,19.70,2.24
568,0,5169066,0,0.00,47343.93,2,5193002,23936,5169066,0,0.00,83.35,47343.93,1,19.91,18.91,2.41
569,0,5169066,0,0.00,47343.93,2,5195644,26578,5169066,0,0.00,83.21,47343.93,0,19.06,18.06,2.20
570,0,5169066,0,0.00,47343.93,2,5198226,29160,5169066,0,0.00,83.06,47343.93,1,19.70,18.70,2.37
571,0,5174062,4996,45.76,47389.69,2,5200724,26662,5174062,4996,45.76,82.99,47389.69,0,18.28,18.70,2.09
572,0,5178972,4910,44.97,47434.66,2,5203179,24207,5178972,4910,44.97,82.93,47434.66,1,18.32,18.70,2.26
573,0,5184130,5158,47.24,47481.90,2,5205758,21628,5184130,5158,47.24,82.87,47481.90,0,17.36,18.70,2.08
574,0,5189422,5292,48.47,47530.38,2,5208404,18982,5189422,5292,48.47,82.81,47530.38,0,17.69,18.70,2.25
575,0,5195182,5760,52.76,47583.13,2,5211284,16102,5195182,5760,52.76,82.75,47583.13,1,17.73,18.70,2.42
576,0,5201920,6738,61.71,47644.84,2,5214653,12733,5201920,6738,61.71,82.72,47644.84,1,17.25,18.70,2.20
577,0,5215400,13480,123.46,47768.31,2,5221393,5993,5215400,13480,123.46,82.79,47768.31,0,16.81,18.70,2.06
578,0,5244863,29463,269.85,48038.16,2,5244863,0,5244863,29463,269.85,83.11,48038.16,0,17.50,18.70,2.23
579,0,5244863,0,0.00,48038.16,2,5255371,10508,5244863,0,0.00,82.97,48038.16,1,19.44,18.44,2.40
580,0,5244863,0,0.00,48038.16,2,5261279,16416,5244863,0,0.00,82.82,48038.16,0,19.91,18.91,2.28
581,0,5244863,0,0.00,48038.16,2,5265939,21076,5244863,0,0.00,82.68,48038.16,1,20.27,19.27,2.45
582,0,5253171,8308,76.09,48114.26,2,5270093,16922,5253171,8308,76.09,82.67,48114.26,1,19.17,19.27,2.26
583,0,5261657,8486,77.72,48191.98,2,5274336,12679,5261657,8486,77.72,82.66,48191.98,0,17.96,19.27,2.08
584,0,5273817,12160,111.37,48303.36,2,5280416,6599,5273817,12160,111.37,82.71,48303.36,1,18.04,19.27,2.25
585,0,5301797,27980,256.27,48559.62,2,5301797,0,5301797,27980,256.27,83.01,48559.62,0,17.44,19.27,2.10
586,0,5335099,33302,305.02,48864.64,2,5335099,0,5335099,33302,305.02,83.39,48864.64,1,18.66,19.27,2.27
587,0,5368655,33556,307.34,49171.98,2,5368655,0,5368655,33556,307.34,83.77,49171.98,0,18.68,19.27,2.11
588,0,5368655,0,0.00,49171.98,2,5379651,10996,5368655,0,0.00,83.63,49171.98,1,20.01,19.01,2.28
589,0,5389043,20388,186.74,49358.72,2,5389845,802,5389043,20388,186.74,83.80,49358.72,0,18.71,19.01,2.09
590,0,5389043,0,0.00,49358.72,2,5400278,11235,5389043,0,0.00,83.66,49358.72,1,19.40,18.40,2.26
591,0,5389043,0,0.00,49358.72,2,5405597,16554,5389043,0,0.00,83.52,49358.72,0,18.67,17.67,2.01
592,0,5389043,0,0.00,49358.72,2,5409070,20027,5389043,0,0.00,83.38,49358.72,0,19.33,18.33,2.17
593,0,5389043,0,0.00,49358.72,2,5412043,23000,5389043,0,0.00,83.24,49358.72,1,19.61,18.61,2.34
594,0,5395535,6492,59.46,49418.18,2,5415289,19754,5395535,6492,59.46,83.20,49418.18,1,18.38,18.61,2.10
595,0,5403039,7504,68.73,49486.91,2,5419041,16002,5403039,7504,68.73,83.17,49486.91,0,17.45,18.61,1.93
596,0,5411599,8560,78.40,49565.31,2,5423321,11722,5411599,8560,78.40,83.16,49565.31,0,18.04,18.61,2.10
597,0,5411599,0,0.00,49565.31,2,5427440,15841,5411599,0,0.00,83.02,49565.31,1,18.69,17.69,2.26
598,0,5419727,8128,74.45,49639.76,2,5431504,11777,5419727,8128,74.45,83.01,49639.76,0,17.33,17.69,2.06
599,0,5436883,17156,157.13,49796.89,2,5440082,3199,5436883,17156,157.13,83.13,49796.89,0,17.40,17.69,2.23
600,0,5469192,32309,295.92,50092.81,2,5469192,0,5469192,32309,295.92,83.49,50092.81,0,17.62,17.69,2.39
601,0,5469192,0,0.00,50092.81,2,5479845,10653,5469192,0,0.00,83.35,50092.81,1,19.57,18.57,2.55
602,0,5469192,0,0.00,50092.81,2,5485980,16788,5469192,0,0.00,83.21,50092.81,1,18.82,17.82,2.41
603,0,5469192,0,0.00,50092.81,2,5490718,21526,5469192,0,0.00,83.07,50092.81,0,18.16,17.16,2.30
604,0,5469192,0,0.00,50092.81,2,5494731,25539,5469192,0,0.00,82.94,50092.81,0,18.65,17.65,2.46
605,0,5469192,0,0.00,50092.81,2,5498442,29250,5469192,0,0.00,82.80,50092.81,1,18.87,17.87,2.62
606,0,5469192,0,0.00,50092.81,2,5501819,32627,5469192,0,0.00,82.66,50092.81,1,18.54,17.54,2.59
607,0,5469192,0,0.00,50092.81,2,5504759,35567,5469192,0,0.00,82.53,50092.81,0,17.98,16.98,2.45
608,0,5469192,0,0.00,50092.81,2,5507514,38322,5469192,0,0.00,82.39,50092.81,1,18.45,17.45,2.61
609,0,5469192,0,0.00,50092.81,2,5510205,41013,5469192,0,0.00,82.25,50092.81,0,17.80,16.80,2.57
610,0,5469192,0,0.00,50092.81,2,5512670,43478,5469192,0,0.00,82.12,50092.81,1,18.08,17.08,2.73
611,0,5469192,0,0.00,50092.81,2,5515099,45907,5469192,0,0.00,81.98,50092.81,1,17.16,16.16,2.61
612,0,5469192,0,0.00,50092.81,2,5517404,48212,5469192,0,0.00,81.85,50092.81,0,16.49,15.49,2.51
613,0,5469192,0,0.00,50092.81,2,5519596,50404,5469192,0,0.00,81.72,50092.81,1,16.77,15.77,2.66
614,0,5469192,0,0.00,50092.81,2,5521707,52515,5469192,0,0.00,81.58,50092.81,1,15.96,14.96,2.61
615,0,5469192,0,0.00,50092.81,2,5523750,54558,5469192,0,0.00,81.45,50092.81,0,15.32,14.32,2.61
616,0,5469192,0,0.00,50092.81,2,5525743,56551,5469192,0,0.00,81.32,50092.81,1,15.32,14.32,2.77
617,0,5469192,0,0.00,50092.81,2,5527679,58487,5469192,0,0.00,81.19,50092.81,0,14.53,13.53,2.67
618,0,5469192,0,0.00,50092.81,2,5529565,60373,5469192,0,0.00,81.06,50092.81,0,14.70,13.70,2.83
619,0,5469192,0,0.00,50092.81,2,5531406,62214,5469192,0,0.00,80.93,50092.81,1,14.70,13.70,2.99
620,0,5469192,0,0.00,50092.81,2,5533199,64007,5469192,0,0.00,80.79,50092.81,0,13.87,12.87,2.93
621,0,5469192,0,0.00,50092.81,2,5534953,65761,5469192,0,0.00,80.66,50092.81,1,14.27,13.27,3.09
622,0,5469192,0,0.00,50092.81,2,5536549,67357,5469192,0,0.00,80.54,50092.81,1,13.37,12.37,2.97
623,0,5469192,0,0.00,50092.81,2,5538149,68957,5469192,0,0.00,80.41,50092.81,0,12.78,11.78,2.84
624,0,5469192,0,0.00,50092.81,2,5539794,70602,5469192,0,0.00,80.28,50092.81,1,12.78,11.78,3.00
625,0,5469192,0,0.00,50092.81,2,5541408,72216,5469192,0,0.00,80.15,50092.81,0,12.15,11.15,3.00
626,0,5469192,0,0.00,50092.81,2,5542989,73797,5469192,0,0.00,80.02,50092.81,1,12.15,11.15,3.15
627,0,5472326,3134,28.70,50121.52,2,5544556,72230,5472326,3134,28.70,79.94,50121.52,0,10.76,11.15,2.96
628,0,5475440,3114,28.52,50150.04,2,5546113,70673,5475440,3114,28.52,79.86,50150.04,1,10.79,11.15,3.11
629,0,5478394,2954,27.06,50177.09,2,5547590,69196,5478394,2954,27.06,79.77,50177.09,0,9.72,11.15,2.99
630,0,5481322,2928,26.82,50203.91,2,5549054,67732,5481322,2928,26.82,79.69,50203.91,1,9.75,11.15,3.15
631,0,5484242,2920,26.74,50230.66,2,5550514,66272,5484242,2920,26.74,79.60,50230.66,0,8.56,11.15,2.99
632,0,5487148,2906,26.62,50257.27,2,5551967,64819,5487148,2906,26.62,79.52,50257.27,1,8.87,11.15,3.15
633,0,5490052,2904,26.60,50283.87,2,5553419,63367,5490052,2904,26.60,79.44,50283.87,0,7.67,11.15,2.99
634,0,5492942,2890,26.47,50310.34,2,5554864,61922,5492942,2890,26.47,79.35,50310.34,1,7.69,11.15,3.15
635,0,5495948,3006,27.53,50337.87,2,5556367,60419,5495948,3006,27.53,79.27,50337.87,0,6.66,11.15,3.03
636,0,5498812,2864,26.23,50364.11,2,5557799,58987,5498812,2864,26.23,79.19,50364.11,1,6.68,11.15,3.19
637,0,5501664,2852,26.12,50390.23,2,5559225,57561,5501664,2852,26.12,79.11,50390.23,0,6.28,11.15,3.13
638,0,5504502,2838,25.99,50416.22,2,5560644,56142,5504502,2838,25.99,79.02,50416.22,0,6.30,11.15,3.29
639,0,5507400,2898,26.54,50442.76,2,5562093,54693,5507400,2898,26.54,78.94,50442.76,1,6.33,11.15,3.44
640,0,5510230,2830,25.92,50468.68,2,5563508,53278,5510230,2830,25.92,78.86,50468.68,0,5.68,11.15,3.32
641,0,5513056,2826,25.88,50494.57,2,5564921,51865,5513056,2826,25.88,78.77,50494.57,1,5.71,11.15,3.47
642,0,5515872,2816,25.79,50520.36,2,5566329,50457,5515872,2816,25.79,78.69,50520.36,0,4.78,11.15,3.39
643,0,5518680,2808,25.72,50546.08,2,5567733,49053,5518680,2808,25.72,78.61,50546.08,1,5.49,11.15,3.54
644,0,5521354,2674,24.49,50570.57,2,5569070,47716,5521354,2674,24.49,78.53,50570.57,1,5.42,11.15,3.47
645,0,5524168,2814,25.77,50596.34,2,5570477,46309,5524168,2814,25.77,78.44,50596.34,0,5.02,11.15,3.52
646,0,5526954,2786,25.52,50621.86,2,5571870,44916,5526954,2786,25.52,78.36,50621.86,1,5.44,11.15,3.67
647,0,5529768,2814,25.77,50647.63,2,5573277,43509,5529768,2814,25.77,78.28,50647.63,0,4.79,11.15,3.65
648,0,5532532,2764,25.32,50672.95,2,5574659,42127,5532532,2764,25.32,78.20,50672.95,1,4.82,11.15,3.80
649,0,5535284,2752,25.21,50698.15,2,5576035,40751,5535284,2752,25.21,78.12,50698.15,0,3.90,11.15,3.65
650,0,5538026,2742,25.11,50723.27,2,5577406,39380,5538026,2742,25.11,78.04,50723.27,1,3.93,11.15,3.80
651,0,5540766,2740,25.10,50748.36,2,5578776,38010,5540766,2740,25.10,77.95,50748.36,0,3.11,11.15,3.67
652,0,5543506,2740,25.10,50773.46,2,5580146,36640,5543506,2740,25.10,77.87,50773.46,1,3.14,11.15,3.82
653,0,5546294,2788,25.54,50799.00,2,5581540,35246,5546294,2788,25.54,77.79,50799.00,0,2.22,11.15,3.74
654,0,5549158,2864,26.23,50825.23,2,5582972,33814,5549158,2864,26.23,77.71,50825.23,1,2.53,11.15,3.89
655,0,5552100,2942,26.95,50852.17,2,5584443,32343,5552100,2942,26.95,77.64,50852.17,0,1.50,11.15,3.71
656,0,5555122,3022,27.68,50879.85,2,5585954,30832,5555122,3022,27.68,77.56,50879.85,1,1.81,11.15,3.86
657,0,5558234,3112,28.50,50908.36,2,5587510,29276,5558234,3112,28.50,77.49,50908.36,0,1.23,11.15,3.79
658,0,5561438,3204,29.35,50937.70,2,5589112,27674,5561438,3204,29.35,77.41,50937.70,0,1.26,11.15,3.93
659,0,5564758,3320,30.41,50968.11,2,5590772,26014,5564758,3320,30.41,77.34,50968.11,1,1.28,11.15,4.08
660,0,5568202,3444,31.54,50999.65,2,5592494,24292,5568202,3444,31.54,77.27,50999.65,0,1.28,11.15,3.84
661,0,5571788,3586,32.84,51032.50,2,5594287,22499,5571788,3586,32.84,77.20,51032.50,1,0.30,11.15,3.98
662,0,5575560,3772,34.55,51067.05,2,5596173,20613,5575560,3772,34.55,77.14,51067.05,1,0.30,11.15,3.93
663,0,5579730,4170,38.19,51105.24,2,5598258,18528,5579730,4170,38.19,77.08,51105.24,0,0.30,11.15,3.84
664,0,5584776,5046,46.22,51151.46,2,5600781,16005,5584776,5046,46.22,77.04,51151.46,1,0.30,11.15,3.98
665,0,5592452,7676,70.31,51221.76,2,5604619,12167,5592452,7676,70.31,77.03,51221.76,0,0.30,11.15,3.88
666,0,5606210,13758,126.01,51347.77,2,5611498,5288,5606210,13758,126.01,77.10,51347.77,0,0.30,11.15,4.03
667,0,5636150,29940,274.22,51622.00,2,5636150,0,5636150,29940,274.22,77.39,51622.00,1,0.30,11.15,4.17
668,0,5671682,35532,325.44,51947.43,2,5671682,0,5671682,35532,325.44,77.77,51947.43,0,0.30,11.15,3.98
669,0,5707065,35383,324.08,52271.51,2,5707065,0,5707065,35383,324.08,78.13,52271.51,0,0.54,11.15,4.13
670,0,5742648,35583,325.91,52597.42,2,5742648,0,5742648,35583,325.91,78.50,52597.42,1,1.70,11.15,4.27
671,0,5777808,35160,322.03,52919.45,2,5777808,0,5777808,35160,322.03,78.87,52919.45,0,2.41,11.15,4.09
672,0,5813134,35326,323.55,53243.01,2,5813134,0,5813134,35326,323.55,79.23,53243.01,0,4.22,11.15,4.23
673,0,5848655,35521,325.34,53568.35,2,5848655,0,5848655,35521,325.34,79.60,53568.35,1,5.26,11.15,4.37
674,0,5883798,35143,321.88,53890.22,2,5883798,0,5883798,35143,321.88,79.96,53890.22,0,4.29,11.15,4.21
675,0,5919762,35964,329.40,54219.62,2,5919762,0,5919762,35964,329.40,80.33,54219.62,0,4.71,11.15,4.36
676,0,5955342,35580,325.88,54545.50,2,5955342,0,5955342,35580,325.88,80.69,54545.50,1,5.65,11.15,4.50
677,0,5990806,35464,324.82,54870.32,2,5990806,0,5990806,35464,324.82,81.05,54870.32,1,5.09,11.15,4.16
678,0,6026287,35481,324.97,55195.29,2,6026287,0,6026287,35481,324.97,81.41,55195.29,0,6.70,11.15,4.10
679,0,6061495,35208,322.47,55517.77,2,6061495,0,6061495,35208,322.47,81.76,55517.77,1,9.17,11.15,4.24
680,0,6093421,31926,292.41,55810.18,2,6093421,0,6093421,31926,292.41,82.07,55810.18,0,10.85,11.15,4.13
681,0,6093421,0,0.00,55810.18,2,6102811,9390,6093421,0,0.00,81.95,55810.18,0,13.60,12.60,4.27
682,0,6093421,0,0.00,55810.18,2,6108043,14622,6093421,0,0.00,81.83,55810.18,1,14.29,13.29,4.41
683,0,6093421,0,0.00,55810.18,2,6112124,18703,6093421,0,0.00,81.71,55810.18,1,13.72,12.72,4.29
684,0,6093421,0,0.00,55810.18,2,6115812,22391,6093421,0,0.00,81.59,55810.18,1,13.72,12.72,4.20
685,0,6093421,0,0.00,55810.18,2,6119207,25786,6093421,0,0.00,81.47,55810.18,0,13.22,12.22,4.16
686,0,6093421,0,0.00,55810.18,2,6122411,28990,6093421,0,0.00,81.36,55810.18,1,13.50,12.50,4.30
687,0,6093421,0,0.00,55810.18,2,6125551,32130,6093421,0,0.00,81.24,55810.18,1,12.83,11.83,4.28
688,0,6093421,0,0.00,55810.18,2,6128479,35058,6093421,0,0.00,81.12,55810.18,1,13.22,12.22,4.25
689,0,6093421,0,0.00,55810.18,2,6131210,37789,6093421,0,0.00,81.00,55810.18,0,12.74,11.74,4.20
690,0,6093421,0,0.00,55810.18,2,6133784,40363,6093421,0,0.00,80.88,55810.18,1,13.03,12.03,4.34
691,0,6093421,0,0.00,55810.18,2,6136230,42809,6093421,0,0.00,80.77,55810.18,1,12.10,11.10,4.27
692,0,6093421,0,0.00,55810.18,2,6138545,45124,6093421,0,0.00,80.65,55810.18,0,11.28,10.28,4.15
693,0,6093421,0,0.00,55810.18,2,6140754,47333,6093421,0,0.00,80.53,55810.18,0,11.28,10.28,4.29
694,0,6093421,0,0.00,55810.18,2,6142859,49438,6093421,0,0.00,80.42,55810.18,1,12.08,11.08,4.43
695,0,6097195,3774,34.57,55844.75,2,6144746,47551,6097195,3774,34.57,80.35,55844.75,0,11.02,11.08,4.26
696,0,6097195,0,0.00,55844.75,2,6146564,49369,6097195,0,0.00,80.24,55844.75,0,11.34,10.34,4.40
697,0,6097195,0,0.00,55844.75,2,6148359,51164,6097195,0,0.00,80.12,55844.75,1,11.34,10.34,4.53
698,0,6100779,3584,32.83,55877.57,2,6150151,49372,6100779,3584,32.83,80.05,55877.57,0,9.67,10.34,4.22
699,0,6104507,3728,34.15,55911.72,2,6152015,47508,6104507,3728,34.15,79.99,55911.72,0,9.70,10.34,4.36
700,0,6108027,3520,32.24,55943.96,2,6153775,45748,6108027,3520,32.24,79.92,55943.96,1,10.11,10.34,4.50
701,0,6111513,3486,31.93,55975.89,2,6155518,44005,6111513,3486,31.93,79.85,55975.89,0,8.80,10.34,4.33
702,0,6115153,3640,33.34,56009.23,2,6157338,42185,6115153,3640,33.34,79.79,56009.23,1,9.41,10.34,4.47
703,0,6118885,3732,34.18,56043.41,2,6159204,40319,6118885,3732,34.18,79.72,56043.41,0,8.36,10.34,4.23
704,0,6122617,3732,34.18,56077.59,2,6161070,38453,6122617,3732,34.18,79.66,56077.59,1,8.68,10.34,4.37
705,0,6126265,3648,33.41,56111.00,2,6162894,36629,6126265,3648,33.41,79.59,56111.00,0,7.06,10.34,4.13
706,0,6129775,3510,32.15,56143.15,2,6164649,34874,6129775,3510,32.15,79.52,56143.15,1,7.09,10.34,4.27
707,0,6133303,3528,32.31,56175.46,2,6166413,33110,6133303,3528,32.31,79.46,56175.46,1,6.46,10.34,4.18
708,0,6136917,3614,33.10,56208.56,2,6168220,31303,6136917,3614,33.10,79.39,56208.56,0,5.69,10.34,4.10
709,0,6140591,3674,33.65,56242.21,2,6170057,29466,6140591,3674,33.65,79.33,56242.21,1,6.19,10.34,4.23
710,0,6144283,3692,33.82,56276.03,2,6171903,27620,6144283,3692,33.82,79.26,56276.03,1,4.67,10.34,4.02
711,0,6148079,3796,34.77,56310.80,2,6173801,25722,6148079,3796,34.77,79.20,56310.80,0,4.18,10.34,4.02
712,0,6151937,3858,35.34,56346.13,2,6175730,23793,6151937,3858,35.34,79.14,56346.13,1,4.80,10.34,4.15
713,0,6155299,3362,30.79,56376.93,2,6177411,22112,6155299,3362,30.79,79.07,56376.93,1,4.27,10.34,4.10
714,0,6159305,4006,36.69,56413.62,2,6179414,20109,6159305,4006,36.69,79.01,56413.62,0,3.97,10.34,4.16
715,0,6163913,4608,42.21,56455.82,2,6181718,17805,6163913,4608,42.21,78.96,56455.82,1,4.29,10.34,4.29
716,0,6169059,5146,47.13,56502.96,2,6184291,15232,6169059,5146,47.13,78.91,56502.96,0,3.69,10.34,4.29
717,0,6178593,9534,87.32,56590.28,2,6189058,10465,6178593,9534,87.32,78.93,56590.28,0,4.02,10.34,4.42
718,0,6198027,19434,178.00,56768.28,2,6198775,748,6198027,19434,178.00,79.06,56768.28,0,4.93,10.34,4.55
719,0,6231365,33338,305.35,57073.62,2,6231365,0,6231365,33338,305.35,79.38,57073.62,0,6.31,10.34,4.69
720,0,6265710,34345,314.57,57388.19,2,6265710,0,6265710,34345,314.57,79.71,57388.19,1,8.98,10.34,4.82
721,0,6302781,37071,339.54,57727.73,2,6302781,0,6302781,37071,339.54,80.07,57727.73,1,9.70,10.34,4.69
722,0,6302781,0,0.00,57727.73,2,6314070,11289,6302781,0,0.00,79.96,57727.73,1,11.95,10.95,4.68
723,0,6302781,0,0.00,57727.73,2,6319805,17024,6302781,0,0.00,79.84,57727.73,0,12.30,11.30,4.58
724,0,6302781,0,0.00,57727.73,2,6324134,21353,6302781,0,0.00,79.73,57727.73,1,12.87,11.87,4.72
725,0,6302781,0,0.00,57727.73,2,6327888,25107,6302781,0,0.00,79.62,57727.73,0,13.12,12.12,4.71
726,0,6302781,0,0.00,57727.73,2,6331245,28464,6302781,0,0.00,79.51,57727.73,1,13.41,12.41,4.85
727,0,6309189,6408,58.69,57786.42,2,6334449,25260,6309189,6408,58.69,79.49,57786.42,0,12.21,12.41,4.65
728,0,6309189,0,0.00,57786.42,2,6337492,28303,6309189,0,0.00,79.38,57786.42,1,12.84,11.84,4.79
729,0,6309189,0,0.00,57786.42,2,6340260,31071,6309189,0,0.00,79.27,57786.42,0,12.73,11.73,4.77
730,0,6309189,0,0.00,57786.42,2,6342825,33636,6309189,0,0.00,79.16,57786.42,1,13.02,12.02,4.90
731,0,6314115,4926,45.12,57831.54,2,6345288,31173,6314115,4926,45.12,79.11,57831.54,0,11.71,12.02,4.68
732,0,6319041,4926,45.12,57876.65,2,6347751,28710,6319041,4926,45.12,79.07,57876.65,1,11.76,12.02,4.81
733,0,6323953,4912,44.99,57921.64,2,6350207,26254,6323953,4912,44.99,79.02,57921.64,0,11.39,12.02,4.79
734,0,6328839,4886,44.75,57966.39,2,6352650,23811,6328839,4886,44.75,78.97,57966.39,1,11.43,12.02,4.92
735,0,6333733,4894,44.82,58011.22,2,6355097,21364,6333733,4894,44.82,78.93,58011.22,0,11.02,12.02,4.77
736,0,6338795,5062,46.36,58057.58,2,6357628,18833,6338795,5062,46.36,78.88,58057.58,1,11.35,12.02,4.90
737,0,6344125,5330,48.82,58106.40,2,6360293,16168,6344125,5330,48.82,78.84,58106.40,0,10.23,12.02,4.75
738,0,6350819,6694,61.31,58167.71,2,6363640,12821,6350819,6694,61.31,78.82,58167.71,0,10.56,12.02,4.88
739,0,6367025,16206,148.43,58316.14,2,6371743,4718,6367025,16206,148.43,78.91,58316.14,0,10.91,12.02,5.01
740,0,6367025,0,0.00,58316.14,2,6379605,12580,6367025,0,0.00,78.81,58316.14,1,12.20,11.20,5.13
741,0,6383413,16388,150.10,58466.24,2,6387799,4386,6383413,16388,150.10,78.90,58466.24,0,11.03,11.20,5.01
742,0,6383413,0,0.00,58466.24,2,6395940,12527,6383413,0,0.00,78.80,58466.24,1,11.47,10.47,5.14
743,0,6383413,0,0.00,58466.24,2,6400574,17161,6383413,0,0.00,78.69,58466.24,0,10.54,9.54,4.95
744,0,6383413,0,0.00,58466.24,2,6403289,19876,6383413,0,0.00,78.58,58466.24,1,10.54,9.54,5.08
745,0,6389245,5832,53.42,58519.66,2,6406205,16960,6389245,5832,53.42,78.55,58519.66,1,8.97,9.54,4.84
746,0,6397289,8044,73.68,58593.33,2,6410227,12938,6397289,8044,73.68,78.54,58593.33,0,8.32,9.54,4.82
747,0,6411615,14326,131.21,58724.55,2,6417390,5775,6411615,14326,131.21,78.61,58724.55,1,8.40,9.54,4.95
748,0,6441955,30340,277.89,59002.43,2,6441955,0,6441955,30340,277.89,78.88,59002.43,0,7.48,9.54,4.85
749,0,6476774,34819,318.91,59321.34,2,6476774,0,6476774,34819,318.91,79.20,59321.34,1,8.32,9.54,4.98
750,0,6511848,35074,321.25,59642.59,2,6511848,0,6511848,35074,321.25,79.52,59642.59,0,9.31,9.54,4.95
751,0,6511848,0,0.00,59642.59,2,6522682,10834,6511848,0,0.00,79.42,59642.59,0,12.20,11.20,5.08
752,0,6511848,0,0.00,59642.59,2,6528645,16797,6511848,0,0.00,79.31,59642.59,1,13.34,12.34,5.20
753,0,6511848,0,0.00,59642.59,2,6533137,21289,6511848,0,0.00,79.21,59642.59,1,13.30,12.30,5.14
754,0,6511848,0,0.00,59642.59,2,6537121,25273,6511848,0,0.00,79.10,59642.59,0,13.32,12.32,5.09
755,0,6511848,0,0.00,59642.59,2,6540780,28932,6511848,0,0.00,79.00,59642.59,1,13.61,12.61,5.21
756,0,6511848,0,0.00,59642.59,2,6544104,32256,6511848,0,0.00,78.89,59642.59,0,12.83,11.83,5.12
757,0,6511848,0,0.00,59642.59,2,6547171,35323,6511848,0,0.00,78.79,59642.59,1,13.40,12.40,5.24
758,0,6511848,0,0.00,59642.59,2,6549930,38082,6511848,0,0.00,78.68,59642.59,0,13.43,12.43,5.26
759,0,6511848,0,0.00,59642.59,2,6552600,40752,6511848,0,0.00,78.58,59642.59,1,13.73,12.73,5.38
760,0,6511848,0,0.00,59642.59,2,6555135,43287,6511848,0,0.00,78.48,59642.59,0,13.05,12.05,5.30
761,0,6511848,0,0.00,59642.59,2,6557553,45705,6511848,0,0.00,78.37,59642.59,1,13.05,12.05,5.43
762,0,6511848,0,0.00,59642.59,2,6559843,47995,6511848,0,0.00,78.27,59642.59,1,12.50,11.50,5.38
763,0,6511848,0,0.00,59642.59,2,6561857,50009,6511848,0,0.00,78.17,59642.59,0,12.02,11.02,5.35
764,0,6511848,0,0.00,59642.59,2,6563914,52066,6511848,0,0.00,78.07,59642.59,1,12.31,11.31,5.47
765,0,6511848,0,0.00,59642.59,2,6565895,54047,6511848,0,0.00,77.96,59642.59,0,11.81,10.81,5.43
766,0,6511848,0,0.00,59642.59,2,6567783,55935,6511848,0,0.00,77.86,59642.59,1,12.10,11.10,5.55
767,0,6511848,0,0.00,59642.59,2,6569659,57811,6511848,0,0.00,77.76,59642.59,0,11.15,10.15,5.48
768,0,6511848,0,0.00,59642.59,2,6571454,59606,6511848,0,0.00,77.66,59642.59,1,11.44,10.44,5.61
769,0,6511848,0,0.00,59642.59,2,6573190,61342,6511848,0,0.00,77.56,59642.59,1,10.77,9.77,5.53
770,0,6511848,0,0.00,59642.59,2,6574882,63034,6511848,0,0.00,77.46,59642.59,0,9.87,8.87,5.47
771,0,6511848,0,0.00,59642.59,2,6576634,64786,6511848,0,0.00,77.36,59642.59,0,9.90,8.90,5.59
772,0,6511848,0,0.00,59642.59,2,6578364,66516,6511848,0,0.00,77.26,59642.59,1,10.18,9.18,5.72
773,0,6511848,0,0.00,59642.59,2,6580052,68204,6511848,0,0.00,77.16,59642.59,0,9.54,8.54,5.59
774,0,6511848,0,0.00,59642.59,2,6581705,69857,6511848,0,0.00,77.06,59642.59,1,9.54,8.54,5.71
775,0,6515100,3252,29.79,59672.38,2,6583331,68231,6515100,3252,29.79,77.00,59672.38,0,8.23,8.54,5.51
776,0,6518152,3052,27.95,59700.33,2,6584857,66705,6518152,3052,27.95,76.93,59700.33,1,8.28,8.54,5.63
777,0,6521396,3244,29.71,59730.04,2,6586479,65083,6521396,3244,29.71,76.87,59730.04,0,6.99,8.54,5.48
778,0,6524638,3242,29.69,59759.73,2,6588100,63462,6524638,3242,29.69,76.81,59759.73,0,7.04,8.54,5.60
779,0,6527760,3122,28.59,59788.33,2,6589661,61901,6527760,3122,28.59,76.75,59788.33,1,7.07,8.54,5.72
780,0,6530974,3214,29.44,59817.77,2,6591268,60294,6530974,3214,29.44,76.69,59817.77,0,5.72,8.54,5.54
781,0,6533792,2818,25.81,59843.58,2,6592677,58885,6533792,2818,25.81,76.62,59843.58,1,5.74,8.54,5.66
782,0,6536726,2934,26.87,59870.45,2,6594144,57418,6536726,2934,26.87,76.56,59870.45,0,4.74,8.54,5.57
783,0,6539878,3152,28.87,59899.32,2,6595720,55842,6539878,3152,28.87,76.50,59899.32,1,4.77,8.54,5.69
784,0,6543018,3140,28.76,59928.08,2,6597290,54272,6543018,3140,28.76,76.44,59928.08,0,3.90,8.54,5.63
785,0,6546144,3126,28.63,59956.71,2,6598853,52709,6546144,3126,28.63,76.38,59956.71,1,4.06,8.54,5.75
786,0,6549258,3114,28.52,59985.23,2,6600410,51152,6549258,3114,28.52,76.32,59985.23,0,2.82,8.54,5.61
787,0,6552364,3106,28.45,60013.68,2,6601963,49599,6552364,3106,28.45,76.26,60013.68,1,2.85,8.54,5.73
788,0,6555434,3070,28.12,60041.80,2,6603498,48064,6555434,3070,28.12,76.20,60041.80,1,1.80,8.54,5.63
789,0,6558514,3080,28.21,60070.01,2,6605038,46524,6558514,3080,28.21,76.13,60070.01,0,0.79,8.54,5.54
790,0,6561588,3074,28.16,60098.16,2,6606575,44987,6561588,3074,28.16,76.07,60098.16,1,0.96,8.54,5.66
791,0,6564760,3172,29.05,60127.21,2,6608161,43401,6564760,3172,29.05,76.01,60127.21,0,0.11,8.54,5.60
792,0,6567768,3008,27.55,60154.77,2,6609665,41897,6567768,3008,27.55,75.95,60154.77,1,0.16,8.54,5.72
793,0,6570804,3036,27.81,60182.57,2,6611183,40379,6570804,3036,27.81,75.89,60182.57,1,0.16,8.54,5.69
794,0,6573830,3026,27.72,60210.29,2,6612696,38866,6573830,3026,27.72,75.83,60210.29,0,0.16,8.54,5.73
795,0,6576794,2964,27.15,60237.44,2,6614178,37384,6576794,2964,27.15,75.77,60237.44,0,0.16,8.54,5.85
796,0,6579842,3048,27.92,60265.35,2,6615702,35860,6579842,3048,27.92,75.71,60265.35,1,0.16,8.54,5.97
797,0,6582940,3098,28.37,60293.73,2,6617251,34311,6582940,3098,28.37,75.65,60293.73,0,0.16,8.54,5.99
798,0,6586036,3096,28.36,60322.09,2,6618799,32763,6586036,3096,28.36,75.59,60322.09,1,0.16,8.54,6.10
799,0,6589196,3160,28.94,60351.03,2,6620379,31183,6589196,3160,28.94,75.53,60351.03,0,0.16,8.54,6.12
800,0,6592452,3256,29.82,60380.85,2,6622007,29555,6592452,3256,29.82,75.48,60380.85,1,0.16,8.54,6.23
801,0,6595756,3304,30.26,60411.11,2,6623659,27903,6595756,3304,30.26,75.42,60411.11,0,0.16,8.54,6.21
802,0,6598846,3090,28.30,60439.41,2,6625204,26358,6598846,3090,28.30,75.36,60439.41,1,0.16,8.54,6.33
803,0,6602360,3514,32.19,60471.60,2,6626961,24601,6602360,3514,32.19,75.31,60471.60,0,0.16,8.54,6.33
804,0,6605984,3624,33.19,60504.79,2,6628773,22789,6605984,3624,33.19,75.25,60504.79,1,0.16,8.54,6.45
805,0,6609814,3830,35.08,60539.87,2,6630688,20874,6609814,3830,35.08,75.20,60539.87,0,0.16,8.54,6.37
806,0,6613890,4076,37.33,60577.20,2,6632726,18836,6613890,4076,37.33,75.16,60577.20,1,0.16,8.54,6.49
807,0,6618606,4716,43.19,60620.39,2,6635084,16478,6618606,4716,43.19,75.12,60620.39,0,0.16,8.54,6.36
808,0,6624936,6330,57.98,60678.37,2,6638249,13313,6624936,6330,57.98,75.10,60678.37,1,0.16,8.54,6.47
809,0,6635810,10874,99.60,60777.97,2,6643686,7876,6635810,10874,99.60,75.13,60777.97,0,0.16,8.54,6.37
810,0,6659919,24109,220.82,60998.79,2,6659919,0,6659919,24109,220.82,75.31,60998.79,1,0.16,8.54,6.49
811,0,6694215,34296,314.12,61312.91,2,6694215,0,6694215,34296,314.12,75.60,61312.91,1,0.16,8.54,6.49
812,0,6728644,34429,315.34,61628.24,2,6728644,0,6728644,34429,315.34,75.90,61628.24,0,0.16,8.54,6.56
813,0,6763373,34729,318.09,61946.33,2,6763373,0,6763373,34729,318.09,76.19,61946.33,0,0.16,8.54,6.68
814,0,6798224,34851,319.20,62265.53,2,6798224,0,6798224,34851,319.20,76.49,62265.53,1,2.54,8.54,6.79
815,0,6833762,35538,325.50,62591.03,2,6833762,0,6833762,35538,325.50,76.80,62591.03,0,3.93,8.54,6.72
816,0,6866813,33051,302.72,62893.75,2,6866813,0,6866813,33051,302.72,77.08,62893.75,0,5.59,8.54,6.84
817,0,6900417,33604,307.78,63201.53,2,6900417,0,6900417,33604,307.78,77.36,63201.53,1,6.89,8.54,6.95
818,0,6932310,31893,292.11,63493.64,2,6932310,0,6932310,31893,292.11,77.62,63493.64,0,5.69,8.54,6.77
819,0,6966142,33832,309.87,63803.51,2,6966142,0,6966142,33832,309.87,77.90,63803.51,1,6.10,8.54,6.89
820,0,6999789,33647,308.18,64111.68,2,6999789,0,6999789,33647,308.18,78.18,64111.68,0,5.63,8.54,6.80
821,0,7033549,33760,309.21,64420.89,2,7033549,0,7033549,33760,309.21,78.47,64420.89,1,7.04,8.54,6.91
822,0,7064138,30589,280.17,64701.06,2,7064138,0,7064138,30589,280.17,78.71,64701.06,1,8.01,8.54,6.81
823,0,7096455,32317,295.99,64997.06,2,7096455,0,7096455,32317,295.99,78.98,64997.06,0,8.53,8.54,6.70
824,0,7096455,0,0.00,64997.06,2,7106810,10355,7096455,0,0.00,78.88,64997.06,1,11.35,10.35,6.81
825,0,7096455,0,0.00,64997.06,2,7112683,16228,7096455,0,0.00,78.78,64997.06,0,12.11,11.11,6.74
826,0,7096455,0,0.00,64997.06,2,7117306,20851,7096455,0,0.00,78.69,64997.06,1,12.81,11.81,6.85
827,0,7105039,8584,78.62,65075.68,2,7121598,16559,7105039,8584,78.62,78.69,65075.68,0,11.18,11.81,6.65
828,0,7105039,0,0.00,65075.68,2,7125613,20574,7105039,0,0.00,78.59,65075.68,1,12.18,11.18,6.76
829,0,7105039,0,0.00,65075.68,2,7129057,24018,7105039,0,0.00,78.50,65075.68,0,11.37,10.37,6.61
830,0,7105039,0,0.00,65075.68,2,7132170,27131,7105039,0,0.00,78.40,65075.68,1,11.67,10.67,6.72
831,0,7110797,5758,52.74,65128.42,2,7135049,24252,7110797,5758,52.74,78.37,65128.42,0,10.11,10.67,6.46
832,0,7116009,5212,47.74,65176.15,2,7137655,21646,7116009,5212,47.74,78.34,65176.15,1,10.16,10.67,6.58
833,0,7121453,5444,49.86,65226.02,2,7140377,18924,7121453,5444,49.86,78.30,65226.02,0,9.76,10.67,6.49
834,0,7121453,0,0.00,65226.02,2,7143048,21595,7121453,0,0.00,78.21,65226.02,1,10.78,9.78,6.61
835,0,7126713,5260,48.18,65274.19,2,7145678,18965,7126713,5260,48.18,78.17,65274.19,0,9.60,9.78,6.50
836,0,7126713,0,0.00,65274.19,2,7148282,21569,7126713,0,0.00,78.08,65274.19,1,9.94,8.94,6.61
837,0,7131713,5000,45.80,65319.99,2,7150782,19069,7131713,5000,45.80,78.04,65319.99,0,8.90,8.94,6.47
838,0,7131713,0,0.00,65319.99,2,7153238,21525,7131713,0,0.00,77.95,65319.99,0,8.95,8.00,6.58
839,0,7136571,4858,44.49,65364.48,2,7155667,19096,7136571,4858,44.49,77.91,65364.48,0,9.52,10.52,6.69
840,0,7142539,5968,54.66,65419.14,2,7158651,16112,7142539,5968,54.66,77.88,65419.14,1,10.14,10.52,6.81
841,0,7150847,8308,76.09,65495.24,2,7162805,11958,7150847,8308,76.09,77.88,65495.24,1,8.81,10.52,6.60
842,0,7165347,14500,132.81,65628.05,2,7170055,4708,7165347,14500,132.81,77.94,65628.05,0,7.98,10.52,6.49
843,0,7192303,26956,246.89,65874.94,2,7192303,0,7192303,26956,246.89,78.14,65874.94,1,9.26,10.52,6.60
844,0,7221197,28894,264.64,66139.58,2,7221197,0,7221197,28894,264.64,78.36,66139.58,1,9.66,10.52,6.53
845,0,7221197,0,0.00,66139.58,2,7231873,10676,7221197,0,0.00,78.27,66139.58,0,11.12,10.12,6.49
846,0,7221197,0,0.00,66139.58,2,7237380,16183,7221197,0,0.00,78.18,66139.58,1,12.83,11.83,6.60
847,0,7231855,10658,97.62,66237.20,2,7242709,10854,7231855,10658,97.62,78.20,66237.20,0,11.73,11.83,6.45
848,0,7231855,0,0.00,66237.20,2,7247833,15978,7231855,0,0.00,78.11,66237.20,1,12.97,11.97,6.56
849,0,7231855,0,0.00,66237.20,2,7251587,19732,7231855,0,0.00,78.02,66237.20,0,12.49,11.49,6.48
850,0,7231855,0,0.00,66237.20,2,7254704,22849,7231855,0,0.00,77.93,66237.20,1,12.78,11.78,6.59
851,0,7237671,5816,53.27,66290.47,2,7257612,19941,7237671,5816,53.27,77.90,66290.47,0,11.24,11.78,6.41
852,0,7237671,0,0.00,66290.47,2,7260488,22817,7237671,0,0.00,77.81,66290.47,1,12.16,11.16,6.52
853,0,7237671,0,0.00,66290.47,2,7263072,25401,7237671,0,0.00,77.71,66290.47,0,11.63,10.63,6.43
854,0,7237671,0,0.00,66290.47,2,7265362,27691,7237671,0,0.00,77.62,66290.47,1,11.63,10.63,6.53
855,0,7242459,4788,43.85,66334.32,2,7267756,25297,7242459,4788,43.85,77.58,66334.32,0,10.56,10.63,6.39
856,0,7242459,0,0.00,66334.32,2,7270125,27666,7242459,0,0.00,77.49,66334.32,1,10.89,9.89,6.50
857,0,7247049,4590,42.04,66376.36,2,7272420,25371,7247049,4590,42.04,77.45,66376.36,0,9.48,9.89,6.35
858,0,7247049,0,0.00,66376.36,2,7274764,27715,7247049,0,0.00,77.36,66376.36,0,10.10,9.10,6.46
859,0,7247049,0,0.00,66376.36,2,7276920,29871,7247049,0,0.00,77.27,66376.36,0,10.67,9.67,6.57
860,0,7247049,0,0.00,66376.36,2,7278975,31926,7247049,0,0.00,77.18,66376.36,1,10.95,9.95,6.68
861,0,7251115,4066,37.24,66413.60,2,7281008,29893,7251115,4066,37.24,77.14,66413.60,1,9.24,9.95,6.47
862,0,7255173,4058,37.17,66450.77,2,7283037,27864,7255173,4058,37.17,77.09,66450.77,0,8.11,9.95,6.32
863,0,7259211,4038,36.98,66487.75,2,7285056,25845,7259211,4038,36.98,77.04,66487.75,1,8.43,9.95,6.42
864,0,7263469,4258,39.00,66526.75,2,7287185,23716,7263469,4258,39.00,77.00,66526.75,0,6.55,9.95,6.18
865,0,7267863,4394,40.25,66567.00,2,7289382,21519,7267863,4394,40.25,76.96,66567.00,1,6.88,9.95,6.29
866,0,7272765,4902,44.90,66611.90,2,7291833,19068,7272765,4902,44.90,76.92,66611.90,1,6.69,9.95,6.25
867,0,7278431,5666,51.90,66663.79,2,7294666,16235,7278431,5666,51.90,76.89,66663.79,0,5.88,9.95,6.10
868,0,7285203,6772,62.03,66725.81,2,7298052,12849,7285203,6772,62.03,76.87,66725.81,0,5.93,9.95,6.21
869,0,7299219,14016,128.37,66854.19,2,7305060,5841,7299219,14016,128.37,76.93,66854.19,1,6.28,9.95,6.32
870,0,7329799,30580,280.08,67134.27,2,7329799,0,7329799,30580,280.08,77.17,67134.27,1,6.38,9.95,6.21
871,0,7362560,32761,300.06,67434.34,2,7362560,0,7362560,32761,300.06,77.42,67434.34,0,7.12,9.95,6.10
872,0,7394224,31664,290.01,67724.35,2,7394224,0,7394224,31664,290.01,77.67,67724.35,1,9.13,9.95,6.21
873,0,7426979,32755,300.01,68024.35,2,7426979,0,7426979,32755,300.01,77.92,68024.35,0,9.62,9.95,6.08
874,0,7426979,0,0.00,68024.35,2,7437538,10559,7426979,0,0.00,77.83,68024.35,1,10.86,9.86,6.19
875,0,7449278,22299,204.24,68228.59,2,7449278,0,7449278,22299,204.24,77.98,68228.59,0,9.60,9.86,5.98
876,0,7449278,0,0.00,68228.59,2,7459888,10610,7449278,0,0.00,77.89,68228.59,1,10.40,9.40,6.09
877,0,7449278,0,0.00,68228.59,2,7465585,16307,7449278,0,0.00,77.80,68228.59,0,9.56,8.56,5.97
878,0,7449278,0,0.00,68228.59,2,7469870,20592,7449278,0,0.00,77.71,68228.59,0,10.07,9.07,6.08
879,0,7449278,0,0.00,68228.59,2,7473820,24542,7449278,0,0.00,77.62,68228.59,0,10.83,9.83,6.18
880,0,7449278,0,0.00,68228.59,2,7477385,28107,7449278,0,0.00,77.53,68228.59,1,11.12,10.12,6.29
881,0,7455844,6566,60.14,68288.73,2,7480668,24824,7455844,6566,60.14,77.51,68288.73,1,9.27,10.12,6.01
882,0,7462232,6388,58.51,68347.24,2,7483862,21630,7462232,6388,58.51,77.49,68347.24,0,8.15,10.12,5.91
883,0,7468824,6592,60.38,68407.62,2,7487158,18334,7468824,6592,60.38,77.47,68407.62,1,9.03,10.12,6.01
884,0,7474986,6162,56.44,68464.05,2,7490239,15253,7474986,6162,56.44,77.45,68464.05,0,7.63,10.12,5.81
885,0,7481852,6866,62.89,68526.95,2,7493672,11820,7481852,6866,62.89,77.43,68526.95,0,8.19,10.12,5.91
886,0,7496414,14562,133.37,68660.32,2,7500953,4539,7496414,14562,133.37,77.49,68660.32,1,8.54,10.12,6.02
887,0,7527112,30698,281.17,68941.48,2,7527112,0,7527112,30698,281.17,77.72,68941.48,1,8.63,10.12,5.95
888,0,7558124,31012,284.04,69225.52,2,7558124,0,7558124,31012,284.04,77.96,69225.52,0,8.40,10.12,5.83
889,0,7590681,32557,298.19,69523.72,2,7590681,0,7590681,32557,298.19,78.20,69523.72,0,9.98,10.12,5.94
890,0,7590681,0,0.00,69523.72,2,7601168,10487,7590681,0,0.00,78.12,69523.72,1,10.64,9.64,6.04
891,0,7590681,0,0.00,69523.72,2,7607184,16503,7590681,0,0.00,78.03,69523.72,1,9.81,8.81,5.88
892,0,7590681,0,0.00,69523.72,2,7611688,21007,7590681,0,0.00,77.94,69523.72,0,9.22,8.22,5.82
893,0,7590681,0,0.00,69523.72,2,7615552,24871,7590681,0,0.00,77.85,69523.72,1,9.40,8.40,5.93
894,0,7597403,6722,61.57,69585.28,2,7618913,21510,7597403,6722,61.57,77.84,69585.28,1,7.96,8.40,5.76
895,0,7604537,7134,65.34,69650.62,2,7622480,17943,7604537,7134,65.34,77.82,69650.62,0,7.29,8.40,5.71
896,0,7611935,7398,67.76,69718.38,2,7626179,14244,7611935,7398,67.76,77.81,69718.38,1,7.82,8.40,5.82
897,0,7620375,8440,77.30,69795.69,2,7630399,10024,7620375,8440,77.30,77.81,69795.69,0,6.83,8.40,5.72
898,0,7641962,21587,197.72,69993.41,2,7641962,0,7641962,21587,197.72,77.94,69993.41,0,7.03,8.40,5.82
899,0,7675398,33436,306.24,70299.65,2,7675398,0,7675398,33436,306.24,78.20,70299.65,1,7.22,8.40,5.93
900,0,7706463,31065,284.53,70584.17,2,7706463,0,7706463,31065,284.53,78.43,70584.17,1,8.40,8.40,5.81
901,0,7737090,30627,280.52,70864.69,2,7737090,0,7737090,30627,280.52,78.65,70864.69,0,8.27,8.40,5.71
902,0,7737090,0,0.00,70864.69,2,7747347,10257,7737090,0,0.00,78.56,70864.69,1,13.35,12.35,5.81
903,0,7737090,0,0.00,70864.69,2,7753113,16023,7737090,0,0.00,78.48,70864.69,0,13.89,12.89,5.72
904,0,7737090,0,0.00,70864.69,2,7757684,20594,7737090,0,0.00,78.39,70864.69,1,14.33,13.33,5.82
905,0,7745272,8182,74.94,70939.62,2,7761775,16503,7745272,8182,74.94,78.39,70939.62,0,12.82,13.33,5.66
906,0,7753956,8684,79.54,71019.16,2,7766117,12161,7753956,8684,79.54,78.39,71019.16,1,12.90,13.33,5.77
907,0,7766382,12426,113.81,71132.98,2,7772330,5948,7766382,12426,113.81,78.43,71132.98,0,11.45,13.33,5.60
908,0,7792457,26075,238.82,71371.80,2,7792457,0,7792457,26075,238.82,78.60,71371.80,1,12.18,13.33,5.71
909,0,7820953,28496,261.00,71632.80,2,7820953,0,7820953,28496,261.00,78.80,71632.80,0,11.76,13.33,5.55
910,0,7851472,30519,279.53,71912.32,2,7851472,0,7851472,30519,279.53,79.02,71912.32,0,12.24,13.33,5.66
911,0,7851472,0,0.00,71912.32,2,7861926,10454,7851472,0,0.00,78.94,71912.32,1,13.92,12.92,5.76
912,0,7851472,0,0.00,71912.32,2,7868186,16714,7851472,0,0.00,78.85,71912.32,0,13.02,12.02,5.56
913,0,7851472,0,0.00,71912.32,2,7872621,21149,7851472,0,0.00,78.76,71912.32,1,13.69,12.69,5.67
914,0,7859388,7916,72.50,71984.83,2,7876579,17191,7859388,7916,72.50,78.76,71984.83,0,12.05,12.69,5.49
915,0,7859388,0,0.00,71984.83,2,7880474,21086,7859388,0,0.00,78.67,71984.83,1,13.26,12.26,5.59
916,0,7866470,7082,64.86,72049.70,2,7884015,17545,7866470,7082,64.86,78.66,72049.70,0,11.88,12.26,5.44
917,0,7873606,7136,65.36,72115.05,2,7887583,13977,7873606,7136,65.36,78.64,72115.05,1,12.23,12.26,5.54
918,0,7883786,10180,93.24,72208.29,2,7892673,8887,7883786,10180,93.24,78.66,72208.29,0,12.12,12.26,5.40
919,0,7883786,0,0.00,72208.29,2,7898766,14980,7883786,0,0.00,78.57,72208.29,0,13.11,12.11,5.50
920,0,7883786,0,0.00,72208.29,2,7902498,18712,7883786,0,0.00,78.49,72208.29,1,13.40,12.40,5.60
921,0,7883786,0,0.00,72208.29,2,7905090,21304,7883786,0,0.00,78.40,72208.29,0,12.56,11.56,5.46
922,0,7883786,0,0.00,72208.29,2,7907349,23563,7883786,0,0.00,78.32,72208.29,1,13.13,12.13,5.56
923,0,7888420,4634,42.44,72250.73,2,7909666,21246,7888420,4634,42.44,78.28,72250.73,0,11.92,12.13,5.44
924,0,7894082,5662,51.86,72302.59,2,7912497,18415,7894082,5662,51.86,78.25,72302.59,1,11.97,12.13,5.54
925,0,7901700,7618,69.77,72372.37,2,7916306,14606,7901700,7618,69.77,78.24,72372.37,1,10.18,12.13,5.30
926,0,7914274,12574,115.17,72487.53,2,7922593,8319,7914274,12574,115.17,78.28,72487.53,0,9.59,12.13,5.27
927,0,7937797,23523,215.45,72702.98,2,7937797,0,7937797,23523,215.45,78.43,72702.98,1,10.04,12.13,5.37
928,0,7965851,28054,256.95,72959.93,2,7965851,0,7965851,28054,256.95,78.62,72959.93,0,9.02,12.13,5.20
929,0,7994631,28780,263.60,73223.53,2,7994631,0,7994631,28780,263.60,78.82,73223.53,1,10.87,12.13,5.31
930,0,8025527,30896,282.98,73506.51,2,8025527,0,8025527,30896,282.98,79.04,73506.51,1,10.59,12.13,5.27
931,0,8025527,0,0.00,73506.51,2,8035817,10290,8025527,0,0.00,78.95,73506.51,0,13.11,12.11,5.21
932,0,8025527,0,0.00,73506.51,2,8041553,16026,8025527,0,0.00,78.87,73506.51,1,13.93,12.93,5.31
933,0,8025527,0,0.00,73506.51,2,8045888,20361,8025527,0,0.00,78.79,73506.51,0,13.84,12.84,5.20
934,0,8025527,0,0.00,73506.51,2,8049639,24112,8025527,0,0.00,78.70,73506.51,1,13.84,12.84,5.30
935,0,8032657,7130,65.30,73571.81,2,8053204,20547,8032657,7130,65.30,78.69,73571.81,0,12.61,12.84,5.19
936,0,8032657,0,0.00,73571.81,2,8056576,23919,8032657,0,0.00,78.60,73571.81,1,12.92,11.92,5.30
937,0,8038829,6172,56.53,73628.34,2,8059662,20833,8038829,6172,56.53,78.58,73628.34,0,11.68,11.92,5.19
938,0,8038829,0,0.00,73628.34,2,8062573,23744,8038829,0,0.00,78.50,73628.34,0,12.59,11.59,5.29
939,0,8038829,0,0.00,73628.34,2,8065158,26329,8038829,0,0.00,78.41,73628.34,1,12.59,11.59,5.39
940,0,8038829,0,0.00,73628.34,2,8067716,28887,8038829,0,0.00,78.33,73628.34,1,11.89,10.89,5.37
941,0,8038829,0,0.00,73628.34,2,8070182,31353,8038829,0,0.00,78.24,73628.34,0,10.91,9.91,5.31
942,0,8038829,0,0.00,73628.34,2,8072515,33686,8038829,0,0.00,78.16,73628.34,1,10.91,9.91,5.41
943,0,8043385,4556,41.73,73670.07,2,8074793,31408,8043385,4556,41.73,78.12,73670.07,1,9.77,9.91,5.32
944,0,8047859,4474,40.98,73711.05,2,8077030,29171,8047859,4474,40.98,78.08,73711.05,0,9.37,9.91,5.21
945,0,8052387,4528,41.47,73752.52,2,8079294,26907,8052387,4528,41.47,78.04,73752.52,0,9.70,9.91,5.31
946,0,8056945,4558,41.75,73794.27,2,8081573,24628,8056945,4558,41.75,78.01,73794.27,1,9.74,9.91,5.41
947,0,8061827,4882,44.71,73838.98,2,8084014,22187,8061827,4882,44.71,77.97,73838.98,0,8.50,9.91,5.24
948,0,8066921,5094,46.66,73885.64,2,8086561,19640,8066921,5094,46.66,77.94,73885.64,1,8.88,9.91,5.34
949,0,8072167,5246,48.05,73933.69,2,8089184,17017,8072167,5246,48.05,77.91,73933.69,0,7.06,9.91,5.13
950,0,8078275,6108,55.94,73989.63,2,8092238,13963,8078275,6108,55.94,77.88,73989.63,1,7.68,9.91,5.23
951,0,8088505,10230,93.70,74083.33,2,8097353,8848,8088505,10230,93.70,77.90,74083.33,0,7.03,9.91,5.07
952,0,8111609,23104,211.61,74294.95,2,8111609,0,8111609,23104,211.61,78.04,74294.95,1,7.69,9.91,5.17
953,0,8144452,32843,300.81,74595.75,2,8144452,0,8144452,32843,300.81,78.27,74595.75,0,7.58,9.91,5.07
954,0,8144452,0,0.00,74595.75,2,8154865,10413,8144452,0,0.00,78.19,74595.75,1,10.16,9.16,5.17
955,0,8164586,20134,184.41,74780.16,2,8164932,346,8164586,20134,184.41,78.30,74780.16,0,8.62,9.16,4.97
956,0,8164586,0,0.00,74780.16,2,8175378,10792,8164586,0,0.00,78.22,74780.16,1,9.31,8.31,5.07
957,0,8164586,0,0.00,74780.16,2,8180755,16169,8164586,0,0.00,78.14,74780.16,0,8.63,8.00,4.95
958,0,8174972,10386,95.13,74875.29,2,8185948,10976,8174972,10386,95.13,78.16,74875.29,0,9.09,10.09,5.05
959,0,8193606,18634,170.67,75045.96,2,8195265,1659,8193606,18634,170.67,78.25,75045.96,1,9.48,10.09,5.15
960,0,8224266,30660,280.82,75326.77,2,8224266,0,8224266,30660,280.82,78.47,75326.77,0,7.94,10.09,4.90
961,0,8254082,29816,273.09,75599.87,2,8254082,0,8254082,29816,273.09,78.67,75599.87,1,9.32,10.09,4.99
962,0,8284259,30177,276.39,75876.26,2,8284259,0,8284259,30177,276.39,78.87,75876.26,0,9.52,10.09,4.93
963,0,8284259,0,0.00,75876.26,2,8294593,10334,8284259,0,0.00,78.79,75876.26,1,10.89,9.89,5.03
964,0,8304553,20294,185.87,76062.13,2,8304740,187,8304553,20294,185.87,78.90,76062.13,0,9.40,9.89,4.88
965,0,8304553,0,0.00,76062.13,2,8315522,10969,8304553,0,0.00,78.82,76062.13,1,12.41,11.41,4.98
966,0,8304553,0,0.00,76062.13,2,8321040,16487,8304553,0,0.00,78.74,76062.13,1,12.93,11.93,4.84
967,0,8314279,9726,89.08,76151.21,2,8325903,11624,8314279,9726,89.08,78.75,76151.21,0,11.85,11.93,4.72
968,0,8314279,0,0.00,76151.21,2,8330864,16585,8314279,0,0.00,78.67,76151.21,1,12.45,11.45,4.82
969,0,8323475,9196,84.23,76235.44,2,8335462,11987,8323475,9196,84.23,78.67,76235.44,0,11.08,11.45,4.68
970,0,8339767,16292,149.22,76384.66,2,8343608,3841,8339767,16292,149.22,78.75,76384.66,1,11.16,11.45,4.78
971,0,8368073,28306,259.26,76643.92,2,8368073,0,8368073,28306,259.26,78.93,76643.92,0,10.10,11.45,4.62
972,0,8398749,30676,280.96,76924.88,2,8398749,0,8398749,30676,280.96,79.14,76924.88,1,10.74,11.45,4.72
973,0,8429846,31097,284.82,77209.70,2,8429846,0,8429846,31097,284.82,79.35,77209.70,0,10.95,11.45,4.64
974,0,8429846,0,0.00,77209.70,2,8440326,10480,8429846,0,0.00,79.27,77209.70,0,12.92,11.92,4.74
975,0,8429846,0,0.00,77209.70,2,8446554,16708,8429846,0,0.00,79.19,77209.70,1,14.31,13.31,4.84
976,0,8439698,9852,90.24,77299.94,2,8451480,11782,8439698,9852,90.24,79.20,77299.94,0,13.31,13.31,4.67
977,0,8439698,0,0.00,77299.94,2,8456334,16636,8439698,0,0.00,79.12,77299.94,1,14.46,13.46,4.76
978,0,8448722,9024,82.65,77382.59,2,8460846,12124,8448722,9024,82.65,79.12,77382.59,0,13.38,13.46,4.66
979,0,8464598,15876,145.41,77528.00,2,8468784,4186,8464598,15876,145.41,79.19,77528.00,1,13.46,13.46,4.76
980,0,8494504,29906,273.91,77801.91,2,8494504,0,8494504,29906,273.91,79.39,77801.91,0,12.84,13.46,4.68
981,0,8494504,0,0.00,77801.91,2,8504903,10399,8494504,0,0.00,79.31,77801.91,1,14.63,13.63,4.78
982,0,8494504,0,0.00,77801.91,2,8510860,16356,8494504,0,0.00,79.23,77801.91,1,14.00,13.00,4.68
983,0,8494504,0,0.00,77801.91,2,8515029,20525,8494504,0,0.00,79.15,77801.91,1,13.84,12.84,4.67
984,0,8494504,0,0.00,77801.91,2,8518829,24325,8494504,0,0.00,79.07,77801.91,0,13.08,12.08,4.61
985,0,8494504,0,0.00,77801.91,2,8522276,27772,8494504,0,0.00,78.99,77801.91,1,13.69,12.69,4.70
986,0,8500956,6452,59.09,77861.01,2,8525502,24546,8500956,6452,59.09,78.97,77861.01,0,12.30,12.69,4.58
987,0,8507422,6466,59.22,77920.23,2,8528735,21313,8507422,6466,59.22,78.95,77920.23,0,12.36,12.69,4.67
988,0,8507422,0,0.00,77920.23,2,8531789,24367,8507422,0,0.00,78.87,77920.23,1,13.06,12.06,4.77
989,0,8513030,5608,51.36,77971.59,2,8534593,21563,8513030,5608,51.36,78.84,77971.59,0,11.92,12.06,4.63
990,0,8513030,0,0.00,77971.59,2,8537259,24229,8513030,0,0.00,78.76,77971.59,1,12.24,11.24,4.72
991,0,8518070,5040,46.16,78017.75,2,8539779,21709,8518070,5040,46.16,78.73,78017.75,0,10.85,11.24,4.52
992,0,8518070,0,0.00,78017.75,2,8542222,24152,8518070,0,0.00,78.65,78017.75,1,11.44,10.44,4.61
993,0,8522646,4576,41.91,78059.66,2,8544510,21864,8522646,4576,41.91,78.61,78059.66,0,10.02,10.44,4.44
994,0,8527408,4762,43.62,78103.28,2,8546891,19483,8527408,4762,43.62,78.57,78103.28,1,10.39,10.44,4.54
995,0,8533308,5900,54.04,78157.32,2,8549841,16533,8533308,5900,54.04,78.55,78157.32,0,9.06,10.44,4.38
996,0,8541724,8416,77.08,78234.41,2,8554049,12325,8541724,8416,77.08,78.55,78234.41,1,9.40,10.44,4.47
997,0,8558464,16740,153.32,78387.73,2,8562419,3955,8558464,16740,153.32,78.62,78387.73,0,8.15,10.44,4.27
998,0,8589600,31136,285.18,78672.91,2,8589600,0,8589600,31136,285.18,78.83,78672.91,0,8.61,10.44,4.36
999,0,8621378,31778,291.06,78963.96,2,8621378,0,8621378,31778,291.06,79.04,78963.96,0,10.03,10.44,4.46
1000,0,8621378,0,0.00,78963.96,2,8631941,10563,8621378,0,0.00,78.96,78963.96,1,11.24,10.24,4.55
1001,0,8621378,0,0.00,78963.96,2,8638053,16675,8621378,0,0.00,78.89,78963.96,0,10.53,9.53,4.37
1002,0,8621378,0,0.00,78963.96,2,8642352,20974,8621378,0,0.00,78.81,78963.96,0,10.53,9.53,4.46
1003,0,8621378,0,0.00,78963.96,2,8646288,24910,8621378,0,0.00,78.73,78963.96,1,10.82,9.82,4.56
1004,0,8628820,7442,68.16,79032.12,2,8650009,21189,8628820,7442,68.16,78.72,79032.12,0,9.11,9.82,4.38
1005,0,8636106,7286,66.73,79098.86,2,8653652,17546,8636106,7286,66.73,78.71,79098.86,1,9.58,9.82,4.48
1006,0,8643258,7152,65.51,79164.36,2,8657228,13970,8643258,7152,65.51,78.69,79164.36,0,8.47,9.82,4.33
1007,0,8652082,8824,80.82,79245.18,2,8661640,9558,8652082,8824,80.82,78.69,79245.18,1,9.22,9.82,4.42
1008,0,8674413,22331,204.53,79449.71,2,8674413,0,8674413,22331,204.53,78.82,79449.71,1,9.57,9.82,4.37
1009,0,8707364,32951,301.80,79751.52,2,8707364,0,8707364,32951,301.80,79.04,79751.52,0,9.68,9.82,4.32
1010,0,8707364,0,0.00,79751.52,2,8717759,10395,8707364,0,0.00,78.96,79751.52,1,11.84,10.84,4.41
1011,0,8707364,0,0.00,79751.52,2,8723800,16436,8707364,0,0.00,78.88,79751.52,1,11.87,10.87,4.36
1012,0,8707364,0,0.00,79751.52,2,8728306,20942,8707364,0,0.00,78.81,79751.52,0,11.18,10.18,4.32
1013,0,8707364,0,0.00,79751.52,2,8732190,24826,8707364,0,0.00,78.73,79751.52,1,11.54,10.54,4.41
1014,0,8707364,0,0.00,79751.52,2,8735565,28201,8707364,0,0.00,78.65,79751.52,1,11.07,10.07,4.35
1015,0,8707364,0,0.00,79751.52,2,8738514,31150,8707364,0,0.00,78.57,79751.52,0,10.33,9.33,4.31
1016,0,8707364,0,0.00,79751.52,2,8741539,34175,8707364,0,0.00,78.50,79751.52,1,10.47,9.47,4.40
1017,0,8707364,0,0.00,79751.52,2,8744383,37019,8707364,0,0.00,78.42,79751.52,0,9.49,8.49,4.32
1018,0,8707364,0,0.00,79751.52,2,8747022,39658,8707364,0,0.00,78.34,79751.52,0,9.78,8.78,4.42
1019,0,8707364,0,0.00,79751.52,2,8749563,42199,8707364,0,0.00,78.26,79751.52,1,9.91,8.91,4.51
1020,0,8712282,4918,45.04,79796.56,2,8752022,39740,8712282,4918,45.04,78.23,79796.56,1,8.87,8.91,4.38
1021,0,8717104,4822,44.17,79840.73,2,8754433,37329,8717104,4822,44.17,78.20,79840.73,0,8.06,8.91,4.30
1022,0,8721900,4796,43.93,79884.65,2,8756831,34931,8721900,4796,43.93,78.17,79884.65,1,8.16,8.91,4.39
1023,0,8726666,4766,43.65,79928.30,2,8759214,32548,8726666,4766,43.65,78.13,79928.30,1,7.69,8.91,4.37
1024,0,8731412,4746,43.47,79971.77,2,8761587,30175,8731412,4746,43.47,78.10,79971.77,0,6.72,8.91,4.31
1025,0,8735946,4534,41.53,80013.30,2,8763854,27908,8735946,4534,41.53,78.06,80013.30,1,7.05,8.91,4.40
1026,0,8740388,4442,40.68,80053.98,2,8766075,25687,8740388,4442,40.68,78.03,80053.98,0,6.84,8.91,4.37
1027,0,8744788,4400,40.30,80094.28,2,8768275,23487,8744788,4400,40.30,77.99,80094.28,0,7.04,8.91,4.46
1028,0,8749162,4374,40.06,80134.34,2,8770462,21300,8749162,4374,40.06,77.95,80134.34,1,7.23,8.91,4.55
1029,0,8753858,4696,43.01,80177.36,2,8772810,18952,8753858,4696,43.01,77.92,80177.36,0,6.14,8.91,4.46
1030,0,8758944,5086,46.58,80223.94,2,8775353,16409,8758944,5086,46.58,77.89,80223.94,1,6.34,8.91,4.55
1031,0,8765030,6086,55.74,80279.68,2,8778396,13366,8765030,6086,55.74,77.87,80279.68,0,5.36,8.91,4.48
1032,0,8778860,13830,126.67,80406.35,2,8785311,6451,8778860,13830,126.67,77.91,80406.35,1,5.73,8.91,4.58
1033,0,8807192,28332,259.50,80665.85,2,8807192,0,8807192,28332,259.50,78.09,80665.85,0,4.50,8.91,4.40
1034,0,8839962,32770,300.14,80965.99,2,8839962,0,8839962,32770,300.14,78.30,80965.99,1,5.12,8.91,4.49
1035,0,8873336,33374,305.68,81271.66,2,8873336,0,8873336,33374,305.68,78.52,81271.66,0,4.97,8.91,4.41
1036,0,8906259,32923,301.54,81573.21,2,8906259,0,8906259,32923,301.54,78.74,81573.21,1,7.03,8.91,4.51
1037,0,8939318,33059,302.79,81876.00,2,8939318,0,8939318,33059,302.79,78.95,81876.00,0,7.22,8.91,4.38
1038,0,8972693,33375,305.68,82181.69,2,8972693,0,8972693,33375,305.68,79.17,82181.69,0,8.81,8.91,4.47
1039,0,8972693,0,0.00,82181.69,2,8983461,10768,8972693,0,0.00,79.10,82181.69,1,10.90,9.90,4.56
1040,0,8972693,0,0.00,82181.69,2,8989079,16386,8972693,0,0.00,79.02,82181.69,0,10.81,9.81,4.51
1041,0,8972693,0,0.00,82181.69,2,8993268,20575,8972693,0,0.00,78.94,82181.69,1,11.09,10.09,4.60
1042,0,8972693,0,0.00,82181.69,2,8996915,24222,8972693,0,0.00,78.87,82181.69,0,10.31,9.31,4.50
1043,0,8972693,0,0.00,82181.69,2,9000214,27521,8972693,0,0.00,78.79,82181.69,1,10.83,9.83,4.60
1044,0,8979251,6558,60.07,82241.75,2,9003493,24242,8979251,6558,60.07,78.78,82241.75,0,9.68,9.83,4.51
1045,0,8979251,0,0.00,82241.75,2,9006603,27352,8979251,0,0.00,78.70,82241.75,1,10.03,9.03,4.60
1046,0,8979251,0,0.00,82241.75,2,9009426,30175,8979251,0,0.00,78.62,82241.75,0,9.51,8.51,4.56
1047,0,8979251,0,0.00,82241.75,2,9011870,32619,8979251,0,0.00,78.55,82241.75,1,9.79,8.79,4.65
1048,0,8979251,0,0.00,82241.75,2,9014193,34942,8979251,0,0.00,78.47,82241.75,0,9.25,8.25,4.53
1049,0,8979251,0,0.00,82241.75,2,9016408,37157,8979251,0,0.00,78.40,82241.75,1,9.26,8.26,4.62
1050,0,8983451,4200,38.47,82280.22,2,9018508,35057,8983451,4200,38.47,78.36,82280.22,0,8.24,8.26,4.53
1051,0,8983451,0,0.00,82280.22,2,9020594,37143,8983451,0,0.00,78.29,82280.22,1,8.61,8.00,4.62
1052,0,8987661,4210,38.56,82318.78,2,9022699,35038,8987661,4210,38.56,78.25,82318.78,1,7.89,8.00,4.56
1053,0,8991717,4056,37.15,82355.93,2,9024727,33010,8991717,4056,37.15,78.21,82355.93,0,6.96,8.00,4.46
1054,0,8995747,4030,36.91,82392.84,2,9026742,30995,8995747,4030,36.91,78.17,82392.84,1,7.09,8.00,4.55
1055,0,9000021,4274,39.15,82431.98,2,9028879,28858,9000021,4274,39.15,78.13,82431.98,0,6.23,8.00,4.48
1056,0,9004301,4280,39.20,82471.19,2,9031019,26718,9004301,4280,39.20,78.10,82471.19,1,6.57,8.00,4.57
1057,0,9008803,4502,41.23,82512.42,2,9033270,24467,9008803,4502,41.23,78.06,82512.42,0,5.41,8.00,4.48
1058,0,9013401,4598,42.11,82554.53,2,9035569,22168,9013401,4598,42.11,78.03,82554.53,0,5.56,8.00,4.57
1059,0,9018035,4634,42.44,82596.98,2,9037886,19851,9018035,4634,42.44,78.00,82596.98,0,5.65,8.00,4.66
1060,0,9022913,4878,44.68,82641.66,2,9040325,17412,9022913,4878,44.68,77.96,82641.66,1,5.69,8.00,4.75
1061,0,9028969,6056,55.47,82697.12,2,9043353,14384,9028969,6056,55.47,77.94,82697.12,0,4.19,8.00,4.60
1062,0,9040409,11440,104.78,82801.91,2,9049073,8664,9040409,11440,104.78,77.97,82801.91,1,4.29,8.00,4.69
1063,0,9064808,24399,223.47,83025.38,2,9064808,0,9064808,24399,223.47,78.10,83025.38,0,3.44,8.00,4.61
1064,0,9097621,32813,300.54,83325.91,2,9097621,0,9097621,32813,300.54,78.31,83325.91,1,3.89,8.00,4.70
1065,0,9131051,33430,306.19,83632.10,2,9131051,0,9131051,33430,306.19,78.53,83632.10,0,3.74,8.00,4.59
1066,0,9164239,33188,303.97,83936.07,2,9164239,0,9164239,33188,303.97,78.74,83936.07,1,6.10,8.00,4.68
1067,0,9197665,33426,306.15,84242.23,2,9197665,0,9197665,33426,306.15,78.95,84242.23,1,5.87,8.00,4.62
1068,0,9231376,33711,308.76,84550.98,2,9231376,0,9231376,33711,308.76,79.17,84550.98,0,4.99,8.00,4.53
1069,0,9264883,33507,306.89,84857.88,2,9264883,0,9264883,33507,306.89,79.38,84857.88,1,6.08,8.00,4.62
1070,0,9296784,31901,292.18,85150.06,2,9296784,0,9296784,31901,292.18,79.58,85150.06,1,10.24,11.24,4.57
1071,0,9296784,0,0.00,85150.06,2,9307254,10470,9296784,0,0.00,79.51,85150.06,0,11.73,10.73,4.50
1072,0,9296784,0,0.00,85150.06,2,9312807,16023,9296784,0,0.00,79.43,85150.06,1,14.27,13.27,4.59
1073,0,9296784,0,0.00,85150.06,2,9316947,20163,9296784,0,0.00,79.36,85150.06,0,13.83,12.83,4.57
1074,0,9296784,0,0.00,85150.06,2,9320644,23860,9296784,0,0.00,79.28,85150.06,1,14.94,13.94,4.66
1075,0,9296784,0,0.00,85150.06,2,9324156,27372,9296784,0,0.00,79.21,85150.06,1,14.45,13.45,4.65
1076,0,9296784,0,0.00,85150.06,2,9327249,30465,9296784,0,0.00,79.14,85150.06,0,14.21,13.21,4.67
1077,0,9296784,0,0.00,85150.06,2,9330047,33263,9296784,0,0.00,79.06,85150.06,0,14.21,13.21,4.76
1078,0,9296784,0,0.00,85150.06,2,9332676,35892,9296784,0,0.00,78.99,85150.06,0,14.63,13.63,4.85
1079,0,9296784,0,0.00,85150.06,2,9335122,38338,9296784,0,0.00,78.92,85150.06,0,14.77,13.77,4.94
1080,0,9296784,0,0.00,85150.06,2,9337403,40619,9296784,0,0.00,78.84,85150.06,0,14.78,13.78,5.03
1081,0,9296784,0,0.00,85150.06,2,9339603,42819,9296784,0,0.00,78.77,85150.06,1,14.80,13.80,5.11
1082,0,9301086,4302,39.40,85189.47,2,9341754,40668,9301086,4302,39.40,78.73,85189.47,0,13.78,13.80,5.05
1083,0,9301086,0,0.00,85189.47,2,9343878,42792,9301086,0,0.00,78.66,85189.47,1,13.87,12.87,5.14
1084,0,9301086,0,0.00,85189.47,2,9345818,44732,9301086,0,0.00,78.59,85189.47,1,12.67,11.67,5.04
1085,0,9305154,4068,37.26,85226.73,2,9347852,42698,9305154,4068,37.26,78.55,85226.73,0,11.49,11.67,4.95
1086,0,9305154,0,0.00,85226.73,2,9349848,44694,9305154,0,0.00,78.48,85226.73,1,11.64,10.64,5.04
1087,0,9305154,0,0.00,85226.73,2,9351820,46666,9305154,0,0.00,78.41,85226.73,1,10.71,9.71,4.99
1088,0,9305154,0,0.00,85226.73,2,9353728,48574,9305154,0,0.00,78.33,85226.73,1,10.19,9.19,4.99
1089,0,9308908,3754,34.38,85261.11,2,9355605,46697,9308908,3754,34.38,78.29,85261.11,0,9.04,9.19,4.90
1090,0,9312636,3728,34.15,85295.25,2,9357469,44833,9312636,3728,34.15,78.25,85295.25,1,9.18,9.19,4.98
1091,0,9316214,3578,32.77,85328.02,2,9359258,43044,9316214,3578,32.77,78.21,85328.02,0,8.53,9.19,4.96
1092,0,9319962,3748,34.33,85362.35,2,9361132,41170,9319962,3748,34.33,78.17,85362.35,1,8.62,9.19,5.05
1093,0,9323648,3686,33.76,85396.12,2,9362975,39327,9323648,3686,33.76,78.13,85396.12,0,7.09,9.19,4.90
1094,0,9327208,3560,32.61,85428.72,2,9364755,37547,9327208,3560,32.61,78.09,85428.72,1,7.23,9.19,4.99
1095,0,9330922,3714,34.02,85462.73,2,9366612,35690,9330922,3714,34.02,78.05,85462.73,0,5.93,9.19,4.88
1096,0,9334600,3678,33.69,85496.42,2,9368451,33851,9334600,3678,33.69,78.01,85496.42,1,6.03,9.19,4.97
1097,0,9338118,3518,32.22,85528.65,2,9370210,32092,9338118,3518,32.22,77.97,85528.65,0,4.17,9.19,4.77
1098,0,9341716,3598,32.95,85561.60,2,9372009,30293,9341716,3598,32.95,77.92,85561.60,0,4.31,9.19,4.85
1099,0,9345496,3780,34.62,85596.22,2,9373899,28403,9345496,3780,34.62,77.89,85596.22,1,4.45,9.19,4.94
1100,0,9349322,3826,35.04,85631.27,2,9375812,26490,9349322,3826,35.04,77.85,85631.27,0,3.31,9.19,4.83
1101,0,9353298,3976,36.42,85667.68,2,9377800,24502,9353298,3976,36.42,77.81,85667.68,1,3.49,9.19,4.91
1102,0,9357462,4164,38.14,85705.82,2,9379882,22420,9357462,4164,38.14,77.77,85705.82,0,1.78,9.19,4.71
1103,0,9361850,4388,40.19,85746.01,2,9382076,20226,9361850,4388,40.19,77.74,85746.01,1,2.04,9.19,4.80
1104,0,9366544,4694,42.99,85789.00,2,9384423,17879,9366544,4694,42.99,77.71,85789.00,1,0.21,9.19,4.60
1105,0,9372550,6006,55.01,85844.01,2,9387426,14876,9372550,6006,55.01,77.69,85844.01,0,0.21,9.19,4.54
1106,0,9384376,11826,108.32,85952.33,2,9393339,8963,9384376,11826,108.32,77.71,85952.33,1,0.21,9.19,4.62
1107,0,9409584,25208,230.88,86183.21,2,9409584,0,9409584,25208,230.88,77.85,86183.21,0,0.21,9.19,4.43
1108,0,9444070,34486,315.86,86499.07,2,9444070,0,9444070,34486,315.86,78.07,86499.07,1,0.10,9.19,4.52
1109,0,9478352,34282,313.99,86813.06,2,9478352,0,9478352,34282,313.99,78.28,86813.06,0,0.10,9.19,4.38
1110,0,9512881,34529,316.25,87129.31,2,9512881,0,9512881,34529,316.25,78.49,87129.31,1,0.10,9.19,4.46
1111,0,9547544,34663,317.48,87446.80,2,9547544,0,9547544,34663,317.48,78.71,87446.80,0,0.10,9.19,4.26
1112,0,9582387,34843,319.13,87765.93,2,9582387,0,9582387,34843,319.13,78.93,87765.93,1,1.26,9.19,4.34
1113,0,9617121,34734,318.13,88084.06,2,9617121,0,9617121,34734,318.13,79.14,88084.06,0,6.72,9.19,4.20
1114,0,9617121,0,0.00,88084.06,2,9628083,10962,9617121,0,0.00,79.07,88084.06,1,9.55,8.55,4.28
1115,0,9617121,0,0.00,88084.06,2,9633853,16732,9617121,0,0.00,79.00,88084.06,0,8.80,8.00,4.06
1116,0,9627325,10204,93.46,88177.52,2,9638955,11630,9627325,10204,93.46,79.01,88177.52,1,8.80,9.80,4.15
1117,0,9645307,17982,164.70,88342.22,2,9647946,2639,9645307,17982,164.70,79.09,88342.22,0,7.10,9.80,3.98
1118,0,9679673,34366,314.76,88656.98,2,9679673,0,9679673,34366,314.76,79.30,88656.98,0,7.26,9.80,4.06
1119,0,9714448,34775,318.51,88975.48,2,9714448,0,9714448,34775,318.51,79.51,88975.48,1,8.03,9.80,4.15
1120,0,9749628,35180,322.22,89297.70,2,9749628,0,9749628,35180,322.22,79.73,89297.70,0,7.53,9.80,3.98
1121,0,9784077,34449,315.52,89613.23,2,9784077,0,9784077,34449,315.52,79.94,89613.23,1,9.13,9.80,4.07
1122,0,9818809,34732,318.11,89931.34,2,9818809,0,9818809,34732,318.11,80.15,89931.34,0,9.55,9.80,3.89
1123,0,9818809,0,0.00,89931.34,2,9829431,10622,9818809,0,0.00,80.08,89931.34,1,11.90,10.90,3.98
1124,0,9818809,0,0.00,89931.34,2,9835192,16383,9818809,0,0.00,80.01,89931.34,1,11.85,10.85,3.83
1125,0,9818809,0,0.00,89931.34,2,9839630,20821,9818809,0,0.00,79.94,89931.34,0,11.34,10.34,3.71
1126,0,9818809,0,0.00,89931.34,2,9843547,24738,9818809,0,0.00,79.87,89931.34,1,11.96,10.96,3.79
1127,0,9826231,7422,67.98,89999.31,2,9847258,21027,9826231,7422,67.98,79.86,89999.31,0,10.62,10.96,3.63
1128,0,9833641,7410,67.87,90067.19,2,9850963,17322,9833641,7410,67.87,79.85,90067.19,1,10.93,10.96,3.72
1129,0,9840951,7310,66.95,90134.14,2,9854618,13667,9840951,7310,66.95,79.84,90134.14,0,9.13,10.96,3.50
1130,0,9848745,7794,71.39,90205.52,2,9858515,9770,9848745,7794,71.39,79.83,90205.52,1,9.77,10.96,3.58
1131,0,9870514,21769,199.38,90404.91,2,9870514,0,9870514,21769,199.38,79.93,90404.91,0,8.81,10.96,3.45
1132,0,9903783,33269,304.71,90709.62,2,9903783,0,9903783,33269,304.71,80.13,90709.62,0,10.43,10.96,3.53
1133,0,9903783,0,0.00,90709.62,2,9914595,10812,9903783,0,0.00,80.06,90709.62,1,12.72,11.72,3.62
1134,0,9924365,20582,188.51,90898.13,2,9924886,521,9924365,20582,188.51,80.16,90898.13,1,11.48,11.72,3.33
1135,0,9924365,0,0.00,90898.13,2,9935421,11056,9924365,0,0.00,80.09,90898.13,0,11.75,10.75,3.21
1136,0,9924365,0,0.00,90898.13,2,9940605,16240,9924365,0,0.00,80.02,90898.13,1,12.65,11.65,3.29
1137,0,9934435,10070,92.23,90990.37,2,9945640,11205,9934435,10070,92.23,80.03,90990.37,0,10.88,11.65,3.09
1138,0,9952675,18240,167.06,91157.43,2,9954760,2085,9952675,18240,167.06,80.10,91157.43,0,11.52,11.65,3.18
1139,0,9952675,0,0.00,91157.43,2,9963680,11005,9952675,0,0.00,80.03,91157.43,0,12.48,11.48,3.26
1140,0,9952675,0,0.00,91157.43,2,9969256,16581,9952675,0,0.00,79.96,91157.43,1,13.04,12.04,3.35
1141,0,9962861,10186,93.29,91250.72,2,9974349,11488,9962861,10186,93.29,79.97,91250.72,0,11.38,12.04,3.16
1142,0,9981067,18206,166.75,91417.47,2,9983452,2385,9981067,18206,166.75,80.05,91417.47,1,11.75,12.04,3.25
1143,0,10013618,32551,298.14,91715.61,2,10013618,0,10013618,32551,298.14,80.24,91715.61,0,11.01,12.04,3.06
1144,0,10013618,0,0.00,91715.61,2,10024213,10595,10013618,0,0.00,80.17,91715.61,1,13.62,12.62,3.15
1145,0,10013618,0,0.00,91715.61,2,10029870,16252,10013618,0,0.00,80.10,91715.61,0,13.02,12.02,2.95
1146,0,10013618,0,0.00,91715.61,2,10034333,20715,10013618,0,0.00,80.03,91715.61,1,13.59,12.59,3.04
1147,0,10013618,0,0.00,91715.61,2,10038374,24756,10013618,0,0.00,79.96,91715.61,1,12.81,11.81,2.94
1148,0,10013618,0,0.00,91715.61,2,10041991,28373,10013618,0,0.00,79.89,91715.61,0,12.00,11.00,2.83
1149,0,10013618,0,0.00,91715.61,2,10045244,31626,10013618,0,0.00,79.82,91715.61,0,12.28,11.28,2.91
1150,0,10013618,0,0.00,91715.61,2,10048094,34476,10013618,0,0.00,79.75,91715.61,1,12.85,11.85,3.00
1151,0,10018752,5134,47.02,91762.63,2,10050661,31909,10018752,5134,47.02,79.72,91762.63,1,11.14,11.85,2.85
1152,0,10024038,5286,48.41,91811.05,2,10053304,29266,10024038,5286,48.41,79.70,91811.05,0,9.99,11.85,2.73
1153,0,10029380,5342,48.93,91859.98,2,10055975,26595,10029380,5342,48.93,79.67,91859.98,1,10.61,11.85,2.81
1154,0,10034646,5266,48.23,91908.21,2,10058608,23962,10034646,5266,48.23,79.64,91908.21,0,9.17,11.85,2.69
1155,0,10039850,5204,47.66,91955.87,2,10061210,21360,10039850,5204,47.66,79.62,91955.87,1,9.51,11.85,2.78
1156,0,10045064,5214,47.76,92003.62,2,10063817,18753,10045064,5214,47.76,79.59,92003.62,0,9.47,11.85,2.74
1157,0,10050210,5146,47.13,92050.76,2,10066390,16180,10050210,5146,47.13,79.56,92050.76,1,9.52,11.85,2.82
1158,0,10056060,5850,53.58,92104.34,2,10069315,13255,10056060,5850,53.58,79.54,92104.34,0,8.32,11.85,2.70
1159,0,10067830,11770,107.80,92212.14,2,10075200,7370,10067830,11770,107.80,79.56,92212.14,0,8.95,11.85,2.78
1160,0,10094452,26622,243.83,92455.98,2,10094452,0,10094452,26622,243.83,79.70,92455.98,1,9.36,11.85,2.86
1161,0,10127951,33499,306.82,92762.80,2,10127951,0,10127951,33499,306.82,79.90,92762.80,1,9.94,11.85,2.84
1162,0,10161380,33429,306.18,93068.98,2,10161380,0,10161380,33429,306.18,80.09,93068.98,0,9.94,11.85,2.84
1163,0,10193967,32587,298.47,93367.45,2,10193967,0,10193967,32587,298.47,80.28,93367.45,1,11.65,11.85,2.92
1164,0,10193967,0,0.00,93367.45,2,10204583,10616,10193967,0,0.00,80.21,93367.45,0,13.48,12.48,2.88
1165,0,10193967,0,0.00,93367.45,2,10210236,16269,10193967,0,0.00,80.14,93367.45,1,13.90,12.90,2.97
1166,0,10193967,0,0.00,93367.45,2,10214603,20636,10193967,0,0.00,80.07,93367.45,1,12.96,11.96,2.91
1167,0,10193967,0,0.00,93367.45,2,10218539,24572,10193967,0,0.00,80.01,93367.45,0,12.58,11.58,2.87
1168,0,10193967,0,0.00,93367.45,2,10221953,27986,10193967,0,0.00,79.94,93367.45,1,12.87,11.87,2.95
1169,0,10193967,0,0.00,93367.45,2,10225052,31085,10193967,0,0.00,79.87,93367.45,0,12.13,11.13,2.87
1170,0,10193967,0,0.00,93367.45,2,10227978,34011,10193967,0,0.00,79.80,93367.45,1,12.70,11.70,2.95
1171,0,10199449,5482,50.21,93417.65,2,10230719,31270,10199449,5482,50.21,79.78,93417.65,0,11.57,11.70,2.88
1172,0,10204853,5404,49.50,93467.15,2,10233421,28568,10204853,5404,49.50,79.75,93467.15,1,11.70,11.70,2.96
1173,0,10210207,5354,49.04,93516.19,2,10236098,25891,10210207,5354,49.04,79.72,93516.19,0,9.98,11.70,2.79
1174,0,10215565,5358,49.07,93565.26,2,10238777,23212,10215565,5358,49.07,79.70,93565.26,0,10.03,11.70,2.88
1175,0,10220677,5112,46.82,93612.08,2,10241333,20656,10220677,5112,46.82,79.67,93612.08,1,10.25,11.70,2.96
1176,0,10226057,5380,49.28,93661.36,2,10244023,17966,10226057,5380,49.28,79.64,93661.36,1,8.58,11.70,2.79
1177,0,10231559,5502,50.39,93711.75,2,10246774,15215,10231559,5502,50.39,79.62,93711.75,0,7.66,11.70,2.71
1178,0,10238181,6622,60.65,93772.40,2,10250085,11904,10238181,6622,60.65,79.60,93772.40,0,7.91,11.70,2.79
1179,0,10255015,16834,154.18,93926.59,2,10258502,3487,10255015,16834,154.18,79.67,93926.59,0,8.36,11.70,2.87
1180,0,10287596,32581,298.41,94225.00,2,10287596,0,10287596,32581,298.41,79.85,94225.00,1,9.24,11.70,2.95
1181,0,10319637,32041,293.47,94518.46,2,10319637,0,10319637,32041,293.47,80.03,94518.46,0,8.62,11.70,2.80
1182,0,10352837,33200,304.08,94822.55,2,10352837,0,10352837,33200,304.08,80.22,94822.55,1,10.28,11.70,2.89
1183,0,10385607,32770,300.14,95122.69,2,10385607,0,10385607,32770,300.14,80.41,95122.69,0,10.89,11.70,2.79
1184,0,10418661,33054,302.74,95425.44,2,10418661,0,10418661,33054,302.74,80.60,95425.44,1,11.42,11.70,2.88
1185,0,10451788,33127,303.41,95728.84,2,10451788,0,10451788,33127,303.41,80.78,95728.84,0,11.44,11.70,2.83
1186,0,10451788,0,0.00,95728.84,2,10462739,10951,10451788,0,0.00,80.72,95728.84,1,13.26,12.26,2.91
1187,0,10451788,0,0.00,95728.84,2,10468395,16607,10451788,0,0.00,80.65,95728.84,1,12.80,11.80,2.79
1188,0,10462356,10568,96.79,95825.64,2,10473679,11323,10462356,10568,96.79,80.66,95825.64,0,11.80,11.80,2.74
1189,0,10462356,0,0.00,95825.64,2,10478486,16130,10462356,0,0.00,80.59,95825.64,1,11.89,10.89,2.82
1190,0,10462356,0,0.00,95825.64,2,10482016,19660,10462356,0,0.00,80.53,95825.64,1,11.00,10.00,2.75
1191,0,10468956,6600,60.45,95886.09,2,10485316,16360,10468956,6600,60.45,80.51,95886.09,0,9.87,10.00,2.68
1192,0,10468956,0,0.00,95886.09,2,10488443,19487,10468956,0,0.00,80.44,95886.09,1,10.50,9.50,2.76
1193,0,10468956,0,0.00,95886.09,2,10491223,22267,10468956,0,0.00,80.37,95886.09,0,10.64,9.64,2.68
1194,0,10468956,0,0.00,95886.09,2,10493791,24835,10468956,0,0.00,80.31,95886.09,1,10.64,9.64,2.76
1195,0,10468956,0,0.00,95886.09,2,10496141,27185,10468956,0,0.00,80.24,95886.09,0,10.42,9.42,2.67
1196,0,10468956,0,0.00,95886.09,2,10498241,29285,10468956,0,0.00,80.17,95886.09,1,11.90,10.90,2.75
1197,0,10473278,4322,39.59,95925.68,2,10500402,27124,10473278,4322,39.59,80.14,95925.68,0,10.41,10.90,2.64
1198,0,10477862,4584,41.99,95967.66,2,10502694,24832,10477862,4584,41.99,80.11,95967.66,0,10.74,10.90,2.72
1199,0,10477862,0,0.00,95967.66,2,10505014,27152,10477862,0,0.00,80.04,95967.66,0,11.06,10.06,2.80
1200,0,10477862,0,0.00,95967.66,2,10507122,29260,10477862,0,0.00,79.97,95967.66,1,11.35,10.35,2.88
1201,0,10481978,4116,37.70,96005.36,2,10509180,27202,10481978,4116,37.70,79.94,96005.36,0,9.30,10.35,2.69
1202,0,10486142,4164,38.14,96043.50,2,10511262,25120,10486142,4164,38.14,79.90,96043.50,1,9.62,10.35,2.77
1203,0,10490544,4402,40.32,96083.82,2,10513463,22919,10490544,4402,40.32,79.87,96083.82,0,8.47,10.35,2.66
1204,0,10495122,4578,41.93,96125.75,2,10515752,20630,10495122,4578,41.93,79.84,96125.75,1,8.80,10.35,2.74
1205,0,10499946,4824,44.18,96169.93,2,10518164,18218,10499946,4824,44.18,79.81,96169.93,1,6.65,10.35,2.53
1206,0,10505696,5750,52.66,96222.59,2,10521039,15343,10505696,5750,52.66,79.79,96222.59,0,5.93,10.35,2.49
1207,0,10514858,9162,83.92,96306.51,2,10525620,10762,10514858,9162,83.92,79.79,96306.51,1,6.20,10.35,2.57
1208,0,10532618,17760,162.67,96469.18,2,10534500,1882,10532618,17760,162.67,79.86,96469.18,0,5.27,10.35,2.52
1209,0,10566066,33448,306.35,96775.53,2,10566066,0,10566066,33448,306.35,80.05,96775.53,1,6.00,10.35,2.60
1210,0,10599584,33518,306.99,97082.52,2,10599584,0,10599584,33518,306.99,80.23,97082.52,1,6.00,10.35,2.56
1211,0,10633669,34085,312.19,97394.71,2,10633669,0,10633669,34085,312.19,80.43,97394.71,0,5.94,10.35,2.50
1212,0,10667504,33835,309.90,97704.61,2,10667504,0,10667504,33835,309.90,80.61,97704.61,1,8.95,10.35,2.59
1213,0,10700041,32537,298.01,98002.62,2,10700041,0,10700041,32537,298.01,80.79,98002.62,0,10.19,10.35,2.49
1214,0,10700041,0,0.00,98002.62,2,10710642,10601,10700041,0,0.00,80.73,98002.62,1,12.49,11.49,2.57
1215,0,10700041,0,0.00,98002.62,2,10716156,16115,10700041,0,0.00,80.66,98002.62,0,12.26,11.26,2.47
1216,0,10700041,0,0.00,98002.62,2,10720276,20235,10700041,0,0.00,80.59,98002.62,1,13.12,12.12,2.55
1217,0,10700041,0,0.00,98002.62,2,10723750,23709,10700041,0,0.00,80.53,98002.62,0,12.76,11.76,2.51
1218,0,10700041,0,0.00,98002.62,2,10727065,27024,10700041,0,0.00,80.46,98002.62,0,13.33,12.33,2.59
1219,0,10700041,0,0.00,98002.62,2,10730155,30114,10700041,0,0.00,80.40,98002.62,0,13.62,12.62,2.67
1220,0,10700041,0,0.00,98002.62,2,10733044,33003,10700041,0,0.00,80.33,98002.62,1,13.91,12.91,2.75
1221,0,10705629,5588,51.18,98053.80,2,10735838,30209,10705629,5588,51.18,80.31,98053.80,1,12.21,12.91,2.57
1222,0,10711207,5578,51.09,98104.89,2,10738627,27420,10711207,5578,51.09,80.28,98104.89,0,11.38,12.91,2.54
1223,0,10716797,5590,51.20,98156.09,2,10741422,24625,10716797,5590,51.20,80.26,98156.09,1,12.15,12.91,2.62
1224,0,10722315,5518,50.54,98206.62,2,10744181,21866,10722315,5518,50.54,80.23,98206.62,0,11.17,12.91,2.53
1225,0,10727889,5574,51.05,98257.68,2,10746968,19079,10727889,5574,51.05,80.21,98257.68,1,11.49,12.91,2.61
1226,0,10733393,5504,50.41,98308.09,2,10749720,16327,10733393,5504,50.41,80.19,98308.09,1,11.06,12.91,2.57
1227,0,10739135,5742,52.59,98360.69,2,10752591,13456,10739135,5742,52.59,80.16,98360.69,0,10.50,12.91,2.55
1228,0,10748897,9762,89.41,98450.09,2,10757472,8575,10748897,9762,89.41,80.17,98450.09,1,11.08,12.91,2.63
1229,0,10773949,25052,229.45,98679.55,2,10773949,0,10773949,25052,229.45,80.29,98679.55,1,10.63,12.91,2.58
1230,0,10807311,33362,305.57,98985.12,2,10807311,0,10807311,33362,305.57,80.48,98985.12,0,9.66,12.91,2.51
1231,0,10839700,32389,296.65,99281.77,2,10839700,0,10839700,32389,296.65,80.65,99281.77,1,11.59,12.91,2.59
1232,0,10872653,32953,301.82,99583.59,2,10872653,0,10872653,32953,301.82,80.83,99583.59,0,11.17,12.91,2.50
1233,0,10905455,32802,300.44,99884.02,2,10905455,0,10905455,32802,300.44,81.01,99884.02,0,12.49,12.91,2.58
1234,0,10905455,0,0.00,99884.02,2,10915857,10402,10905455,0,0.00,80.94,99884.02,1,13.69,12.69,2.65
1235,0,10925961,20506,187.82,100071.84,2,10926110,149,10925961,20506,187.82,81.03,100071.84,0,12.06,12.69,2.50
1236,0,10958381,32420,296.94,100368.78,2,10958381,0,10958381,32420,296.94,81.20,100368.78,1,12.64,12.69,2.58
1237,0,10958381,0,0.00,100368.78,2,10969124,10743,10958381,0,0.00,81.14,100368.78,0,12.72,11.72,2.40
1238,0,10958381,0,0.00,100368.78,2,10974907,16526,10958381,0,0.00,81.07,100368.78,0,14.31,13.31,2.48
1239,0,10958381,0,0.00,100368.78,2,10979249,20868,10958381,0,0.00,81.01,100368.78,1,15.72,14.72,2.56
1240,0,10958381,0,0.00,100368.78,2,10983032,24651,10958381,0,0.00,80.94,100368.78,0,16.72,15.72,2.52
1241,0,10958381,0,0.00,100368.78,2,10986407,28026,10958381,0,0.00,80.88,100368.78,1,18.05,17.05,2.60
1242,0,10964797,6416,58.76,100427.54,2,10989615,24818,10964797,6416,58.76,80.86,100427.54,0,16.96,17.05,2.49
1243,0,10964797,0,0.00,100427.54,2,10992628,27831,10964797,0,0.00,80.79,100427.54,1,17.18,16.18,2.57
1244,0,10970437,5640,51.66,100479.20,2,10995448,25011,10970437,5640,51.66,80.77,100479.20,1,16.12,16.18,2.48
1245,0,10975989,5552,50.85,100530.05,2,10998224,22235,10975989,5552,50.85,80.75,100530.05,0,15.84,16.18,2.40
1246,0,10981491,5502,50.39,100580.45,2,11000975,19484,10981491,5502,50.39,80.72,100580.45,1,15.89,16.18,2.48
1247,0,10987165,5674,51.97,100632.41,2,11003812,16647,10987165,5674,51.97,80.70,100632.41,0,14.72,16.18,2.40
1248,0,10992867,5702,52.23,100684.64,2,11006663,13796,10992867,5702,52.23,80.68,100684.64,1,15.32,16.18,2.47
1249,0,11000739,7872,72.10,100756.73,2,11010599,9860,11000739,7872,72.10,80.67,100756.73,0,14.20,16.18,2.37
1250,0,11022123,21384,195.86,100952.59,2,11022123,0,11022123,21384,195.86,80.76,100952.59,1,14.58,16.18,2.45
1251,0,11055046,32923,301.54,101254.14,2,11055046,0,11055046,32923,301.54,80.94,101254.14,0,13.95,16.18,2.37
1252,0,11086809,31763,290.92,101545.06,2,11086809,0,11086809,31763,290.92,81.11,101545.06,1,15.05,16.18,2.45
1253,0,11119428,32619,298.76,101843.82,2,11119428,0,11119428,32619,298.76,81.28,101843.82,0,14.87,16.18,2.36
1254,0,11119428,0,0.00,101843.82,2,11130236,10808,11119428,0,0.00,81.22,101843.82,0,16.66,15.66,2.44
1255,0,11119428,0,0.00,101843.82,2,11136214,16786,11119428,0,0.00,81.15,101843.82,1,17.15,16.15,2.51
1256,0,11128880,9452,86.57,101930.39,2,11140940,12060,11128880,9452,86.57,81.15,101930.39,0,15.79,16.15,2.38
1257,0,11143122,14242,130.44,102060.84,2,11148061,4939,11143122,14242,130.44,81.19,102060.84,1,15.87,16.15,2.46
1258,0,11173351,30229,276.87,102337.70,2,11173351,0,11173351,30229,276.87,81.35,102337.70,0,14.67,16.15,2.37
1259,0,11204589,31238,286.11,102623.82,2,11204589,0,11204589,31238,286.11,81.51,102623.82,0,15.23,16.15,2.45
1260,0,11204589,0,0.00,102623.82,2,11214722,10133,11204589,0,0.00,81.45,102623.82,1,17.20,16.20,2.53
1261,0,11204589,0,0.00,102623.82,2,11220388,15799,11204589,0,0.00,81.38,102623.82,0,17.39,16.39,2.45
1262,0,11204589,0,0.00,102623.82,2,11224580,19991,11204589,0,0.00,81.32,102623.82,1,18.79,17.79,2.53
1263,0,11204589,0,0.00,102623.82,2,11228345,23756,11204589,0,0.00,81.25,102623.82,0,18.11,17.11,2.45
1264,0,11204589,0,0.00,102623.82,2,11231827,27238,11204589,0,0.00,81.19,102623.82,1,18.11,17.11,2.52
1265,0,11204589,0,0.00,102623.82,2,11234775,30186,11204589,0,0.00,81.13,102623.82,1,18.48,17.48,2.47
1266,0,11204589,0,0.00,102623.82,2,11237596,33007,11204589,0,0.00,81.06,102623.82,1,18.78,17.78,2.41
1267,0,11204589,0,0.00,102623.82,2,11240397,35808,11204589,0,0.00,81.00,102623.82,0,18.08,17.08,2.38
1268,0,11204589,0,0.00,102623.82,2,11243042,38453,11204589,0,0.00,80.93,102623.82,1,19.66,18.66,2.46
1269,0,11204589,0,0.00,102623.82,2,11245555,40966,11204589,0,0.00,80.87,102623.82,0,19.03,18.03,2.41
1270,0,11204589,0,0.00,102623.82,2,11247936,43347,11204589,0,0.00,80.81,102623.82,1,19.27,18.27,2.49
1271,0,11204589,0,0.00,102623.82,2,11250206,45617,11204589,0,0.00,80.74,102623.82,1,18.42,17.42,2.46
1272,0,11204589,0,0.00,102623.82,2,11252380,47791,11204589,0,0.00,80.68,102623.82,0,17.87,16.87,2.43
1273,0,11204589,0,0.00,102623.82,2,11254476,49887,11204589,0,0.00,80.62,102623.82,1,18.05,17.05,2.51
1274,0,11208587,3998,36.62,102660.44,2,11256475,47888,11208587,3998,36.62,80.58,102660.44,0,16.72,17.05,2.42
1275,0,11208587,0,0.00,102660.44,2,11258497,49910,11208587,0,0.00,80.52,102660.44,0,17.33,16.33,2.50
1276,0,11208587,0,0.00,102660.44,2,11260418,51831,11208587,0,0.00,80.45,102660.44,1,17.62,16.62,2.57
1277,0,11212349,3762,34.46,102694.89,2,11262299,49950,11212349,3762,34.46,80.42,102694.89,0,16.20,16.62,2.47
1278,0,11215989,3640,33.34,102728.23,2,11264119,48130,11215989,3640,33.34,80.38,102728.23,0,16.44,16.62,2.55
1279,0,11215989,0,0.00,102728.23,2,11265815,49826,11215989,0,0.00,80.32,102728.23,1,16.65,15.65,2.62
1280,0,11219399,3410,31.23,102759.46,2,11267520,48121,11219399,3410,31.23,80.28,102759.46,1,15.26,15.65,2.52
1281,0,11222929,3530,32.33,102791.80,2,11269285,46356,11222929,3530,32.33,80.24,102791.80,0,14.19,15.65,2.46
1282,0,11226403,3474,31.82,102823.62,2,11271022,44619,11226403,3474,31.82,80.21,102823.62,0,14.28,15.65,2.54
1283,0,11229923,3520,32.24,102855.85,2,11272782,42859,11229923,3520,32.24,80.17,102855.85,1,14.68,15.65,2.61
1284,0,11233425,3502,32.08,102887.93,2,11274533,41108,11233425,3502,32.08,80.13,102887.93,1,13.32,15.65,2.49
1285,0,11236891,3466,31.75,102919.67,2,11276266,39375,11236891,3466,31.75,80.09,102919.67,0,12.60,15.65,2.46
1286,0,11240311,3420,31.32,102951.00,2,11277976,37665,11240311,3420,31.32,80.06,102951.00,1,12.69,15.65,2.53
1287,0,11243747,3436,31.47,102982.47,2,11279694,35947,11243747,3436,31.47,80.02,102982.47,0,12.09,15.65,2.53
1288,0,11247141,3394,31.09,103013.55,2,11281391,34250,11247141,3394,31.09,79.98,103013.55,1,12.18,15.65,2.60
1289,0,11250523,3382,30.98,103044.53,2,11283082,32559,11250523,3382,30.98,79.94,103044.53,0,11.62,15.65,2.61
1290,0,11253875,3352,30.70,103075.23,2,11284758,30883,11253875,3352,30.70,79.90,103075.23,1,11.65,15.65,2.68
1291,0,11257267,3392,31.07,103106.30,2,11286454,29187,11257267,3392,31.07,79.87,103106.30,0,10.95,15.65,2.67
1292,0,11260747,3480,31.87,103138.17,2,11288194,27447,11260747,3480,31.87,79.83,103138.17,1,10.98,15.65,2.74
1293,0,11264309,3562,32.62,103170.80,2,11289975,25666,11264309,3562,32.62,79.79,103170.80,0,10.17,15.65,2.72
1294,0,11268017,3708,33.96,103204.76,2,11291829,23812,11268017,3708,33.96,79.76,103204.76,1,10.20,15.65,2.79
1295,0,11271921,3904,35.76,103240.52,2,11293781,21860,11271921,3904,35.76,79.72,103240.52,0,9.23,15.65,2.74
1296,0,11275985,4064,37.22,103277.74,2,11295813,19828,11275985,4064,37.22,79.69,103277.74,1,9.31,15.65,2.82
1297,0,11279989,4004,36.67,103314.41,2,11297815,17826,11279989,4004,36.67,79.66,103314.41,0,8.30,15.65,2.73
1298,0,11285005,5016,45.94,103360.35,2,11300323,15318,11285005,5016,45.94,79.63,103360.35,0,8.37,15.65,2.81
1299,0,11293135,8130,74.46,103434.82,2,11304388,11253,11293135,8130,74.46,79.63,103434.82,1,8.45,15.65,2.88
1300,0,11309913,16778,153.67,103588.49,2,11312777,2864,11309913,16778,153.67,79.68,103588.49,0,7.67,15.65,2.84
1301,0,11342898,32985,302.11,103890.60,2,11342898,0,11342898,32985,302.11,79.85,103890.60,1,9.11,15.65,2.92
1302,0,11376086,33188,303.97,104194.58,2,11376086,0,11376086,33188,303.97,80.03,104194.58,1,9.00,15.65,2.81
1303,0,11409014,32928,301.59,104496.16,2,11409014,0,11409014,32928,301.59,80.20,104496.16,0,10.81,15.65,2.74
1304,0,11441356,32342,296.22,104792.39,2,11441356,0,11441356,32342,296.22,80.36,104792.39,1,13.13,15.65,2.82
1305,0,11473825,32469,297.39,105089.77,2,11473825,0,11473825,32469,297.39,80.53,105089.77,0,12.58,15.65,2.76
1306,0,11506565,32740,299.87,105389.64,2,11506565,0,11506565,32740,299.87,80.70,105389.64,0,14.81,15.65,2.84
1307,0,11506565,0,0.00,105389.64,2,11517295,10730,11506565,0,0.00,80.63,105389.64,1,17.54,16.54,2.91
1308,0,11506565,0,0.00,105389.64,2,11522955,16390,11506565,0,0.00,80.57,105389.64,1,17.36,16.36,2.82
1309,0,11506565,0,0.00,105389.64,2,11527364,20799,11506565,0,0.00,80.51,105389.64,0,16.95,15.95,2.76
1310,0,11506565,0,0.00,105389.64,2,11531262,24697,11506565,0,0.00,80.45,105389.64,1,17.17,16.17,2.83
1311,0,11506565,0,0.00,105389.64,2,11534740,28175,11506565,0,0.00,80.39,105389.64,0,16.44,15.44,2.78
1312,0,11506565,0,0.00,105389.64,2,11537891,31326,11506565,0,0.00,80.33,105389.64,1,16.44,15.44,2.86
1313,0,11512543,5978,54.75,105444.40,2,11540880,28337,11512543,5978,54.75,80.31,105444.40,0,15.32,15.44,2.78
1314,0,11512543,0,0.00,105444.40,2,11543713,31170,11512543,0,0.00,80.25,105444.40,1,15.47,14.47,2.86
1315,0,11512543,0,0.00,105444.40,2,11546308,33765,11512543,0,0.00,80.19,105444.40,1,14.66,13.66,2.83
1316,0,11512543,0,0.00,105444.40,2,11548745,36202,11512543,0,0.00,80.12,105444.40,0,13.97,12.97,2.80
1317,0,11512543,0,0.00,105444.40,2,11551056,38513,11512543,0,0.00,80.06,105444.40,0,14.10,13.10,2.88
1318,0,11512543,0,0.00,105444.40,2,11553098,40555,11512543,0,0.00,80.00,105444.40,0,14.10,13.10,2.95
1319,0,11512543,0,0.00,105444.40,2,11555140,42597,11512543,0,0.00,79.94,105444.40,0,14.10,13.10,3.03
1320,0,11512543,0,0.00,105444.40,2,11557223,44680,11512543,0,0.00,79.88,105444.40,1,14.10,13.10,3.10
1321,0,11516669,4126,37.79,105482.19,2,11559286,42617,11516669,4126,37.79,79.85,105482.19,0,12.64,13.10,3.00
1322,0,11520629,3960,36.27,105518.45,2,11561266,40637,11520629,3960,36.27,79.82,105518.45,1,12.68,13.10,3.07
1323,0,11524583,3954,36.22,105554.67,2,11563243,38660,11524583,3954,36.22,79.78,105554.67,0,11.35,13.10,2.98
1324,0,11528517,3934,36.03,105590.70,2,11565210,36693,11528517,3934,36.03,79.75,105590.70,1,11.39,13.10,3.06
1325,0,11532437,3920,35.90,105626.61,2,11567170,34733,11532437,3920,35.90,79.72,105626.61,1,9.65,13.10,2.89
1326,0,11536345,3908,35.79,105662.40,2,11569124,32779,11536345,3908,35.79,79.69,105662.40,0,8.87,13.10,2.87
1327,0,11540319,3974,36.40,105698.80,2,11571111,30792,11540319,3974,36.40,79.65,105698.80,1,8.91,13.10,2.94
1328,0,11544449,4130,37.83,105736.62,2,11573176,28727,11544449,4130,37.83,79.62,105736.62,1,7.93,13.10,2.89
1329,0,11548563,4114,37.68,105774.30,2,11575233,26670,11548563,4114,37.68,79.59,105774.30,0,7.04,13.10,2.86
1330,0,11552659,4096,37.52,105811.82,2,11577281,24622,11552659,4096,37.52,79.56,105811.82,1,7.07,13.10,2.93
1331,0,11556805,4146,37.97,105849.80,2,11579354,22549,11556805,4146,37.97,79.53,105849.80,0,6.21,13.10,2.89
1332,0,11561029,4224,38.69,105888.48,2,11581466,20437,11561029,4224,38.69,79.50,105888.48,1,6.25,13.10,2.97
1333,0,11565551,4522,41.42,105929.90,2,11583727,18176,11565551,4522,41.42,79.47,105929.90,0,5.53,13.10,2.92
1334,0,11569937,4386,40.17,105970.07,2,11585920,15983,11569937,4386,40.17,79.44,105970.07,1,5.57,13.10,2.99
1335,0,11575567,5630,51.57,106021.64,2,11588735,13168,11575567,5630,51.57,79.42,106021.64,0,4.86,13.10,2.97
1336,0,11587335,11768,107.78,106129.42,2,11594619,7284,11587335,11768,107.78,79.44,106129.42,1,5.08,13.10,3.05
1337,0,11615105,27770,254.35,106383.77,2,11615105,0,11615105,27770,254.35,79.57,106383.77,0,4.06,13.10,2.94
1338,0,11647230,32125,294.24,106678.01,2,11647230,0,11647230,32125,294.24,79.73,106678.01,0,5.81,13.10,3.02
1339,0,11679176,31946,292.60,106970.60,2,11679176,0,11679176,31946,292.60,79.89,106970.60,1,8.10,13.10,3.09
1340,0,11710821,31645,289.84,107260.45,2,11710821,0,11710821,31645,289.84,80.05,107260.45,0,8.74,13.10,2.97
1341,0,11742468,31647,289.86,107550.30,2,11742468,0,11742468,31647,289.86,80.20,107550.30,1,11.03,13.10,3.04
1342,0,11774614,32146,294.43,107844.73,2,11774614,0,11774614,32146,294.43,80.36,107844.73,0,12.29,13.10,2.99
1343,0,11774614,0,0.00,107844.73,2,11784952,10338,11774614,0,0.00,80.30,107844.73,1,14.58,13.58,3.06
1344,0,11774614,0,0.00,107844.73,2,11791051,16437,11774614,0,0.00,80.24,107844.73,1,14.67,13.67,2.94
1345,0,11774614,0,0.00,107844.73,2,11795882,21268,11774614,0,0.00,80.18,107844.73,0,13.69,12.69,2.87
1346,0,11774614,0,0.00,107844.73,2,11799950,25336,11774614,0,0.00,80.12,107844.73,1,14.27,13.27,2.94
1347,0,11774614,0,0.00,107844.73,2,11803629,29015,11774614,0,0.00,80.06,107844.73,0,13.37,12.37,2.84
1348,0,11774614,0,0.00,107844.73,2,11806966,32352,11774614,0,0.00,80.00,107844.73,1,13.65,12.65,2.91
1349,0,11780436,5822,53.32,107898.05,2,11809877,29441,11780436,5822,53.32,79.98,107898.05,0,12.42,12.65,2.81
1350,0,11780436,0,0.00,107898.05,2,11812750,32314,11780436,0,0.00,79.92,107898.05,1,12.76,11.76,2.88
1351,0,11786082,5646,51.71,107949.77,2,11815573,29491,11786082,5646,51.71,79.90,107949.77,0,11.15,11.76,2.73
1352,0,11786082,0,0.00,107949.77,2,11818244,32162,11786082,0,0.00,79.84,107949.77,1,11.78,10.78,2.80
1353,0,11791066,4984,45.65,107995.41,2,11820736,29670,11791066,4984,45.65,79.82,107995.41,0,10.41,10.78,2.71
1354,0,11795902,4836,44.29,108039.70,2,11823154,27252,11795902,4836,44.29,79.79,108039.70,0,10.45,10.78,2.78
1355,0,11800678,4776,43.74,108083.45,2,11825542,24864,11800678,4776,43.74,79.77,108083.45,1,10.49,10.78,2.85
1356,0,11805368,4690,42.96,108126.41,2,11827887,22519,11805368,4690,42.96,79.74,108126.41,0,8.77,10.78,2.72
1357,0,11809832,4464,40.89,108167.29,2,11830119,20287,11809832,4464,40.89,79.71,108167.29,1,8.82,10.78,2.79
1358,0,11814516,4684,42.90,108210.20,2,11832461,17945,11814516,4684,42.90,79.68,108210.20,0,7.13,10.78,2.66
1359,0,11819586,5070,46.44,108256.63,2,11834996,15410,11819586,5070,46.44,79.66,108256.63,0,7.17,10.78,2.73
1360,0,11826966,7380,67.59,108324.23,2,11838686,11720,11826966,7380,67.59,79.65,108324.23,1,7.22,10.78,2.81
1361,0,11842892,15926,145.87,108470.09,2,11846649,3757,11842892,15926,145.87,79.70,108470.09,0,6.11,10.78,2.71
1362,0,11875134,32242,295.31,108765.40,2,11875134,0,11875134,32242,295.31,79.86,108765.40,1,6.29,10.78,2.78
1363,0,11907748,32614,298.71,109064.12,2,11907748,0,11907748,32614,298.71,80.02,109064.12,1,5.89,10.78,2.68
1364,0,11942045,34297,314.13,109378.24,2,11942045,0,11942045,34297,314.13,80.19,109378.24,0,6.42,10.78,2.58
1365,0,11975822,33777,309.37,109687.61,2,11975822,0,11975822,33777,309.37,80.36,109687.61,1,8.43,10.78,2.66
1366,0,12009685,33863,310.15,109997.77,2,12009685,0,12009685,33863,310.15,80.53,109997.77,0,9.81,10.78,2.61
1367,0,12009685,0,0.00,109997.77,2,12020428,10743,12009685,0,0.00,80.47,109997.77,1,12.41,11.41,2.68
1368,0,12009685,0,0.00,109997.77,2,12026407,16722,12009685,0,0.00,80.41,109997.77,0,12.48,11.48,2.63
1369,0,12009685,0,0.00,109997.77,2,12030978,21293,12009685,0,0.00,80.35,109997.77,1,13.33,12.33,2.70
1370,0,12009685,0,0.00,109997.77,2,12034627,24942,12009685,0,0.00,80.29,109997.77,1,12.47,11.47,2.64
1371,0,12009685,0,0.00,109997.77,2,12038047,28362,12009685,0,0.00,80.23,109997.77,0,11.97,10.97,2.59
1372,0,12009685,0,0.00,109997.77,2,12041220,31535,12009685,0,0.00,80.17,109997.77,1,12.83,11.83,2.66
1373,0,12009685,0,0.00,109997.77,2,12044135,34450,12009685,0,0.00,80.11,109997.77,0,11.93,10.93,2.59
1374,0,12009685,0,0.00,109997.77,2,12046842,37157,12009685,0,0.00,80.06,109997.77,1,11.93,10.93,2.66
1375,0,12014859,5174,47.39,110045.16,2,12049429,34570,12014859,5174,47.39,80.03,110045.16,0,10.67,10.93,2.55
1376,0,12014859,0,0.00,110045.16,2,12051966,37107,12014859,0,0.00,79.97,110045.16,1,11.00,10.00,2.62
1377,0,12014859,0,0.00,110045.16,2,12054342,39483,12014859,0,0.00,79.92,110045.16,0,10.53,9.53,2.58
1378,0,12014859,0,0.00,110045.16,2,12056611,41752,12014859,0,0.00,79.86,110045.16,0,11.09,10.09,2.65
1379,0,12014859,0,0.00,110045.16,2,12058772,43913,12014859,0,0.00,79.80,110045.16,0,11.38,10.38,2.72
1380,0,12014859,0,0.00,110045.16,2,12060848,45989,12014859,0,0.00,79.74,110045.16,0,11.38,10.38,2.79
1381,0,12014859,0,0.00,110045.16,2,12062840,47981,12014859,0,0.00,79.69,110045.16,1,11.38,10.38,2.86
1382,0,12018497,3638,33.32,110078.48,2,12064659,46162,12018497,3638,33.32,79.65,110078.48,0,9.93,10.38,2.73
1383,0,12022229,3732,34.18,110112.66,2,12066525,44296,12022229,3732,34.18,79.62,110112.66,1,10.25,10.38,2.80
1384,0,12026061,3832,35.10,110147.75,2,12068441,42380,12026061,3832,35.10,79.59,110147.75,1,8.96,10.38,2.72
1385,0,12029865,3804,34.84,110182.59,2,12070343,40478,12029865,3804,34.84,79.55,110182.59,0,8.24,10.38,2.64
1386,0,12033649,3784,34.66,110217.25,2,12072235,38586,12033649,3784,34.66,79.52,110217.25,1,8.56,10.38,2.71
1387,0,12037445,3796,34.77,110252.02,2,12074133,36688,12037445,3796,34.77,79.49,110252.02,1,7.82,10.38,2.66
1388,0,12041223,3778,34.60,110286.62,2,12076022,34799,12041223,3778,34.60,79.46,110286.62,0,6.93,10.38,2.62
1389,0,12044973,3750,34.35,110320.97,2,12077897,32924,12044973,3750,34.35,79.42,110320.97,1,6.96,10.38,2.69
1390,0,12048717,3744,34.29,110355.26,2,12079769,31052,12048717,3744,34.29,79.39,110355.26,1,5.92,10.38,2.61
1391,0,12052521,3804,34.84,110390.10,2,12081671,29150,12052521,3804,34.84,79.36,110390.10,0,5.34,10.38,2.57
1392,0,12056393,3872,35.46,110425.56,2,12083607,27214,12056393,3872,35.46,79.33,110425.56,1,5.40,10.38,2.64
1393,0,12060257,3864,35.39,110460.95,2,12085539,25282,12060257,3864,35.39,79.30,110460.95,0,4.46,10.38,2.57
1394,0,12064139,3882,35.56,110496.52,2,12087480,23341,12064139,3882,35.56,79.27,110496.52,1,4.78,10.38,2.64
1395,0,12068311,4172,38.21,110534.73,2,12089566,21255,12068311,4172,38.21,79.24,110534.73,0,3.57,10.38,2.53
1396,0,12072747,4436,40.63,110575.35,2,12091784,19037,12072747,4436,40.63,79.21,110575.35,1,3.62,10.38,2.60
1397,0,12077559,4812,44.07,110619.43,2,12094190,16631,12077559,4812,44.07,79.18,110619.43,0,2.53,10.38,2.53
1398,0,12083067,5508,50.45,110669.88,2,12096944,13877,12083067,5508,50.45,79.16,110669.88,0,2.62,10.38,2.60
1399,0,12093141,10074,92.27,110762.14,2,12101981,8840,12093141,10074,92.27,79.17,110762.14,1,2.72,10.38,2.67
1400,0,12117239,24098,220.72,110982.86,2,12117239,0,12117239,24098,220.72,79.27,110982.86,0,0.93,10.38,2.51
1401,0,12151711,34472,315.73,111298.59,2,12151711,0,12151711,34472,315.73,79.44,111298.59,1,1.37,10.38,2.58
1402,0,12186259,34548,316.43,111615.02,2,12186259,0,12186259,34548,316.43,79.61,111615.02,0,1.66,10.38,2.52
1403,0,12220793,34534,316.30,111931.32,2,12220793,0,12220793,34534,316.30,79.78,111931.32,0,3.55,10.38,2.59
1404,0,12255282,34489,315.89,112247.21,2,12255282,0,12255282,34489,315.89,79.95,112247.21,1,4.53,10.38,2.66
1405,0,12290018,34736,318.15,112565.36,2,12290018,0,12290018,34736,318.15,80.12,112565.36,0,3.42,10.38,2.57
1406,0,12324562,34544,316.39,112881.75,2,12324562,0,12324562,34544,316.39,80.29,112881.75,1,5.11,10.38,2.64
1407,0,12356984,32422,296.96,113178.70,2,12356984,0,12356984,32422,296.96,80.44,113178.70,1,9.75,10.38,2.56
1408,0,12356984,0,0.00,113178.70,2,12367397,10413,12356984,0,0.00,80.38,113178.70,0,11.67,10.67,2.53
1409,0,12356984,0,0.00,113178.70,2,12373459,16475,12356984,0,0.00,80.33,113178.70,0,12.54,11.54,2.60
1410,0,12356984,0,0.00,113178.70,2,12377897,20913,12356984,0,0.00,80.27,113178.70,1,13.07,12.07,2.67
1411,0,12365378,8394,76.88,113255.59,2,12382094,16716,12365378,8394,76.88,80.27,113255.59,1,12.02,12.07,2.62
1412,0,12373424,8046,73.69,113329.28,2,12386117,12693,12373424,8046,73.69,80.26,113329.28,0,11.05,12.07,2.58
1413,0,12384762,11338,103.85,113433.12,2,12391786,7024,12384762,11338,103.85,80.28,113433.12,1,11.12,12.07,2.65
1414,0,12412679,27917,255.69,113688.82,2,12412679,0,12412679,27917,255.69,80.40,113688.82,1,10.16,12.07,2.58
1415,0,12444758,32079,293.81,113982.63,2,12444758,0,12444758,32079,293.81,80.55,113982.63,0,10.06,12.07,2.57
1416,0,12476407,31649,289.88,114272.51,2,12476407,0,12476407,31649,289.88,80.70,114272.51,1,11.02,12.07,2.64
1417,0,12507319,30912,283.13,114555.64,2,12507319,0,12507319,30912,283.13,80.84,114555.64,0,11.66,12.07,2.57
1418,0,12507319,0,0.00,114555.64,2,12517489,10170,12507319,0,0.00,80.79,114555.64,0,13.65,12.65,2.64
1419,0,12507319,0,0.00,114555.64,2,12523195,15876,12507319,0,0.00,80.73,114555.64,0,15.09,14.09,2.70
1420,0,12507319,0,0.00,114555.64,2,12527397,20078,12507319,0,0.00,80.67,114555.64,1,15.66,14.66,2.77
1421,0,12507319,0,0.00,114555.64,2,12531055,23736,12507319,0,0.00,80.62,114555.64,1,15.15,14.15,2.69
1422,0,12507319,0,0.00,114555.64,2,12534367,27048,12507319,0,0.00,80.56,114555.64,0,14.55,13.55,2.63
1423,0,12507319,0,0.00,114555.64,2,12537450,30131,12507319,0,0.00,80.50,114555.64,1,14.55,13.55,2.70
1424,0,12513305,5986,54.83,114610.46,2,12540443,27138,12513305,5986,54.83,80.48,114610.46,1,13.19,13.55,2.58
1425,0,12519301,5996,54.92,114665.38,2,12543441,24140,12519301,5996,54.92,80.47,114665.38,0,13.13,13.55,2.57
1426,0,12519301,0,0.00,114665.38,2,12546063,26762,12519301,0,0.00,80.41,114665.38,1,13.76,12.76,2.64
1427,0,12519301,0,0.00,114665.38,2,12548589,29288,12519301,0,0.00,80.35,114665.38,0,13.00,12.00,2.55
1428,0,12519301,0,0.00,114665.38,2,12550918,31617,12519301,0,0.00,80.30,114665.38,1,13.00,12.00,2.62
1429,0,12523837,4536,41.55,114706.93,2,12553186,29349,12523837,4536,41.55,80.27,114706.93,0,11.74,12.00,2.52
1430,0,12528443,4606,42.19,114749.12,2,12555489,27046,12528443,4606,42.19,80.24,114749.12,1,11.78,12.00,2.59
1431,0,12533151,4708,43.12,114792.23,2,12557843,24692,12533151,4708,43.12,80.22,114792.23,0,10.49,12.00,2.51
1432,0,12537709,4558,41.75,114833.98,2,12560122,22413,12537709,4558,41.75,80.19,114833.98,1,10.53,12.00,2.58
1433,0,12542331,4622,42.33,114876.31,2,12562433,20102,12542331,4622,42.33,80.16,114876.31,0,9.56,12.00,2.43
1434,0,12547143,4812,44.07,114920.39,2,12564839,17696,12547143,4812,44.07,80.14,114920.39,1,9.97,12.00,2.49
1435,0,12552607,5464,50.05,114970.44,2,12567571,14964,12552607,5464,50.05,80.12,114970.44,0,9.43,12.00,2.42
1436,0,12561447,8840,80.97,115051.40,2,12571991,10544,12561447,8840,80.97,80.12,115051.40,0,9.77,12.00,2.49
1437,0,12580221,18774,171.95,115223.35,2,12581378,1157,12580221,18774,171.95,80.18,115223.35,1,10.04,12.00,2.56
1438,0,12613031,32810,300.51,115523.86,2,12613031,0,12613031,32810,300.51,80.34,115523.86,0,8.88,12.00,2.38
1439,0,12644500,31469,288.23,115812.09,2,12644500,0,12644500,31469,288.23,80.48,115812.09,0,11.69,12.00,2.44
1440,0,12644500,0,0.00,115812.09,2,12654822,10322,12644500,0,0.00,80.43,115812.09,1,13.65,12.65,2.51
1441,0,12644500,0,0.00,115812.09,2,12660516,16016,12644500,0,0.00,80.37,115812.09,0,14.02,13.02,2.45
1442,0,12644500,0,0.00,115812.09,2,12664877,20377,12644500,0,0.00,80.31,115812.09,1,14.32,13.32,2.52
1443,0,12652586,8086,74.06,115886.15,2,12668920,16334,12652586,8086,74.06,80.31,115886.15,0,13.11,13.32,2.39
1444,0,12652586,0,0.00,115886.15,2,12672566,19980,12652586,0,0.00,80.25,115886.15,1,13.58,12.58,2.46
1445,0,12659180,6594,60.40,115946.55,2,12675863,16683,12659180,6594,60.40,80.24,115946.55,1,11.52,12.58,2.24
1446,0,12666384,7204,65.98,116012.53,2,12679465,13081,12666384,7204,65.98,80.23,116012.53,0,11.20,12.58,2.27
1447,0,12678652,12268,112.36,116124.89,2,12685599,6947,12678652,12268,112.36,80.25,116124.89,1,11.39,12.58,2.34
1448,0,12705432,26780,245.28,116370.17,2,12705432,0,12705432,26780,245.28,80.37,116370.17,0,10.56,12.58,2.27
1449,0,12736854,31422,287.80,116657.97,2,12736854,0,12736854,31422,287.80,80.51,116657.97,1,11.81,12.58,2.34
1450,0,12768339,31485,288.37,116946.34,2,12768339,0,12768339,31485,288.37,80.65,116946.34,1,11.26,12.58,2.25
1451,0,12799509,31170,285.49,117231.83,2,12799509,0,12799509,31170,285.49,80.79,117231.83,0,12.28,12.58,2.21
1452,0,12799509,0,0.00,117231.83,2,12809803,10294,12799509,0,0.00,80.74,117231.83,1,15.21,14.21,2.28
1453,0,12799509,0,0.00,117231.83,2,12815409,15900,12799509,0,0.00,80.68,117231.83,0,15.23,14.23,2.19
1454,0,12799509,0,0.00,117231.83,2,12819580,20071,12799509,0,0.00,80.63,117231.83,1,15.51,14.51,2.26
1455,0,12799509,0,0.00,117231.83,2,12823098,23589,12799509,0,0.00,80.57,117231.83,0,15.19,14.19,2.19
1456,0,12799509,0,0.00,117231.83,2,12826304,26795,12799509,0,0.00,80.52,117231.83,1,15.26,14.26,2.26
1457,0,12805579,6070,55.60,117287.43,2,12829339,23760,12805579,6070,55.60,80.50,117287.43,0,13.89,14.26,2.17
1458,0,12811585,6006,55.01,117342.44,2,12832342,20757,12811585,6006,55.01,80.48,117342.44,0,13.95,14.26,2.24
1459,0,12817539,5954,54.53,117396.97,2,12835319,17780,12817539,5954,54.53,80.46,117396.97,0,14.00,14.26,2.31
1460,0,12823799,6260,57.34,117454.30,2,12838449,14650,12823799,6260,57.34,80.45,117454.30,1,14.05,14.26,2.38
1461,0,12831007,7208,66.02,117520.32,2,12842053,11046,12831007,7208,66.02,80.44,117520.32,0,12.48,14.26,2.27
1462,0,12847713,16706,153.01,117673.34,2,12850406,2693,12847713,16706,153.01,80.49,117673.34,1,12.54,14.26,2.33
1463,0,12878827,31114,284.98,117958.31,2,12878827,0,12878827,31114,284.98,80.63,117958.31,0,12.13,14.26,2.26
1464,0,12910532,31705,290.39,118248.70,2,12910532,0,12910532,31705,290.39,80.77,118248.70,1,13.91,14.26,2.33
1465,0,12941259,30727,281.43,118530.13,2,12941259,0,12941259,30727,281.43,80.91,118530.13,1,13.73,14.26,2.22
1466,0,12941259,0,0.00,118530.13,2,12951359,10100,12941259,0,0.00,80.85,118530.13,1,14.59,13.59,2.15
1467,0,12941259,0,0.00,118530.13,2,12957050,15791,12941259,0,0.00,80.80,118530.13,0,14.29,13.29,2.11
1468,0,12941259,0,0.00,118530.13,2,12961197,19938,12941259,0,0.00,80.74,118530.13,0,14.94,13.94,2.18
1469,0,12941259,0,0.00,118530.13,2,12964777,23518,12941259,0,0.00,80.69,118530.13,0,14.94,13.94,2.25
1470,0,12941259,0,0.00,118530.13,2,12968006,26747,12941259,0,0.00,80.63,118530.13,1,15.01,14.01,2.31
1471,0,12947491,6232,57.08,118587.21,2,12971122,23631,12947491,6232,57.08,80.62,118587.21,1,13.43,14.01,2.21
1472,0,12953939,6448,59.06,118646.27,2,12974346,20407,12953939,6448,59.06,80.60,118646.27,0,12.68,14.01,2.12
1473,0,12960531,6592,60.38,118706.65,2,12977642,17111,12960531,6592,60.38,80.59,118706.65,1,13.81,14.01,2.19
1474,0,12967057,6526,59.77,118766.41,2,12980905,13848,12967057,6526,59.77,80.57,118766.41,0,13.40,14.01,2.12
1475,0,12975123,8066,73.88,118840.30,2,12984938,9815,12975123,8066,73.88,80.57,118840.30,1,13.45,14.01,2.19
1476,0,12995941,20818,190.67,119030.97,2,12995941,0,12995941,20818,190.67,80.64,119030.97,1,12.41,14.01,2.14
1477,0,13028161,32220,295.11,119326.08,2,13028161,0,13028161,32220,295.11,80.79,119326.08,0,12.04,14.01,2.07
1478,0,13059698,31537,288.85,119614.92,2,13059698,0,13059698,31537,288.85,80.93,119614.92,1,13.97,14.01,2.13
1479,0,13059698,0,0.00,119614.92,2,13069871,10173,13059698,0,0.00,80.88,119614.92,0,14.52,13.52,2.11
1480,0,13059698,0,0.00,119614.92,2,13075612,15914,13059698,0,0.00,80.82,119614.92,1,15.50,14.50,2.17
1481,0,13059698,0,0.00,119614.92,2,13079798,20100,13059698,0,0.00,80.77,119614.92,0,16.04,15.04,2.08
1482,0,13059698,0,0.00,119614.92,2,13083360,23662,13059698,0,0.00,80.71,119614.92,1,16.23,15.23,2.15
1483,0,13059698,0,0.00,119614.92,2,13086572,26874,13059698,0,0.00,80.66,119614.92,0,15.58,14.58,2.09
1484,0,13059698,0,0.00,119614.92,2,13089330,29632,13059698,0,0.00,80.60,119614.92,1,15.84,14.84,2.16
1485,0,13065202,5504,50.41,119665.34,2,13092082,26880,13065202,5504,50.41,80.58,119665.34,0,14.62,14.84,2.06
1486,0,13065202,0,0.00,119665.34,2,13094840,29638,13065202,0,0.00,80.53,119665.34,1,14.90,13.90,2.12
1487,0,13070500,5298,48.52,119713.86,2,13097489,26989,13070500,5298,48.52,80.51,119713.86,0,13.47,13.90,2.01
1488,0,13075720,5220,47.81,119761.67,2,13100099,24379,13075720,5220,47.81,80.48,119761.67,1,13.51,13.90,2.07
1489,0,13080896,5176,47.41,119809.08,2,13102687,21791,13080896,5176,47.41,80.46,119809.08,0,11.83,13.90,1.92
1490,0,13086028,5132,47.00,119856.09,2,13105253,19225,13086028,5132,47.00,80.44,119856.09,1,12.17,13.90,1.99
1491,0,13091336,5308,48.62,119904.70,2,13107907,16571,13091336,5308,48.62,80.42,119904.70,0,10.54,13.90,1.85
1492,0,13097152,5816,53.27,119957.97,2,13110815,13663,13097152,5816,53.27,80.40,119957.97,1,11.34,13.90,1.91
1493,0,13108184,11032,101.04,120059.02,2,13116331,8147,13108184,11032,101.04,80.41,120059.02,0,9.92,13.90,1.82
1494,0,13131811,23627,216.40,120275.41,2,13131811,0,13131811,23627,216.40,80.51,120275.41,1,10.19,13.90,1.88
1495,0,13164651,32840,300.78,120576.20,2,13164651,0,13164651,32840,300.78,80.65,120576.20,0,8.96,13.90,1.77
1496,0,13196332,31681,290.17,120866.37,2,13196332,0,13196332,31681,290.17,80.79,120866.37,1,10.45,13.90,1.84
1497,0,13228774,32442,297.14,121163.51,2,13228774,0,13228774,32442,297.14,80.94,121163.51,0,9.73,13.90,1.69
1498,0,13260295,31521,288.70,121452.21,2,13260295,0,13260295,31521,288.70,81.08,121452.21,0,11.82,13.90,1.76
1499,0,13260295,0,0.00,121452.21,2,13270480,10185,13260295,0,0.00,81.02,121452.21,1,15.18,14.18,1.83
1500,0,13260295,0,0.00,121452.21,2,13275995,15700,13260295,0,0.00,80.97,121452.21,0,14.29,13.29,1.72
1501,0,13260295,0,0.00,121452.21,2,13280117,19822,13260295,0,0.00,80.91,121452.21,1,14.74,13.74,1.79
1502,0,13267795,7500,68.69,121520.91,2,13283867,16072,13267795,7500,68.69,80.91,121520.91,0,12.72,13.74,1.63
1503,0,13276175,8380,76.75,121597.66,2,13288057,11882,13276175,8380,76.75,80.90,121597.66,1,12.79,13.74,1.69
1504,0,13289713,13538,124.00,121721.66,2,13294826,5113,13289713,13538,124.00,80.93,121721.66,0,10.89,13.74,1.55
1505,0,13317364,27651,253.26,121974.91,2,13317364,0,13317364,27651,253.26,81.05,121974.91,1,11.38,13.74,1.62
1506,0,13348907,31543,288.91,122263.81,2,13348907,0,13348907,31543,288.91,81.18,122263.81,1,11.51,13.74,1.56
1507,0,13380263,31356,287.19,122551.01,2,13380263,0,13380263,31356,287.19,81.32,122551.01,0,12.12,13.74,1.43
1508,0,13380263,0,0.00,122551.01,2,13390477,10214,13380263,0,0.00,81.27,122551.01,1,13.89,12.89,1.50
1509,0,13380263,0,0.00,122551.01,2,13396204,15941,13380263,0,0.00,81.21,122551.01,0,13.43,12.43,1.39
1510,0,13380263,0,0.00,122551.01,2,13400329,20066,13380263,0,0.00,81.16,122551.01,1,14.11,13.11,1.46
1511,0,13388235,7972,73.02,122624.02,2,13404315,16080,13388235,7972,73.02,81.15,122624.02,0,12.76,13.11,1.34
1512,0,13396495,8260,75.65,122699.68,2,13408445,11950,13396495,8260,75.65,81.15,122699.68,1,12.88,13.11,1.40
1513,0,13409985,13490,123.56,122823.23,2,13415190,5205,13409985,13490,123.56,81.18,122823.23,0,11.49,13.11,1.28
1514,0,13438582,28597,261.92,123085.16,2,13438582,0,13438582,28597,261.92,81.30,123085.16,1,11.82,13.11,1.35
1515,0,13470784,32202,294.94,123380.10,2,13470784,0,13470784,32202,294.94,81.44,123380.10,0,10.08,13.11,1.18
1516,0,13502341,31557,289.03,123669.13,2,13502341,0,13502341,31557,289.03,81.58,123669.13,1,11.87,13.11,1.25
1517,0,13534112,31771,290.99,123960.12,2,13534112,0,13534112,31771,290.99,81.71,123960.12,0,11.57,13.11,1.15
1518,0,13565591,31479,288.32,124248.45,2,13565591,0,13565591,31479,288.32,81.85,124248.45,0,11.85,13.11,1.22
1519,0,13565591,0,0.00,124248.45,2,13575751,10160,13565591,0,0.00,81.80,124248.45,1,13.44,12.44,1.28
1520,0,13565591,0,0.00,124248.45,2,13581248,15657,13565591,0,0.00,81.74,124248.45,0,14.15,13.15,1.13
1521,0,13565591,0,0.00,124248.45,2,13585548,19957,13565591,0,0.00,81.69,124248.45,1,14.15,13.15,1.20
1522,0,13573321,7730,70.80,124319.24,2,13589413,16092,13573321,7730,70.80,81.68,124319.24,0,12.34,13.15,1.07
1523,0,13573321,0,0.00,124319.24,2,13593133,19812,13573321,0,0.00,81.63,124319.24,1,13.69,12.69,1.13
1524,0,13580065,6744,61.77,124381.02,2,13596505,16440,13580065,6744,61.77,81.61,124381.02,1,12.42,12.69,1.02
1525,0,13587491,7426,68.02,124449.03,2,13600218,12727,13587491,7426,68.02,81.61,124449.03,0,11.01,12.69,0.93
1526,0,13598921,11430,104.69,124553.72,2,13605933,7012,13598921,11430,104.69,81.62,124553.72,1,12.23,12.69,1.00
1527,0,13625382,26461,242.36,124796.08,2,13625382,0,13625382,26461,242.36,81.73,124796.08,0,11.59,12.69,0.88
1528,0,13625382,0,0.00,124796.08,2,13635780,10398,13625382,0,0.00,81.67,124796.08,1,13.34,12.34,0.94
1529,0,13625382,0,0.00,124796.08,2,13641563,16181,13625382,0,0.00,81.62,124796.08,0,12.77,11.77,0.82
1530,0,13625382,0,0.00,124796.08,2,13646050,20668,13625382,0,0.00,81.57,124796.08,1,13.03,12.03,0.89
1531,0,13633910,8528,78.11,124874.18,2,13650314,16404,13633910,8528,78.11,81.56,124874.18,0,11.27,12.03,0.71
1532,0,13642896,8986,82.30,124956.48,2,13654807,11911,13642896,8986,82.30,81.56,124956.48,1,11.76,12.03,0.78
1533,0,13656686,13790,126.30,125082.79,2,13661702,5016,13656686,13790,126.30,81.59,125082.79,0,11.06,12.03,0.68
1534,0,13685472,28786,263.65,125346.45,2,13685472,0,13685472,28786,263.65,81.71,125346.45,0,11.89,12.03,0.74
1535,0,13685472,0,0.00,125346.45,2,13696180,10708,13685472,0,0.00,81.66,125346.45,1,13.71,12.71,0.81
1536,0,13703634,18162,166.35,125512.79,2,13705261,1627,13703634,18162,166.35,81.71,125512.79,0,12.28,12.71,0.59
1537,0,13703634,0,0.00,125512.79,2,13714443,10809,13703634,0,0.00,81.66,125512.79,1,12.85,11.85,0.65
1538,0,13721390,17756,162.63,125675.42,2,13723321,1931,13721390,17756,162.63,81.71,125675.42,0,11.63,11.85,0.56
1539,0,13721390,0,0.00,125675.42,2,13731995,10605,13721390,0,0.00,81.66,125675.42,0,12.41,11.41,0.63
1540,0,13721390,0,0.00,125675.42,2,13737345,15955,13721390,0,0.00,81.61,125675.42,0,12.75,11.75,0.69
1541,0,13721390,0,0.00,125675.42,2,13740721,19331,13721390,0,0.00,81.55,125675.42,1,13.02,12.02,0.76
1542,0,13727910,6520,59.72,125735.14,2,13743981,16071,13727910,6520,59.72,81.54,125735.14,0,10.76,12.02,0.59
1543,0,13737280,9370,85.82,125820.96,2,13748666,11386,13737280,9370,85.82,81.54,125820.96,1,10.82,12.02,0.65
1544,0,13754898,17618,161.36,125982.32,2,13757475,2577,13754898,17618,161.36,81.59,125982.32,0,9.93,12.02,0.52
1545,0,13786097,31199,285.75,126268.08,2,13786097,0,13786097,31199,285.75,81.73,126268.08,1,10.09,12.02,0.59
1546,0,13817256,31159,285.39,126553.47,2,13817256,0,13817256,31159,285.39,81.86,126553.47,1,11.83,12.02,0.50
1547,0,13817256,0,0.00,126553.47,2,13827421,10165,13817256,0,0.00,81.81,126553.47,1,14.60,13.60,0.44
1548,0,13817256,0,0.00,126553.47,2,13833035,15779,13817256,0,0.00,81.75,126553.47,0,14.22,13.22,0.38
1549,0,13817256,0,0.00,126553.47,2,13837287,20031,13817256,0,0.00,81.70,126553.47,1,14.80,13.80,0.45
1550,0,13817256,0,0.00,126553.47,2,13840915,23659,13817256,0,0.00,81.65,126553.47,0,13.87,12.87,0.36
1551,0,13817256,0,0.00,126553.47,2,13844266,27010,13817256,0,0.00,81.59,126553.47,1,14.44,13.44,0.42
1552,0,13823626,6370,58.34,126611.81,2,13847451,23825,13823626,6370,58.34,81.58,126611.81,1,13.43,13.44,0.37
1553,0,13830014,6388,58.51,126670.32,2,13850645,20631,13830014,6388,58.51,81.56,126670.32,0,12.35,13.44,0.29
1554,0,13836272,6258,57.32,126727.63,2,13853774,17502,13836272,6258,57.32,81.55,126727.63,1,12.43,13.44,0.36
1555,0,13842448,6176,56.57,126784.20,2,13856862,14414,13842448,6176,56.57,81.53,126784.20,0,11.23,13.44,0.29
1556,0,13849680,7232,66.24,126850.44,2,13860478,10798,13849680,7232,66.24,81.52,126850.44,1,11.33,13.44,0.35
1557,0,13867546,17866,163.64,127014.08,2,13869411,1865,13867546,17866,163.64,81.58,127014.08,0,10.13,13.44,0.28
1558,0,13899078,31532,288.80,127302.88,2,13899078,0,13899078,31532,288.80,81.71,127302.88,0,10.78,13.44,0.34
1559,0,13930254,31176,285.54,127588.42,2,13930254,0,13930254,31176,285.54,81.84,127588.42,0,12.22,13.44,0.41
1560,0,13930254,0,0.00,127588.42,2,13940459,10205,13930254,0,0.00,81.79,127588.42,0,13.60,12.60,0.47
1561,0,13930254,0,0.00,127588.42,2,13946154,15900,13930254,0,0.00,81.74,127588.42,1,14.09,13.09,0.53
1562,0,13940128,9874,90.44,127678.86,2,13951091,10963,13940128,9874,90.44,81.74,127678.86,1,12.70,13.09,0.43
1563,0,13956500,16372,149.95,127828.81,2,13959277,2777,13956500,16372,149.95,81.78,127828.81,0,11.54,13.09,0.34
1564,0,13987827,31327,286.93,128115.74,2,13987827,0,13987827,31327,286.93,81.92,128115.74,0,12.43,13.09,0.40
1565,0,13987827,0,0.00,128115.74,2,13998265,10438,13987827,0,0.00,81.86,128115.74,1,13.89,12.89,0.47
1566,0,13987827,0,0.00,128115.74,2,14004126,16299,13987827,0,0.00,81.81,128115.74,1,12.99,11.99,0.33
1567,0,13987827,0,0.00,128115.74,2,14008538,20711,13987827,0,0.00,81.76,128115.74,1,12.40,11.40,0.24
1568,0,13995905,8078,73.99,128189.73,2,14012577,16672,13995905,8078,73.99,81.75,128189.73,0,11.26,11.40,0.19
1569,0,14004043,8138,74.54,128264.27,2,14016646,12603,14004043,8138,74.54,81.75,128264.27,1,11.33,11.40,0.26
1570,0,14014719,10676,97.78,128362.05,2,14021984,7265,14014719,10676,97.78,81.76,128362.05,1,10.52,11.40,0.18
1571,0,14041099,26380,241.62,128603.66,2,14041099,0,14041099,26380,241.62,81.86,128603.66,0,9.50,11.40,0.10
1572,0,14073051,31952,292.65,128896.31,2,14073051,0,14073051,31952,292.65,82.00,128896.31,1,10.59,11.40,0.17
1573,0,14105090,32039,293.45,129189.77,2,14105090,0,14105090,32039,293.45,82.13,129189.77,0,10.27,11.40,0.08
1574,0,14105090,0,0.00,129189.77,2,14115360,10270,14105090,0,0.00,82.08,129189.77,1,12.79,11.79,0.15
1575,0,14105090,0,0.00,129189.77,2,14121068,15978,14105090,0,0.00,82.03,129189.77,0,12.58,11.58,0.04
1576,0,14105090,0,0.00,129189.77,2,14125412,20322,14105090,0,0.00,81.97,129189.77,1,12.66,11.66,0.11
1577,0,14113288,8198,75.09,129264.85,2,14129511,16223,14113288,8198,75.09,81.97,129264.85,0,11.30,11.66,0.11
1578,0,14121604,8316,76.17,129341.02,2,14133669,12065,14121604,8316,76.17,81.97,129341.02,0,11.38,11.66,0.06
1579,0,14121604,0,0.00,129341.02,2,14137574,15970,14121604,0,0.00,81.91,129341.02,0,11.71,10.71,0.13
1580,0,14121604,0,0.00,129341.02,2,14140720,19116,14121604,0,0.00,81.86,129341.02,1,11.74,10.74,0.19
1581,0,14127472,5868,53.75,129394.76,2,14143654,16182,14127472,5868,53.75,81.84,129394.76,0,10.63,10.74,0.10
1582,0,14135346,7874,72.12,129466.88,2,14147591,12245,14135346,7874,72.12,81.84,129466.88,1,10.68,10.74,0.17
1583,0,14152398,17052,156.18,129623.06,2,14156117,3719,14152398,17052,156.18,81.88,129623.06,0,8.52,10.74,0.01
1584,0,14183761,31363,287.26,129910.32,2,14183761,0,14183761,31363,287.26,82.01,129910.32,1,8.96,10.74,0.07
1585,0,14215937,32176,294.70,130205.02,2,14215937,0,14215937,32176,294.70,82.15,130205.02,1,9.27,10.74,0.07
1586,0,14248286,32349,296.29,130501.30,2,14248286,0,14248286,32349,296.29,82.28,130501.30,0,9.56,10.74,0.06
1587,0,14248286,0,0.00,130501.30,2,14258595,10309,14248286,0,0.00,82.23,130501.30,1,12.04,11.04,0.13
1588,0,14248286,0,0.00,130501.30,2,14264305,16019,14248286,0,0.00,82.18,130501.30,0,11.30,10.30,0.04
1589,0,14248286,0,0.00,130501.30,2,14268620,20334,14248286,0,0.00,82.13,130501.30,1,11.72,10.72,0.10
1590,0,14256070,7784,71.29,130572.60,2,14272512,16442,14256070,7784,71.29,82.12,130572.60,0,10.17,10.72,0.10
1591,0,14263902,7832,71.73,130644.34,2,14276428,12526,14263902,7832,71.73,82.11,130644.34,1,10.24,10.72,0.06
1592,0,14274552,10650,97.54,130741.88,2,14281753,7201,14274552,10650,97.54,82.12,130741.88,1,8.18,10.72,0.06
1593,0,14301740,27188,249.02,130990.90,2,14301740,0,14301740,27188,249.02,82.23,130990.90,0,8.28,10.72,0.06
1594,0,14334409,32669,299.22,131290.11,2,14334409,0,14334409,32669,299.22,82.37,131290.11,1,9.67,10.72,0.13
1595,0,14366953,32544,298.07,131588.19,2,14366953,0,14366953,32544,298.07,82.50,131588.19,0,9.28,10.72,0.02
1596,0,14366953,0,0.00,131588.19,2,14377325,10372,14366953,0,0.00,82.45,131588.19,1,10.83,9.83,0.08
1597,0,14366953,0,0.00,131588.19,2,14382856,15903,14366953,0,0.00,82.40,131588.19,0,10.70,9.70,0.08
1598,0,14366953,0,0.00,131588.19,2,14386929,19976,14366953,0,0.00,82.35,131588.19,0,10.70,9.70,0.06
1599,0,14366953,0,0.00,131588.19,2,14390565,23612,14366953,0,0.00,82.29,131588.19,0,11.03,10.03,0.13
1600,0,14366953,0,0.00,131588.19,2,14393868,26915,14366953,0,0.00,82.24,131588.19,1,12.01,11.01,0.19
1601,0,14373225,6272,57.45,131645.64,2,14397004,23779,14373225,6272,57.45,82.23,131645.64,0,10.48,11.01,0.07
1602,0,14379395,6170,56.51,131702.14,2,14400089,20694,14379395,6170,56.51,82.21,131702.14,1,10.60,11.01,0.13
1603,0,14385513,6118,56.04,131758.19,2,14403148,17635,14385513,6118,56.04,82.19,131758.19,1,9.75,11.01,0.05
1604,0,14392007,6494,59.48,131817.66,2,14406395,14388,14392007,6494,59.48,82.18,131817.66,0,8.90,11.01,0.05
1605,0,14399559,7552,69.17,131886.83,2,14410171,10612,14399559,7552,69.17,82.17,131886.83,1,8.96,11.01,0.06
1606,0,14418121,18562,170.01,132056.84,2,14419452,1331,14418121,18562,170.01,82.23,132056.84,1,8.32,11.01,0.00
1607,0,14451289,33168,303.79,132360.62,2,14451289,0,14451289,33168,303.79,82.37,132360.62,0,8.29,11.01,0.00
1608,0,14484436,33147,303.60,132664.22,2,14484436,0,14484436,33147,303.60,82.50,132664.22,1,8.59,11.01,0.06
1609,0,14517426,32990,302.16,132966.39,2,14517426,0,14517426,32990,302.16,82.64,132966.39,0,10.36,11.01,0.06
1610,0,14549938,32512,297.78,133264.17,2,14549938,0,14549938,32512,297.78,82.77,133264.17,1,10.66,11.01,0.06
1611,0,14549938,0,0.00,133264.17,2,14560207,10269,14549938,0,0.00,82.72,133264.17,0,12.78,11.78,0.06
1612,0,14549938,0,0.00,133264.17,2,14565698,15760,14549938,0,0.00,82.67,133264.17,1,12.78,11.78,0.06
1613,0,14549938,0,0.00,133264.17,2,14569950,20012,14549938,0,0.00,82.62,133264.17,0,12.34,11.34,0.06
1614,0,14549938,0,0.00,133264.17,2,14573546,23608,14549938,0,0.00,82.57,133264.17,1,12.34,11.34,0.06
1615,0,14553603,3665,33.57,133297.73,2,14576890,23287,14553603,3665,33.57,82.54,133297.73,0,11.36,10.36,0.06
1616,0,14553603,0,0.00,133297.73,2,14580054,26451,14553603,0,0.00,82.49,133297.73,1,11.39,10.39,0.06
1617,0,14559557,5954,54.53,133352.27,2,14583031,23474,14559557,5954,54.53,82.47,133352.27,0,10.20,10.39,0.06
1618,0,14565423,5866,53.73,133406.00,2,14585964,20541,14565423,5866,53.73,82.45,133406.00,0,10.25,10.39,0.06
1619,0,14571453,6030,55.23,133461.22,2,14588979,17526,14571453,6030,55.23,82.43,133461.22,0,10.30,10.39,0.12
1620,0,14571453,0,0.00,133461.22,2,14591849,20396,14571453,0,0.00,82.38,133461.22,1,10.51,9.51,0.19
1621,0,14576621,5168,47.33,133508.56,2,14594433,17812,14576621,5168,47.33,82.36,133508.56,1,9.11,9.51,0.10
1622,0,14582747,6126,56.11,133564.67,2,14597496,14749,14582747,6126,56.11,82.35,133564.67,0,7.85,9.51,0.10
1623,0,14592467,9720,89.03,133653.69,2,14602356,9889,14592467,9720,89.03,82.35,133653.69,1,7.91,9.51,0.06
1624,0,14614966,22499,206.07,133859.77,2,14614966,0,14614966,22499,206.07,82.43,133859.77,1,6.49,9.51,0.06
1625,0,14648956,33990,311.32,134171.08,2,14648956,0,14648956,33990,311.32,82.57,134171.08,0,6.69,9.51,0.06
1626,0,14682023,33067,302.86,134473.94,2,14682023,0,14682023,33067,302.86,82.70,134473.94,1,9.12,9.51,0.12
1627,0,14682023,0,0.00,134473.94,2,14692657,10634,14682023,0,0.00,82.65,134473.94,0,9.58,8.58,0.02
1628,0,14682023,0,0.00,134473.94,2,14698290,16267,14682023,0,0.00,82.60,134473.94,1,10.44,9.44,0.08
1629,0,14682023,0,0.00,134473.94,2,14702745,20722,14682023,0,0.00,82.55,134473.94,0,10.13,9.13,0.08
1630,0,14682023,0,0.00,134473.94,2,14706512,24489,14682023,0,0.00,82.50,134473.94,1,10.13,9.13,0.06
1631,0,14689141,7118,65.19,134539.14,2,14710071,20930,14689141,7118,65.19,82.49,134539.14,0,8.74,9.13,0.06
1632,0,14696395,7254,66.44,134605.58,2,14713698,17303,14696395,7254,66.44,82.48,134605.58,1,8.80,9.13,0.06
1633,0,14703651,7256,66.46,134672.03,2,14717326,13675,14703651,7256,66.46,82.47,134672.03,0,6.81,9.13,0.06
1634,0,14712209,8558,78.38,134750.42,2,14721605,9396,14712209,8558,78.38,82.47,134750.42,1,6.88,9.13,0.06
1635,0,14733976,21767,199.37,134949.78,2,14733976,0,14733976,21767,199.37,82.54,134949.78,0,6.23,9.13,0.06
1636,0,14768338,34362,314.72,135264.52,2,14768338,0,14768338,34362,314.72,82.68,135264.52,1,6.43,9.13,0.06
1637,0,14801762,33424,306.13,135570.64,2,14801762,0,14801762,33424,306.13,82.82,135570.64,0,7.09,9.13,0.06
1638,0,14835196,33434,306.22,135876.88,2,14835196,0,14835196,33434,306.22,82.95,135876.88,0,7.39,9.13,0.06
1639,0,14835196,0,0.00,135876.88,2,14845891,10695,14835196,0,0.00,82.90,135876.88,0,10.26,9.26,0.12
1640,0,14835196,0,0.00,135876.88,2,14851472,16276,14835196,0,0.00,82.85,135876.88,1,12.91,11.91,0.18
1641,0,14845340,10144,92.91,135969.78,2,14856544,11204,14845340,10144,92.91,82.86,135969.78,0,11.36,11.91,0.18
1642,0,14861650,16310,149.38,136119.16,2,14864699,3049,14861650,16310,149.38,82.90,136119.16,1,11.45,11.91,0.06
1643,0,14892702,31052,284.41,136403.56,2,14892702,0,14892702,31052,284.41,83.02,136403.56,0,10.71,11.91,0.06
1644,0,14924353,31651,289.89,136693.47,2,14924353,0,14924353,31651,289.89,83.15,136693.47,1,10.99,11.91,0.06
1645,0,14956027,31674,290.10,136983.56,2,14956027,0,14956027,31674,290.10,83.27,136983.56,0,11.82,11.91,0.06
1646,0,14956027,0,0.00,136983.56,2,14966420,10393,14956027,0,0.00,83.22,136983.56,1,12.10,11.10,0.06
1647,0,14956027,0,0.00,136983.56,2,14972418,16391,14956027,0,0.00,83.17,136983.56,0,12.35,11.35,0.06
1648,0,14956027,0,0.00,136983.56,2,14976749,20722,14956027,0,0.00,83.12,136983.56,1,12.35,11.35,0.06
1649,0,14956027,0,0.00,136983.56,2,14980354,24327,14956027,0,0.00,83.07,136983.56,0,12.21,11.21,0.06
1650,0,14956027,0,0.00,136983.56,2,14983731,27704,14956027,0,0.00,83.02,136983.56,1,12.21,11.21,0.06
1651,0,14962399,6372,58.36,137041.94,2,14986917,24518,14962399,6372,58.36,83.01,137041.94,1,9.86,11.21,0.06
1652,0,14968791,6392,58.54,137100.47,2,14990113,21322,14968791,6392,58.54,82.99,137100.47,0,9.92,11.21,0.06
1653,0,14975051,6260,57.34,137157.81,2,14993243,18192,14975051,6260,57.34,82.98,137157.81,1,10.27,11.21,0.12
1654,0,14981219,6168,56.49,137214.31,2,14996327,15108,14981219,6168,56.49,82.96,137214.31,0,9.16,11.21,0.04
1655,0,14987963,6744,61.77,137276.08,2,14999699,11736,14987963,6744,61.77,82.95,137276.08,1,10.04,11.21,0.10
1656,0,15003539,15576,142.66,137418.73,2,15007487,3948,15003539,15576,142.66,82.98,137418.73,0,9.25,11.21,0.06
1657,0,15034274,30735,281.50,137700.23,2,15034274,0,15034274,30735,281.50,83.10,137700.23,1,9.68,11.21,0.12
1658,0,15067041,32767,300.12,138000.36,2,15067041,0,15067041,32767,300.12,83.23,138000.36,0,9.41,11.21,0.04
1659,0,15099066,32025,293.32,138293.67,2,15099066,0,15099066,32025,293.32,83.36,138293.67,0,10.89,11.21,0.10
1660,0,15099066,0,0.00,138293.67,2,15109497,10431,15099066,0,0.00,83.31,138293.67,1,13.01,12.01,0.16
1661,0,15099066,0,0.00,138293.67,2,15115027,15961,15099066,0,0.00,83.26,138293.67,0,12.54,11.54,0.10
1662,0,15099066,0,0.00,138293.67,2,15119358,20292,15099066,0,0.00,83.21,138293.67,1,13.11,12.11,0.16
1663,0,15106906,7840,71.81,138365.48,2,15123278,16372,15106906,7840,71.81,83.20,138365.48,1,11.72,12.11,0.09
1664,0,15115450,8544,78.26,138443.73,2,15127550,12100,15115450,8544,78.26,83.20,138443.73,0,11.28,12.11,0.02
1665,0,15115450,0,0.00,138443.73,2,15131550,16100,15115450,0,0.00,83.15,138443.73,1,12.12,11.12,0.08
1666,0,15115450,0,0.00,138443.73,2,15134720,19270,15115450,0,0.00,83.10,138443.73,1,11.90,10.90,0.03
1667,0,15116344,894,8.19,138451.92,2,15137380,21036,15116344,894,8.19,83.05,138451.92,0,11.00,10.00,0.03
1668,0,15116344,0,0.00,138451.92,2,15139862,23518,15116344,0,0.00,83.00,138451.92,1,11.01,10.01,0.06
1669,0,15118917,2573,23.57,138475.50,2,15142279,23362,15118917,2573,23.57,82.97,138475.50,0,10.08,9.08,0.06
1670,0,15118917,0,0.00,138475.50,2,15144553,25636,15118917,0,0.00,82.92,138475.50,1,10.10,9.10,0.06
1671,0,15123347,4430,40.57,138516.06,2,15146768,23421,15123347,4430,40.57,82.89,138516.06,0,8.73,9.10,0.06
1672,0,15128061,4714,43.18,138559.25,2,15149125,21064,15128061,4714,43.18,82.87,138559.25,1,8.77,9.10,0.06
1673,0,15133501,5440,49.83,138609.06,2,15151845,18344,15133501,5440,49.83,82.85,138609.06,0,7.42,9.10,0.06
1674,0,15140421,6920,63.38,138672.45,2,15155305,14884,15140421,6920,63.38,82.84,138672.45,1,7.47,9.10,0.06
1675,0,15152411,11990,109.82,138782.27,2,15161300,8889,15152411,11990,109.82,82.86,138782.27,0,6.25,9.10,0.06
1676,0,15177137,24726,226.47,139008.73,2,15177137,0,15177137,24726,226.47,82.94,139008.73,1,6.35,9.10,0.06
1677,0,15210654,33517,306.99,139315.72,2,15210654,0,15210654,33517,306.99,83.07,139315.72,0,8.25,9.10,0.06
1678,0,15243683,33029,302.52,139618.23,2,15243683,0,15243683,33029,302.52,83.21,139618.23,0,8.55,9.10,0.06
1679,0,15243683,0,0.00,139618.23,2,15254202,10519,15243683,0,0.00,83.16,139618.23,0,10.23,9.23,0.12
1680,0,15243683,0,0.00,139618.23,2,15259986,16303,15243683,0,0.00,83.11,139618.23,1,11.43,10.43,0.18
1681,0,15253563,9880,90.49,139708.73,2,15264926,11363,15253563,9880,90.49,83.11,139708.73,1,10.11,10.43,0.04
1682,0,15270861,17298,158.43,139867.16,2,15273575,2714,15270861,17298,158.43,83.16,139867.16,0,9.21,10.43,0.04
1683,0,15302567,31706,290.40,140157.56,2,15302567,0,15302567,31706,290.40,83.28,140157.56,0,9.36,10.43,0.06
1684,0,15334311,31744,290.75,140448.31,2,15334311,0,15334311,31744,290.75,83.40,140448.31,1,10.30,10.43,0.12
1685,0,15338571,4260,39.02,140487.33,2,15346887,8316,15338571,4260,39.02,83.38,140487.33,1,10.03,9.03,0.12
1686,0,15338571,0,0.00,140487.33,2,15353254,14683,15338571,0,0.00,83.33,140487.33,0,10.07,9.07,0.06
1687,0,15338571,0,0.00,140487.33,2,15357392,18821,15338571,0,0.00,83.28,140487.33,1,10.80,9.80,0.12
1688,0,15346029,7458,68.31,140555.62,2,15361121,15092,15346029,7458,68.31,83.27,140555.62,0,9.33,9.80,0.02
1689,0,15346029,0,0.00,140555.62,2,15364683,18654,15346029,0,0.00,83.22,140555.62,1,10.17,9.17,0.07
1690,0,15346029,0,0.00,140555.62,2,15367812,21783,15346029,0,0.00,83.17,140555.62,1,9.46,8.46,0.03
1691,0,15352118,6089,55.77,140611.41,2,15370857,18739,15352118,6089,55.77,83.15,140611.41,0,9.10,9.81,0.03
1692,0,15358670,6552,60.01,140671.41,2,15374133,15463,15358670,6552,60.01,83.14,140671.41,1,9.15,9.81,0.06
1693,0,15367410,8740,80.05,140751.47,2,15378503,11093,15367410,8740,80.05,83.14,140751.47,0,8.27,9.81,0.06
1694,0,15387944,20534,188.07,140939.53,2,15388770,826,15387944,20534,188.07,83.20,140939.53,0,8.34,9.81,0.06
1695,0,15416397,28453,260.60,141200.14,2,15416397,0,15416397,28453,260.60,83.30,141200.14,1,9.67,9.81,0.12
1696,0,15443810,27413,251.08,141451.22,2,15443810,0,15443810,27413,251.08,83.40,141451.22,1,8.26,9.81,0.12
1697,0,15471491,27681,253.53,141704.75,2,15471491,0,15471491,27681,253.53,83.50,141704.75,0,8.50,9.81,0.06
1698,0,15499801,28310,259.29,141964.05,2,15499801,0,15499801,28310,259.29,83.61,141964.05,0,9.36,9.81,0.12
1699,0,15499801,0,0.00,141964.05,2,15509454,9653,15499801,0,0.00,83.56,141964.05,0,11.08,10.08,0.18
1700,0,15499801,0,0.00,141964.05,2,15515064,15263,15499801,0,0.00,83.51,141964.05,1,11.84,10.84,0.24
1701,0,15509685,9884,90.53,142054.58,2,15520006,10321,15509685,9884,90.53,83.51,142054.58,1,10.11,10.84,0.12
1702,0,15522667,12982,118.90,142173.47,2,15526497,3830,15522667,12982,118.90,83.53,142173.47,0,9.07,10.84,0.05
1703,0,15551300,28633,262.25,142435.73,2,15551300,0,15551300,28633,262.25,83.64,142435.73,1,10.17,10.84,0.11
1704,0,15577560,26260,240.52,142676.25,2,15577560,0,15577560,26260,240.52,83.73,142676.25,1,10.63,10.84,0.05
1705,0,15602914,25354,232.22,142908.47,2,15602914,0,15602914,25354,232.22,83.82,142908.47,0,10.54,10.84,0.01
1706,0,15602914,0,0.00,142908.47,2,15612718,9804,15602914,0,0.00,83.77,142908.47,0,13.32,12.32,0.07
1707,0,15602914,0,0.00,142908.47,2,15618015,15101,15602914,0,0.00,83.72,142908.47,1,13.40,12.40,0.13
1708,0,15613038,10124,92.73,143001.19,2,15623077,10039,15613038,10124,92.73,83.72,143001.19,1,11.65,12.40,0.01
1709,0,15630254,17216,157.68,143158.88,2,15632404,2150,15630254,17216,157.68,83.77,143158.88,0,12.71,11.71,0.01
1710,0,15630254,0,0.00,143158.88,2,15641403,11149,15630254,0,0.00,83.72,143158.88,1,12.86,11.86,0.06
1711,0,15630254,0,0.00,143158.88,2,15646250,15996,15630254,0,0.00,83.67,143158.88,0,13.01,12.01,0.06
1712,0,15630254,0,0.00,143158.88,2,15648911,18657,15630254,0,0.00,83.62,143158.88,1,13.01,12.01,0.06
1713,0,15635186,4932,45.17,143204.05,2,15651644,16458,15635186,4932,45.17,83.60,143204.05,0,12.16,11.16,0.06
1714,0,15635186,0,0.00,143204.05,2,15654426,19240,15635186,0,0.00,83.55,143204.05,1,12.20,11.20,0.06
1715,0,15640958,5772,52.87,143256.91,2,15657312,16354,15640958,5772,52.87,83.53,143256.91,0,11.16,11.20,0.06
1716,0,15640958,0,0.00,143256.91,2,15660276,19318,15640958,0,0.00,83.48,143256.91,1,11.21,10.21,0.06
1717,0,15647046,6088,55.76,143312.67,2,15663320,16274,15647046,6088,55.76,83.47,143312.67,0,9.93,10.21,0.06
1718,0,15655448,8402,76.95,143389.62,2,15667521,12073,15655448,8402,76.95,83.46,143389.62,0,9.99,10.21,0.06
1719,0,15655448,0,0.00,143389.62,2,15672489,17041,15655448,0,0.00,83.41,143389.62,0,10.38,9.38,0.12
1720,0,15655448,0,0.00,143389.62,2,15675896,20448,15655448,0,0.00,83.37,143389.62,1,10.83,9.83,0.17
1721,0,15661986,6538,59.88,143449.52,2,15679165,17179,15661986,6538,59.88,83.35,143449.52,1,8.75,9.83,0.02
1722,0,15668768,6782,62.12,143511.62,2,15682556,13788,15668768,6782,62.12,83.34,143511.62,0,7.60,9.83,0.02
1723,0,15683380,14612,133.83,143645.45,2,15689862,6482,15683380,14612,133.83,83.37,143645.45,1,7.66,9.83,0.06
1724,0,15714399,31019,284.11,143929.56,2,15714399,0,15714399,31019,284.11,83.49,143929.56,1,6.15,9.83,0.06
1725,0,15740074,25675,235.16,144164.72,2,15740074,0,15740074,25675,235.16,83.57,144164.72,0,6.43,9.83,0.06
1726,0,15767218,27144,248.61,144413.34,2,15767218,0,15767218,27144,248.61,83.67,144413.34,1,8.21,9.83,0.12
1727,0,15800343,33125,303.39,144716.73,2,15800343,0,15800343,33125,303.39,83.80,144716.73,0,7.86,9.83,0.03
1728,0,15800343,0,0.00,144716.73,2,15810848,10505,15800343,0,0.00,83.75,144716.73,1,11.53,10.53,0.09
1729,0,15800343,0,0.00,144716.73,2,15816929,16586,15800343,0,0.00,83.70,144716.73,0,10.94,9.94,0.01
1730,0,15800343,0,0.00,144716.73,2,15821670,21327,15800343,0,0.00,83.65,144716.73,1,11.51,10.51,0.07
1731,0,15808929,8586,78.64,144795.38,2,15825963,17034,15808929,8586,78.64,83.65,144795.38,0,10.33,10.51,0.07
1732,0,15817469,8540,78.22,144873.59,2,15830233,12764,15817469,8540,78.22,83.65,144873.59,1,10.41,10.51,0.06
1733,0,15828725,11256,103.09,144976.69,2,15835861,7136,15828725,11256,103.09,83.66,144976.69,0,9.71,10.51,0.06
1734,0,15856574,27849,255.07,145231.77,2,15856574,0,15856574,27849,255.07,83.76,145231.77,1,9.81,10.51,0.06
1735,0,15874531,17957,164.47,145396.23,2,15880121,5590,15874531,17957,164.47,83.80,145396.23,0,11.35,10.35,0.06
1736,0,15874531,0,0.00,145396.23,2,15888079,13548,15874531,0,0.00,83.75,145396.23,1,11.51,10.51,0.06
1737,0,15874531,0,0.00,145396.23,2,15893298,18767,15874531,0,0.00,83.71,145396.23,0,11.73,10.73,0.06
1738,0,15874531,0,0.00,145396.23,2,15897607,23076,15874531,0,0.00,83.66,145396.23,0,11.73,10.73,0.06
1739,0,15874531,0,0.00,145396.23,2,15901433,26902,15874531,0,0.00,83.61,145396.23,0,11.73,10.73,0.12
1740,0,15874531,0,0.00,145396.23,2,15904764,30233,15874531,0,0.00,83.56,145396.23,0,11.73,10.73,0.17
1741,0,15874531,0,0.00,145396.23,2,15907771,33240,15874531,0,0.00,83.51,145396.23,1,11.73,10.73,0.23
1742,0,15880461,5930,54.31,145450.55,2,15910736,30275,15880461,5930,54.31,83.50,145450.55,0,10.06,10.73,0.14
1743,0,15886451,5990,54.86,145505.41,2,15913731,27280,15886451,5990,54.86,83.48,145505.41,1,10.40,10.73,0.20
1744,0,15892343,5892,53.97,145559.38,2,15916677,24334,15892343,5892,53.97,83.46,145559.38,1,8.72,10.73,0.10
1745,0,15898119,5776,52.90,145612.27,2,15919565,21446,15898119,5776,52.90,83.45,145612.27,0,7.78,10.73,0.10
1746,0,15903693,5574,51.05,145663.33,2,15922352,18659,15903693,5574,51.05,83.43,145663.33,1,7.83,10.73,0.06
1747,0,15909291,5598,51.27,145714.59,2,15925151,15860,15909291,5598,51.27,83.41,145714.59,1,6.37,10.73,0.06
1748,0,15915367,6076,55.65,145770.25,2,15928189,12822,15915367,6076,55.65,83.39,145770.25,0,6.42,10.73,0.06
1749,0,15927311,11944,109.40,145879.64,2,15934161,6850,15927311,11944,109.40,83.41,145879.64,1,6.47,10.73,0.11
1750,0,15955736,28425,260.35,146140.00,2,15955736,0,15955736,28425,260.35,83.51,146140.00,1,4.79,10.73,0.01
1751,0,15989765,34029,311.67,146451.67,2,15989765,0,15989765,34029,311.67,83.64,146451.67,0,5.75,10.73,0.01
1752,0,16023763,33998,311.39,146763.06,2,16023763,0,16023763,33998,311.39,83.77,146763.06,1,6.06,10.73,0.06
1753,0,16058090,34327,314.40,147077.47,2,16058090,0,16058090,34327,314.40,83.90,147077.47,0,8.43,10.73,0.06
1754,0,16092065,33975,311.18,147388.64,2,16092065,0,16092065,33975,311.18,84.03,147388.64,1,8.74,10.73,0.06
1755,0,16122009,29944,274.26,147662.91,2,16123733,1724,16122009,29944,274.26,84.14,147662.91,0,10.92,9.92,0.06
1756,0,16122009,0,0.00,147662.91,2,16133322,11313,16122009,0,0.00,84.09,147662.91,1,11.19,10.19,0.06
1757,0,16122009,0,0.00,147662.91,2,16138841,16832,16122009,0,0.00,84.04,147662.91,0,11.22,10.22,0.06
1758,0,16122009,0,0.00,147662.91,2,16143202,21193,16122009,0,0.00,83.99,147662.91,0,11.22,10.22,0.06
1759,0,16122009,0,0.00,147662.91,2,16147011,25002,16122009,0,0.00,83.95,147662.91,1,11.50,10.50,0.11
1760,0,16129061,7052,64.59,147727.48,2,16150537,21476,16129061,7052,64.59,83.94,147727.48,1,10.41,10.50,0.07
1761,0,16136057,6996,64.08,147791.56,2,16154035,17978,16136057,6996,64.08,83.92,147791.56,0,9.31,10.50,0.07
1762,0,16142873,6816,62.43,147854.00,2,16157443,14570,16142873,6816,62.43,83.91,147854.00,1,9.38,10.50,0.06
1763,0,16150035,7162,65.60,147919.59,2,16161024,10989,16150035,7162,65.60,83.90,147919.59,0,8.55,10.50,0.06
1764,0,16165847,15812,144.82,148064.42,2,16168930,3083,16165847,15812,144.82,83.94,148064.42,1,8.62,10.50,0.06
1765,0,16199493,33646,308.17,148372.58,2,16199493,0,16199493,33646,308.17,84.06,148372.58,0,9.36,10.50,0.06
1766,0,16232705,33212,304.19,148676.78,2,16232705,0,16232705,33212,304.19,84.19,148676.78,1,9.67,10.50,0.06
1767,0,16266301,33596,307.71,148984.48,2,16266301,0,16266301,33596,307.71,84.31,148984.48,0,10.12,10.50,0.06
1768,0,16299480,33179,303.89,149288.38,2,16299480,0,16299480,33179,303.89,84.44,149288.38,1,10.42,10.50,0.06
1769,0,16329569,30089,275.59,149563.97,2,16331104,1535,16329569,30089,275.59,84.55,149563.97,0,11.79,10.79,0.06
1770,0,16329569,0,0.00,149563.97,2,16341001,11432,16329569,0,0.00,84.50,149563.97,0,12.06,11.06,0.06
1771,0,16329569,0,0.00,149563.97,2,16346749,17180,16329569,0,0.00,84.45,149563.97,1,12.26,11.26,0.11
1772,0,16339337,9768,89.47,149653.42,2,16351633,12296,16339337,9768,89.47,84.45,149653.42,1,8.21,11.26,0.11
1773,0,16352157,12820,117.42,149770.84,2,16358043,5886,16352157,12820,117.42,84.47,149770.84,0,8.30,11.26,0.06
1774,0,16383874,31717,290.50,150061.34,2,16383874,0,16383874,31717,290.50,84.59,150061.34,1,8.88,11.26,0.11
1775,0,16417411,33537,307.17,150368.52,2,16417411,0,16417411,33537,307.17,84.71,150368.52,0,10.68,11.26,0.11
1776,0,16449803,32392,296.68,150665.20,2,16449803,0,16449803,32392,296.68,84.83,150665.20,1,10.98,11.26,0.06
1777,0,16449803,0,0.00,150665.20,2,16460240,10437,16449803,0,0.00,84.79,150665.20,0,16.01,15.01,0.06
1778,0,16449803,0,0.00,150665.20,2,16465969,16166,16449803,0,0.00,84.74,150665.20,0,16.01,15.01,0.06
1779,0,16449803,0,0.00,150665.20,2,16470569,20766,16449803,0,0.00,84.69,150665.20,0,16.37,15.37,0.11
1780,0,16449803,0,0.00,150665.20,2,16474573,24770,16449803,0,0.00,84.64,150665.20,1,16.73,15.73,0.17
1781,0,16457149,7346,67.28,150732.48,2,16478246,21097,16457149,7346,67.28,84.63,150732.48,0,14.69,15.73,0.03
1782,0,16463949,6800,62.28,150794.77,2,16481646,17697,16463949,6800,62.28,84.62,150794.77,1,15.17,15.73,0.09
1783,0,16471005,7056,64.63,150859.39,2,16485174,14169,16471005,7056,64.63,84