timestamp,socket_0,socket_0_TSENT,socket_0_TSENTSEC,socket_0_TTHSENTSEC,socket_0_TTHSENT,socket_status_0,TMSG,TOSEND,SENT,TMSGSEC,TTHMSGSEC,AVG,THtotalsent,ackSent,state,globalState,THloss
1,0,0,0,0.00,0.00,2,0,0,0,0,0.00,0.00,0.00,0,0.00,8.00,0.00
2,0,0,0,0.00,0.00,2,0,0,0,0,0.00,0.00,0.00,0,0.00,8.00,0.00
3,0,0,0,0.00,0.00,2,0,0,0,0,0.00,0.00,0.00,0,0.00,8.00,0.00
4,0,0,0,0.00,0.00,2,0,0,0,0,0.00,0.00,0.00,0,0.00,8.00,0.00
5,0,0,0,0.00,0.00,2,0,0,0,0,0.00,0.00,0.00,0,0.00,8.00,0.00
6,0,0,0,0.00,0.00,2,0,0,0,0,0.00,0.00,0.00,0,0.00,8.00,0.00
7,0,0,0,0.00,0.00,2,0,0,0,0,0.00,0.00,0.00,0,0.00,8.00,0.00
8,0,0,0,0.00,0.00,2,0,0,0,0,0.00,0.00,0.00,0,0.00,8.00,0.00
9,0,0,0,0.00,0.00,2,0,0,0,0,0.00,0.00,0.00,0,0.00,8.00,0.00
10,0,0,0,0.00,0.00,2,0,0,0,0,0.00,0.00,0.00,0,0.00,8.00,0.00
11,0,0,0,0.00,0.00,2,0,0,0,0,0.00,0.00,0.00,0,0.00,8.00,0.00
12,0,0,0,0.00,0.00,2,0,0,0,0,0.00,0.00,0.00,0,0.00,8.00,0.00
13,0,0,0,0.00,0.00,2,0,0,0,0,0.00,0.00,0.00,0,0.00,8.00,0.00
14,0,0,0,0.00,0.00,2,0,0,0,0,0.00,0.00,0.00,0,0.00,8.00,0.00
15,0,0,0,0.00,0.00,2,0,0,0,0,0.00,0.00,0.00,0,0.00,8.00,0.00
16,0,0,0,0.00,0.00,2,0,0,0,0,0.00,0.00,0.00,0,0.00,8.00,0.00
17,0,0,0,0.00,0.00,2,0,0,0,0,0.00,0.00,0.00,0,0.00,8.00,0.00
18,0,5497,5497,50.35,50.35,2,5497,0,5497,5497,50.35,2.80,50.35,0,0.00,8.00,0.00
19,0,38627,33130,303.44,353.79,2,38627,0,38627,33130,303.44,18.62,353.79,0,1.51,8.00,0.00
20,0,75007,36380,333.21,687.00,2,75007,0,75007,36380,333.21,34.35,687.00,0,2.16,8.00,0.00
21,0,109835,34828,318.99,1005.99,2,109835,0,109835,34828,318.99,47.90,1005.99,1,2.49,8.00,0.00
22,0,145702,35867,328.51,1334.50,2,145702,0,145702,35867,328.51,60.66,1334.50,1,9.46,9.48,0.00
23,0,145702,0,0.00,1334.50,2,156567,10865,145702,0,0.00,58.02,1334.50,0,10.60,9.60,4.55
24,0,145702,0,0.00,1334.50,2,162051,16349,145702,0,0.00,55.60,1334.50,1,11.19,10.19,8.70
25,0,145702,0,0.00,1334.50,2,166356,20654,145702,0,0.00,53.38,1334.50,0,11.64,10.64,4.17
26,0,145702,0,0.00,1334.50,2,170255,24553,145702,0,0.00,51.33,1334.50,1,12.39,11.39,8.00
27,0,145702,0,0.00,1334.50,2,173836,28134,145702,0,0.00,49.43,1334.50,0,13.03,12.03,3.85
28,0,145702,0,0.00,1334.50,2,177151,31449,145702,0,0.00,47.66,1334.50,1,12.28,11.28,7.41
29,0,145702,0,0.00,1334.50,2,180216,34514,145702,0,0.00,46.02,1334.50,0,12.28,11.28,3.57
30,0,146207,505,4.63,1339.12,2,183106,36899,146207,505,4.63,44.64,1339.12,1,11.56,10.56,6.90
31,0,146207,0,0.00,1339.12,2,185909,39702,146207,0,0.00,43.20,1339.12,0,13.80,12.80,3.33
32,0,147249,1042,9.54,1348.67,2,188531,41282,147249,1042,9.54,42.15,1348.67,1,12.55,12.80,6.45
33,0,152255,5006,45.85,1394.52,2,191034,38779,152255,5006,45.85,42.26,1394.52,0,12.56,12.80,3.12
34,0,156813,4558,41.75,1436.26,2,193313,36500,156813,4558,41.75,42.24,1436.26,0,12.61,12.80,6.06
35,0,161343,4530,41.49,1477.75,2,195578,34235,161343,4530,41.49,42.22,1477.75,1,11.09,12.80,8.82
36,0,166163,4820,44.15,1521.90,2,197988,31825,166163,4820,44.15,42.28,1521.90,0,11.13,12.80,2.86
37,0,170869,4706,43.10,1565.00,2,200341,29472,170869,4706,43.10,42.30,1565.00,1,9.70,12.80,5.56
38,0,175549,4680,42.86,1607.87,2,202681,27132,175549,4680,42.86,42.31,1607.87,0,10.08,12.80,2.70
39,0,180165,4616,42.28,1650.15,2,204989,24824,180165,4616,42.28,42.31,1650.15,0,10.65,12.80,5.26
40,0,184841,4676,42.83,1692.97,2,207327,22486,184841,4676,42.83,42.32,1692.97,0,10.77,12.80,7.69
41,0,189501,4660,42.68,1735.66,2,209657,20156,189501,4660,42.68,42.33,1735.66,1,9.53,12.80,10.00
42,0,194441,4940,45.25,1780.90,2,212127,17686,194441,4940,45.25,42.40,1780.90,0,9.57,12.80,2.44
43,0,199935,5494,50.32,1831.22,2,214874,14939,199935,5494,50.32,42.59,1831.22,1,7.78,12.80,4.76
44,0,208633,8698,79.67,1910.89,2,219223,10590,208633,8698,79.67,43.43,1910.89,0,8.50,12.80,2.33
45,0,230566,21933,200.89,2111.77,2,230566,0,230566,21933,200.89,46.93,2111.77,1,8.26,12.80,4.55
46,0,266942,36376,333.17,2444.95,2,266942,0,266942,36376,333.17,53.15,2444.95,0,10.74,12.80,2.22
47,0,300719,33777,309.37,2754.31,2,300719,0,300719,33777,309.37,58.60,2754.31,1,12.56,12.80,4.35
48,0,305363,4644,42.53,2796.85,2,311742,6379,305363,4644,42.53,58.27,2796.85,1,12.46,12.72,2.13
49,0,313316,7953,72.84,2869.69,2,322431,9115,313316,7953,72.84,58.57,2869.69,0,14.01,13.01,2.08
50,0,320689,7373,67.53,2937.22,2,330615,9926,320689,7373,67.53,58.74,2937.22,1,14.36,13.36,4.08
51,0,327059,6370,58.34,2995.56,2,337695,10636,327059,6370,58.34,58.74,2995.56,1,14.18,13.18,2.00
52,0,327059,0,0.00,2995.56,2,343232,16173,327059,0,0.00,57.61,2995.56,0,14.24,13.24,1.96
53,0,327059,0,0.00,2995.56,2,346770,19711,327059,0,0.00,56.52,2995.56,1,14.24,13.24,1.96
54,0,327059,0,0.00,2995.56,2,349694,22635,327059,0,0.00,55.47,2995.56,1,14.24,13.24,1.96
55,0,327912,853,7.81,3003.38,2,352281,24369,327912,853,7.81,54.61,3003.38,0,12.23,13.24,1.96
56,0,333176,5264,48.21,3051.59,2,354913,21737,333176,5264,48.21,54.49,3051.59,0,12.23,13.24,1.82
57,0,339056,5880,53.86,3105.44,2,357853,18797,339056,5880,53.86,54.48,3105.44,1,10.79,13.24,3.57
58,0,346068,7012,64.22,3169.67,2,361359,15291,346068,7012,64.22,54.65,3169.67,0,11.19,13.24,1.75
59,0,354080,8012,73.38,3243.05,2,365365,11285,354080,8012,73.38,54.97,3243.05,0,11.59,13.24,3.45
60,0,370598,16518,151.29,3394.34,2,373624,3026,370598,16518,151.29,56.57,3394.34,1,9.27,13.24,5.08
61,0,403828,33230,304.36,3698.70,2,403828,0,403828,33230,304.36,60.63,3698.70,0,9.93,13.24,1.67
62,0,435777,31949,292.62,3991.32,2,435777,0,435777,31949,292.62,64.38,3991.32,1,9.43,13.24,3.28
63,0,466626,30849,282.55,4273.87,2,466626,0,466626,30849,282.55,67.84,4273.87,0,10.37,13.24,1.61
64,0,499469,32843,300.81,4574.68,2,499469,0,499469,32843,300.81,71.48,4574.68,1,9.85,13.24,3.17
65,0,532609,33140,303.53,4878.21,2,532609,0,532609,33140,303.53,75.05,4878.21,0,11.99,13.24,1.56
66,0,562287,29678,271.82,5150.04,2,562287,0,562287,29678,271.82,78.03,5150.04,1,11.49,13.24,3.08
67,0,571864,9577,87.72,5237.75,2,579771,7907,571864,9577,87.72,78.18,5237.75,0,15.67,14.67,1.52
68,0,576319,4455,40.80,5278.56,2,588048,11729,576319,4455,40.80,77.63,5278.56,1,15.39,14.39,2.99
69,0,576319,0,0.00,5278.56,2,593232,16913,576319,0,0.00,76.50,5278.56,0,16.29,15.29,1.47
70,0,578797,2478,22.70,5301.25,2,597340,18543,578797,2478,22.70,75.73,5301.25,1,14.67,15.29,2.90
71,0,583572,4775,43.73,5344.99,2,601253,17681,583572,4775,43.73,75.28,5344.99,0,15.55,14.55,1.43
72,0,587279,3707,33.95,5378.94,2,604814,17535,587279,3707,33.95,74.71,5378.94,1,14.84,13.84,2.82
73,0,587279,0,0.00,5378.94,2,608053,20774,587279,0,0.00,73.68,5378.94,0,15.45,14.45,1.39
74,0,592219,4940,45.25,5424.19,2,610823,18604,592219,4940,45.25,73.30,5424.19,1,13.66,14.45,2.74
75,0,598487,6268,57.41,5481.60,2,613957,15470,598487,6268,57.41,73.09,5481.60,1,12.48,14.45,1.35
76,0,607241,8754,80.18,5561.77,2,618334,11093,607241,8754,80.18,73.18,5561.77,0,13.40,14.45,1.33
77,0,625132,17891,163.87,5725.64,2,627559,2427,625132,17891,163.87,74.36,5725.64,1,13.55,13.85,2.63
78,0,628255,3123,28.60,5754.24,2,638839,10584,628255,3123,28.60,73.77,5754.24,0,14.27,13.27,1.30
79,0,628255,0,0.00,5754.24,2,643977,15722,628255,0,0.00,72.84,5754.24,0,14.30,13.30,2.56
80,0,631769,3514,32.19,5786.43,2,647511,15742,631769,3514,32.19,72.33,5786.43,1,12.84,13.30,3.80
81,0,641913,10144,92.91,5879.34,2,652583,10670,641913,10144,92.91,72.58,5879.34,0,12.87,13.30,1.25
82,0,662051,20138,184.45,6063.78,2,662652,601,662051,20138,184.45,73.95,6063.78,1,12.24,13.30,2.47
83,0,694410,32359,296.38,6360.16,2,694410,0,694410,32359,296.38,76.63,6360.16,1,11.92,13.30,1.22
84,0,727990,33580,307.56,6667.72,2,727990,0,727990,33580,307.56,79.38,6667.72,0,13.15,13.30,1.20
85,0,739552,11562,105.90,6773.62,2,742370,2818,739552,11562,105.90,79.69,6773.62,1,12.82,11.82,2.38
86,0,739552,0,0.00,6773.62,2,751597,12045,739552,0,0.00,78.76,6773.62,0,13.78,12.78,1.18
87,0,746344,6792,62.21,6835.83,2,757651,11307,746344,6792,62.21,78.57,6835.83,1,12.04,12.78,2.33
88,0,748183,1839,16.84,6852.67,2,763310,15127,748183,1839,16.84,77.87,6852.67,0,13.14,12.14,1.15
89,0,754945,6762,61.93,6914.61,2,767652,12707,754945,6762,61.93,77.69,6914.61,1,12.50,12.86,2.27
90,0,768358,13413,122.85,7037.46,2,774529,6171,768358,13413,122.85,78.19,7037.46,0,13.78,12.78,1.12
91,0,770198,1840,16.85,7054.31,2,782042,11844,770198,1840,16.85,77.52,7054.31,1,13.12,14.12,2.22
92,0,788348,18150,166.24,7220.55,2,791117,2769,788348,18150,166.24,78.48,7220.55,0,13.32,14.12,1.10
93,0,819757,31409,287.68,7508.23,2,819757,0,819757,31409,287.68,80.73,7508.23,1,13.46,14.12,2.17
94,0,838742,18985,173.89,7682.11,2,843919,5177,838742,18985,173.89,81.72,7682.11,0,14.16,13.16,1.08
95,0,838742,0,0.00,7682.11,2,851417,12675,838742,0,0.00,80.86,7682.11,0,14.79,13.79,2.13
96,0,844001,5259,48.17,7730.28,2,856635,12634,844001,5259,48.17,80.52,7730.28,1,12.95,14.06,3.16
97,0,859569,15568,142.59,7872.87,2,864419,4850,859569,15568,142.59,81.16,7872.87,0,13.65,14.06,1.04
98,0,889122,29553,270.68,8143.55,2,889122,0,889122,29553,270.68,83.10,8143.55,1,13.19,14.06,2.06
99,0,898315,9193,84.20,8227.75,2,906488,8173,898315,9193,84.20,83.11,8227.75,0,15.08,14.08,1.02
100,0,898315,0,0.00,8227.75,2,913228,14913,898315,0,0.00,82.28,8227.75,0,16.86,15.86,2.02
101,0,906709,8394,76.88,8304.63,2,918511,11802,906709,8394,76.88,82.22,8304.63,1,15.08,15.86,3.00
102,0,924239,17530,160.56,8465.19,2,927276,3037,924239,17530,160.56,82.99,8465.19,0,15.17,15.86,0.99
103,0,955679,31440,287.96,8753.15,2,955679,0,955679,31440,287.96,84.98,8753.15,1,14.53,15.86,1.96
104,0,960844,5165,47.31,8800.46,2,970187,9343,960844,5165,47.31,84.62,8800.46,0,16.28,15.28,0.97
105,0,976112,15268,139.84,8940.30,2,979442,3330,976112,15268,139.84,85.15,8940.30,1,15.11,15.33,1.92
106,0,1007741,31629,289.69,9229.99,2,1007741,0,1007741,31629,289.69,87.08,9229.99,1,15.27,15.33,0.95
107,0,1007741,0,0.00,9229.99,2,1018716,10975,1007741,0,0.00,86.26,9229.99,0,16.13,15.13,0.94
108,0,1017589,9848,90.20,9320.19,2,1025788,8199,1017589,9848,90.20,86.30,9320.19,1,16.03,16.20,1.87
109,0,1042073,24484,224.25,9544.44,2,1042073,0,1042073,24484,224.25,87.56,9544.44,1,15.65,16.20,0.93
110,0,1056993,14920,136.65,9681.09,2,1063817,6824,1056993,14920,136.65,88.01,9681.09,0,17.03,16.03,0.92
111,0,1073754,16761,153.52,9834.61,2,1077259,3505,1073754,16761,153.52,88.60,9834.61,1,17.80,16.80,1.82
112,0,1073754,0,0.00,9834.61,2,1086445,12691,1073754,0,0.00,87.81,9834.61,0,17.95,16.95,0.90
113,0,1073852,98,0.90,9835.50,2,1091715,17863,1073852,98,0.90,87.04,9835.50,1,16.08,17.05,1.79
114,0,1083480,9628,88.18,9923.69,2,1096529,13049,1083480,9628,88.18,87.05,9923.69,0,16.74,17.05,0.88
115,0,1089439,5959,54.58,9978.27,2,1101637,12198,1089439,5959,54.58,86.77,9978.27,1,15.64,16.15,1.75
116,0,1093465,4026,36.87,10015.14,2,1106802,13337,1093465,4026,36.87,86.34,10015.14,0,16.62,15.62,0.87
117,0,1096921,3456,31.65,10046.80,2,1110601,13680,1096921,3456,31.65,85.87,10046.80,1,14.92,15.65,1.72
118,0,1111129,14208,130.13,10176.93,2,1117705,6576,1111129,14208,130.13,86.25,10176.93,0,14.95,15.65,0.85
119,0,1119416,8287,75.90,10252.83,2,1127647,8231,1119416,8287,75.90,86.16,10252.83,0,17.08,16.08,1.69
120,0,1129114,9698,88.82,10341.65,2,1135190,6076,1129114,9698,88.82,86.18,10341.65,1,15.61,16.15,2.52
121,0,1155899,26785,245.33,10586.98,2,1156344,445,1155899,26785,245.33,87.50,10586.98,0,16.40,15.40,1.30
122,0,1182391,26492,242.64,10829.62,2,1184980,2589,1182391,26492,242.64,88.77,10829.62,1,16.10,15.10,2.11
123,0,1186251,3860,35.35,10864.98,2,1194387,8136,1186251,3860,35.35,88.33,10864.98,1,14.77,15.46,0.82
124,0,1212957,26706,244.60,11109.58,2,1212957,0,1212957,26706,244.60,89.59,11109.58,0,15.21,15.46,0.81
125,0,1245827,32870,301.06,11410.64,2,1245827,0,1245827,32870,301.06,91.29,11410.64,1,15.44,15.46,1.61
126,0,1245827,0,0.00,11410.64,2,1256500,10673,1245827,0,0.00,90.56,11410.64,0,17.71,16.71,0.80
127,0,1245827,0,0.00,11410.64,2,1262554,16727,1245827,0,0.00,89.85,11410.64,0,17.80,16.80,1.59
128,0,1249703,3876,35.50,11446.14,2,1267205,17502,1249703,3876,35.50,89.42,11446.14,1,15.48,16.80,2.36
129,0,1258871,9168,83.97,11530.11,2,1271789,12918,1258871,9168,83.97,89.38,11530.11,0,15.52,16.80,0.78
130,0,1270893,12022,110.11,11640.22,2,1277800,6907,1270893,12022,110.11,89.54,11640.22,1,15.22,16.80,1.55
131,0,1297942,27049,247.74,11887.96,2,1297942,0,1297942,27049,247.74,90.75,11887.96,0,16.40,16.80,0.77
132,0,1318450,20508,187.83,12075.80,2,1318450,0,1318450,20508,187.83,91.48,12075.80,1,16.38,17.32,1.53
133,0,1350016,31566,289.12,12364.92,2,1350016,0,1350016,31566,289.12,92.97,12364.92,0,16.57,17.32,0.76
134,0,1382849,32833,300.72,12665.64,2,1382849,0,1382849,32833,300.72,94.52,12665.64,1,17.16,17.32,1.50
135,0,1384952,2103,19.26,12684.90,2,1393751,8799,1384952,2103,19.26,93.96,12684.90,1,17.67,18.40,0.75
136,0,1408613,23661,216.71,12901.61,2,1409113,500,1408613,23661,216.71,94.86,12901.61,0,18.41,17.41,0.74
137,0,1412565,3952,36.20,12937.81,2,1419607,7042,1412565,3952,36.20,94.44,12937.81,1,17.67,18.37,1.47
138,0,1426363,13798,126.38,13064.18,2,1431874,5511,1426363,13798,126.38,94.67,13064.18,0,20.41,19.41,0.73
139,0,1426363,0,0.00,13064.18,2,1439673,13310,1426363,0,0.00,93.99,13064.18,0,21.05,20.05,1.45
140,0,1426363,0,0.00,13064.18,2,1444208,17845,1426363,0,0.00,93.32,13064.18,0,21.82,20.82,2.16
141,0,1426363,0,0.00,13064.18,2,1448157,21794,1426363,0,0.00,92.65,13064.18,1,20.67,19.67,2.86
142,0,1429561,3198,29.29,13093.48,2,1451815,22254,1429561,3198,29.29,92.21,13093.48,1,19.06,19.72,1.63
143,0,1436947,7386,67.65,13161.12,2,1455508,18561,1436947,7386,67.65,92.04,13161.12,0,19.15,19.72,0.70
144,0,1444225,7278,66.66,13227.78,2,1459147,14922,1444225,7278,66.66,91.86,13227.78,1,17.27,19.72,1.40
145,0,1452273,8048,73.71,13301.50,2,1463171,10898,1452273,8048,73.71,91.73,13301.50,1,16.34,19.72,0.69
146,0,1469707,17434,159.68,13461.18,2,1471888,2181,1469707,17434,159.68,92.20,13461.18,0,16.42,19.72,0.69
147,0,1501522,31815,291.40,13752.57,2,1501522,0,1501522,31815,291.40,93.55,13752.57,1,16.66,19.72,1.37
148,0,1533457,31935,292.50,14045.07,2,1533457,0,1533457,31935,292.50,94.90,14045.07,0,17.63,19.72,0.68
149,0,1562202,28745,263.28,14308.35,2,1562202,0,1562202,28745,263.28,96.03,14308.35,1,16.57,19.72,1.35
150,0,1589271,27069,247.93,14556.27,2,1589271,0,1589271,27069,247.93,97.04,14556.27,0,17.22,19.72,0.67
151,0,1616326,27055,247.80,14804.07,2,1616326,0,1616326,27055,247.80,98.04,14804.07,1,16.71,19.72,1.33
152,0,1645220,28894,264.64,15068.71,2,1645220,0,1645220,28894,264.64,99.14,15068.71,0,18.37,19.72,0.66
153,0,1677366,32146,294.43,15363.14,2,1677366,0,1677366,32146,294.43,100.41,15363.14,1,18.20,19.72,1.32
154,0,1709773,32407,296.82,15659.96,2,1709773,0,1709773,32407,296.82,101.69,15659.96,1,17.03,19.72,0.65
155,0,1739107,29334,268.67,15928.63,2,1740329,1222,1739107,29334,268.67,102.77,15928.63,0,20.32,19.32,0.65
156,0,1739107,0,0.00,15928.63,2,1750335,11228,1739107,0,0.00,102.11,15928.63,0,21.74,20.74,1.29
157,0,1739108,1,0.01,15928.64,2,1756292,17184,1739108,1,0.01,101.46,15928.64,1,19.53,18.53,1.92
158,0,1739108,0,0.00,15928.64,2,1760818,21710,1739108,0,0.00,100.81,15928.64,0,19.53,18.53,0.64
159,0,1739108,0,0.00,15928.64,2,1764589,25481,1739108,0,0.00,100.18,15928.64,0,20.10,19.10,1.27
160,0,1742227,3119,28.57,15957.21,2,1768179,25952,1742227,3119,28.57,99.73,15957.21,1,19.10,19.68,1.89
161,0,1749065,6838,62.63,16019.84,2,1771598,22533,1749065,6838,62.63,99.50,16019.84,0,19.13,19.68,0.62
162,0,1752415,3350,30.68,16050.52,2,1774825,22410,1752415,3350,30.68,99.08,16050.52,1,17.51,18.78,1.24
163,0,1753272,857,7.85,16058.37,2,1777792,24520,1753272,857,7.85,98.52,16058.37,0,20.29,19.29,0.62
164,0,1756923,3651,33.44,16091.81,2,1780469,23546,1756923,3651,33.44,98.12,16091.81,1,18.90,19.29,1.23
165,0,1761916,4993,45.73,16137.54,2,1783087,21171,1761916,4993,45.73,97.80,16137.54,0,19.51,18.51,0.61
166,0,1763924,2008,18.39,16155.94,2,1785596,21672,1763924,2008,18.39,97.32,16155.94,1,18.08,18.55,1.21
167,0,1768856,4932,45.17,16201.11,2,1788062,19206,1768856,4932,45.17,97.01,16201.11,0,18.38,18.55,0.60
168,0,1774164,5308,48.62,16249.72,2,1790716,16552,1774164,5308,48.62,96.72,16249.72,1,16.51,18.55,1.20
169,0,1780138,5974,54.72,16304.44,2,1793703,13565,1780138,5974,54.72,96.48,16304.44,0,17.13,18.55,0.60
170,0,1791630,11492,105.26,16409.70,2,1799449,7819,1791630,11492,105.26,96.53,16409.70,1,16.40,18.55,1.18
171,0,1816766,25136,230.22,16639.92,2,1816766,0,1816766,25136,230.22,97.31,16639.92,0,17.62,18.55,0.59
172,0,1835061,18295,167.57,16807.49,2,1839644,4583,1835061,18295,167.57,97.72,16807.49,1,17.90,16.90,1.17
173,0,1835061,0,0.00,16807.49,2,1848299,13238,1835061,0,0.00,97.15,16807.49,0,18.19,17.19,0.69
174,0,1839227,4166,38.16,16845.64,2,1853592,14365,1839227,4166,38.16,96.81,16845.64,1,16.50,17.19,1.27
175,0,1850441,11214,102.71,16948.35,2,1859199,8758,1850441,11214,102.71,96.85,16948.35,0,17.15,17.19,0.57
176,0,1859818,9377,85.88,17034.24,2,1866142,6324,1859818,9377,85.88,96.79,17034.24,1,15.48,16.25,1.14
177,0,1879565,19747,180.86,17215.10,2,1883177,3612,1879565,19747,180.86,97.26,17215.10,0,16.64,15.64,0.57
178,0,1883112,3547,32.49,17247.59,2,1892695,9583,1883112,3547,32.49,96.90,17247.59,1,16.22,15.22,1.13
179,0,1883112,0,0.00,17247.59,2,1898497,15385,1883112,0,0.00,96.36,17247.59,0,17.39,16.39,0.81
180,0,1883596,484,4.43,17252.02,2,1902779,19183,1883596,484,4.43,95.84,17252.02,1,16.06,16.68,1.36
181,0,1891558,7962,72.92,17324.95,2,1906760,15202,1891558,7962,72.92,95.72,17324.95,0,16.35,16.68,0.64
182,0,1898000,6442,59.00,17383.95,2,1911243,13243,1898000,6442,59.00,95.52,17383.95,1,15.21,15.71,1.19
183,0,1901942,3942,36.11,17420.05,2,1915872,13930,1901942,3942,36.11,95.19,17420.05,0,15.92,14.92,0.55
184,0,1904758,2816,25.79,17445.85,2,1919717,14959,1904758,2816,25.79,94.81,17445.85,1,15.14,14.14,1.09
185,0,1906981,2223,20.36,17466.21,2,1922787,15806,1906981,2223,20.36,94.41,17466.21,1,14.48,14.52,0.73
186,0,1908299,1318,12.07,17478.28,2,1926133,17834,1908299,1318,12.07,93.97,17478.28,0,14.79,13.79,0.54
187,0,1913146,4847,44.39,17522.67,2,1929275,16129,1913146,4847,44.39,93.70,17522.67,1,13.30,13.80,1.08
188,0,1923116,9970,91.32,17613.99,2,1934260,11144,1923116,9970,91.32,93.69,17613.99,1,12.10,13.80,0.53
189,0,1941038,17922,164.15,17778.14,2,1943221,2183,1941038,17922,164.15,94.06,17778.14,0,12.62,13.80,0.53
190,0,1972604,31566,289.12,18067.25,2,1972604,0,1972604,31566,289.12,95.09,18067.25,1,11.96,13.80,1.06
191,0,2005536,32932,301.63,18368.88,2,2005536,0,2005536,32932,301.63,96.17,18368.88,0,13.06,13.80,0.53
192,0,2029907,24371,223.22,18592.10,2,2033476,3569,2029907,24371,223.22,96.83,18592.10,0,13.93,12.93,1.05
193,0,2033227,3320,30.41,18622.51,2,2042453,9226,2033227,3320,30.41,96.49,18622.51,1,12.92,14.34,1.56
194,0,2056450,23223,212.70,18835.21,2,2056450,0,2056450,23223,212.70,97.09,18835.21,0,13.99,14.34,0.52
195,0,2072462,16012,146.66,18981.86,2,2078004,5542,2072462,16012,146.66,97.34,18981.86,1,12.69,14.06,1.03
196,0,2080447,7985,73.14,19055.00,2,2088829,8382,2080447,7985,73.14,97.22,19055.00,0,14.39,13.39,0.51
197,0,2083381,2934,26.87,19081.87,2,2095555,12174,2083381,2934,26.87,96.86,19081.87,1,13.45,14.31,1.02
198,0,2098311,14930,136.75,19218.62,2,2104419,6108,2098311,14930,136.75,97.06,19218.62,0,14.33,13.33,0.51
199,0,2098311,0,0.00,19218.62,2,2112102,13791,2098311,0,0.00,96.58,19218.62,0,15.04,14.04,1.01
200,0,2098311,0,0.00,19218.62,2,2115903,17592,2098311,0,0.00,96.09,19218.62,0,15.61,14.61,1.51
201,0,2103897,5586,51.16,19269.78,2,2119424,15527,2103897,5586,51.16,95.87,19269.78,1,14.09,14.61,2.00
202,0,2109450,5553,50.86,19320.64,2,2124362,14912,2109450,5553,50.86,95.65,19320.64,0,15.06,14.06,1.08
203,0,2119877,10427,95.50,19416.14,2,2129985,10108,2119877,10427,95.50,95.65,19416.14,1,13.03,14.11,1.57
204,0,2140442,20565,188.36,19604.50,2,2140442,0,2140442,20565,188.36,96.10,19604.50,0,13.79,14.11,0.58
205,0,2173218,32776,300.20,19904.70,2,2173218,0,2173218,32776,300.20,97.10,19904.70,1,12.69,14.11,1.06
206,0,2205571,32353,296.32,20201.02,2,2205571,0,2205571,32353,296.32,98.06,20201.02,1,12.52,14.11,0.49
207,0,2237902,32331,296.12,20497.14,2,2237902,0,2237902,32331,296.12,99.02,20497.14,0,13.75,14.11,0.49
208,0,2265102,27200,249.13,20746.27,2,2265102,0,2265102,27200,249.13,99.74,20746.27,1,13.13,13.46,0.97
209,0,2270340,5238,47.98,20794.24,2,2279700,9360,2270340,5238,47.98,99.49,20794.24,0,14.42,13.42,0.48
210,0,2276159,5819,53.30,20847.54,2,2286719,10560,2276159,5819,53.30,99.27,20847.54,1,14.21,13.21,0.96
211,0,2276159,0,0.00,20847.54,2,2292489,16330,2276159,0,0.00,98.80,20847.54,0,14.41,13.41,0.48
212,0,2280399,4240,38.83,20886.38,2,2296711,16312,2280399,4240,38.83,98.52,20886.38,1,12.77,13.41,0.95
213,0,2288375,7976,73.05,20959.43,2,2301243,12868,2288375,7976,73.05,98.40,20959.43,0,13.73,12.73,0.47
214,0,2295429,7054,64.61,21024.04,2,2305961,10532,2295429,7054,64.61,98.24,21024.04,1,12.35,13.17,0.94
215,0,2314007,18578,170.16,21194.19,2,2315250,1243,2314007,18578,170.16,98.58,21194.19,1,11.62,13.17,0.47
216,0,2346867,32860,300.97,21495.16,2,2346867,0,2346867,32860,300.97,99.51,21495.16,0,12.36,13.17,0.47
217,0,2356672,9805,89.80,21584.97,2,2364793,8121,2356672,9805,89.80,99.47,21584.97,0,16.25,15.25,0.93
218,0,2378994,22322,204.45,21789.42,2,2378994,0,2378994,22322,204.45,99.95,21789.42,1,15.31,15.34,1.38
219,0,2378994,0,0.00,21789.42,2,2389691,10697,2378994,0,0.00,99.50,21789.42,0,15.96,14.96,0.85
220,0,2386314,7320,67.04,21856.46,2,2396112,9798,2386314,7320,67.04,99.35,21856.46,1,15.17,15.24,1.30
221,0,2387682,1368,12.53,21868.99,2,2401651,13969,2387682,1368,12.53,98.95,21868.99,1,14.30,14.85,0.67
222,0,2399984,12302,112.68,21981.66,2,2407802,7818,2399984,12302,112.68,99.02,21981.66,0,14.31,14.85,0.45
223,0,2427540,27556,252.39,22234.05,2,2427540,0,2427540,27556,252.39,99.70,22234.05,1,14.66,14.85,0.90
224,0,2427540,0,0.00,22234.05,2,2438165,10625,2427540,0,0.00,99.26,22234.05,0,16.26,15.26,0.55
225,0,2440200,12660,115.95,22350.01,2,2445868,5668,2440200,12660,115.95,99.33,22350.01,1,15.00,15.26,0.99
226,0,2441239,1039,9.52,22359.52,2,2453991,12752,2441239,1039,9.52,98.94,22359.52,0,15.70,14.70,0.44
227,0,2445548,4309,39.47,22398.99,2,2458975,13427,2445548,4309,39.47,98.67,22398.99,1,13.78,14.71,0.88
228,0,2457349,11801,108.09,22507.08,2,2466090,8741,2457349,11801,108.09,98.72,22507.08,0,14.95,13.95,0.44
229,0,2462338,4989,45.69,22552.77,2,2472603,10265,2462338,4989,45.69,98.48,22552.77,1,13.25,14.15,0.88
230,0,2484067,21729,199.02,22751.79,2,2484067,0,2484067,21729,199.02,98.92,22751.79,0,13.80,14.15,0.44
231,0,2491271,7204,65.98,22817.77,2,2500477,9206,2491271,7204,65.98,98.78,22817.77,0,15.00,14.00,0.87
232,0,2497040,5769,52.84,22870.61,2,2507183,10143,2497040,5769,52.84,98.58,22870.61,1,12.99,14.07,1.30
233,0,2515394,18354,168.11,23038.71,2,2517501,2107,2515394,18354,168.11,98.88,23038.71,0,14.17,13.17,0.44
234,0,2536181,20787,190.39,23229.11,2,2536181,0,2536181,20787,190.39,99.27,23229.11,1,12.84,13.33,0.87
235,0,2543940,7759,71.07,23300.17,2,2552682,8742,2543940,7759,71.07,99.15,23300.17,0,14.38,13.38,0.43
236,0,2558279,14339,131.33,23431.50,2,2561825,3546,2558279,14339,131.33,99.29,23431.50,1,12.83,13.45,0.85
237,0,2568113,9834,90.07,23521.57,2,2575962,7849,2568113,9834,90.07,99.25,23521.57,0,13.88,12.88,0.42
238,0,2580123,12010,110.00,23631.57,2,2585082,4959,2580123,12010,110.00,99.29,23631.57,1,13.38,13.48,0.84
239,0,2580123,0,0.00,23631.57,2,2593062,12939,2580123,0,0.00,98.88,23631.57,0,13.84,12.84,0.42
240,0,2581130,1007,9.22,23640.80,2,2597048,15918,2581130,1007,9.22,98.50,23640.80,1,12.24,13.06,0.84
241,0,2591918,10788,98.81,23739.61,2,2602442,10524,2591918,10788,98.81,98.50,23739.61,0,12.53,13.06,0.42
242,0,2613694,21776,199.45,23939.05,2,2613694,0,2613694,21776,199.45,98.92,23939.05,1,12.22,13.06,0.83
243,0,2638391,24697,226.20,24165.26,2,2641731,3340,2638391,24697,226.20,99.45,24165.26,1,12.83,11.83,0.41
244,0,2638391,0,0.00,24165.26,2,2650658,12267,2638391,0,0.00,99.04,24165.26,0,13.15,12.15,0.41
245,0,2640229,1838,16.83,24182.09,2,2655961,15732,2640229,1838,16.83,98.70,24182.09,1,12.06,12.43,0.82
246,0,2643549,3320,30.41,24212.50,2,2660524,16975,2643549,3320,30.41,98.42,24212.50,0,12.75,11.75,0.41
247,0,2643549,0,0.00,24212.50,2,2664322,20773,2643549,0,0.00,98.03,24212.50,0,12.92,11.92,0.82
248,0,2644659,1110,10.17,24222.66,2,2667776,23117,2644659,1110,10.17,97.67,24222.66,1,11.21,12.07,1.22
249,0,2651195,6536,59.86,24282.53,2,2671044,19849,2651195,6536,59.86,97.52,24282.53,0,11.37,12.07,0.63
250,0,2657859,6664,61.04,24343.56,2,2674376,16517,2657859,6664,61.04,97.37,24343.56,1,10.08,12.07,1.03
251,0,2665077,7218,66.11,24409.68,2,2677985,12908,2665077,7218,66.11,97.25,24409.68,0,10.52,12.07,0.65
252,0,2676441,11364,104.08,24513.76,2,2683667,7226,2676441,11364,104.08,97.28,24513.76,1,9.25,12.07,1.05
253,0,2704632,28191,258.20,24771.96,2,2704632,0,2704632,28191,258.20,97.91,24771.96,0,10.56,12.07,0.71
254,0,2736118,31486,288.38,25060.35,2,2736118,0,2736118,31486,288.38,98.66,25060.35,1,11.33,12.07,1.10
255,0,2751358,15240,139.58,25199.93,2,2757230,5872,2751358,15240,139.58,98.82,25199.93,1,11.26,10.26,0.93
256,0,2751358,0,0.00,25199.93,2,2764704,13346,2751358,0,0.00,98.44,25199.93,0,11.58,10.58,0.81
257,0,2755541,4183,38.31,25238.24,2,2770130,14589,2755541,4183,38.31,98.20,25238.24,1,10.89,9.89,1.19
258,0,2755541,0,0.00,25238.24,2,2774420,18879,2755541,0,0.00,97.82,25238.24,0,11.36,10.36,1.05
259,0,2755541,0,0.00,25238.24,2,2778032,22491,2755541,0,0.00,97.44,25238.24,0,11.41,10.41,1.43
260,0,2760460,4919,45.05,25283.30,2,2781559,21099,2760460,4919,45.05,97.24,25283.30,1,10.37,10.51,1.82
261,0,2765171,4711,43.15,25326.45,2,2784974,19803,2765171,4711,43.15,97.04,25326.45,1,9.69,8.69,1.49
262,0,2765793,622,5.70,25332.14,2,2788066,22273,2765793,622,5.70,96.69,25332.14,1,8.50,8.79,1.29
263,0,2772069,6276,57.48,25389.62,2,2791204,19135,2772069,6276,57.48,96.54,25389.62,0,8.55,8.79,1.02
264,0,2778762,6693,61.30,25450.93,2,2794551,15789,2778762,6693,61.30,96.41,25450.93,1,7.46,9.80,1.40
265,0,2787470,8708,79.76,25530.68,2,2798905,11435,2787470,8708,79.76,96.34,25530.68,0,7.81,9.80,1.01
266,0,2806862,19392,177.61,25708.30,2,2808601,1739,2806862,19392,177.61,96.65,25708.30,1,7.23,9.80,1.39
267,0,2840781,33919,310.67,26018.96,2,2840781,0,2840781,33919,310.67,97.45,26018.96,0,8.99,9.80,0.85
268,0,2857841,17060,156.25,26175.22,2,2860677,2836,2857841,17060,156.25,97.67,26175.22,1,9.04,9.27,1.22
269,0,2858447,606,5.55,26180.77,2,2870539,12092,2858447,606,5.55,97.33,26180.77,0,9.56,8.56,0.86
270,0,2858447,0,0.00,26180.77,2,2875940,17493,2858447,0,0.00,96.97,26180.77,0,9.95,8.95,1.23
271,0,2864335,5888,53.93,26234.70,2,2880250,15915,2864335,5888,53.93,96.81,26234.70,1,8.61,9.24,1.59
272,0,2873769,9434,86.41,26321.10,2,2884967,11198,2873769,9434,86.41,96.77,26321.10,0,8.76,9.24,1.00
273,0,2891611,17842,163.42,26484.52,2,2893888,2277,2891611,17842,163.42,97.01,26484.52,1,6.07,9.24,1.36
274,0,2926885,35274,323.08,26807.60,2,2926885,0,2926885,35274,323.08,97.84,26807.60,0,7.96,9.24,0.39
275,0,2935493,8608,78.84,26886.44,2,2944201,8708,2935493,8608,78.84,97.77,26886.44,1,9.05,9.61,0.75
276,0,2946303,10810,99.01,26985.45,2,2954508,8205,2946303,10810,99.01,97.77,26985.45,0,10.12,9.12,0.37
277,0,2948633,2330,21.34,27006.79,2,2961031,12398,2948633,2330,21.34,97.50,27006.79,1,9.24,9.96,0.73
278,0,2967509,18876,172.89,27179.68,2,2970469,2960,2967509,18876,172.89,97.77,27179.68,0,9.69,9.96,0.36
279,0,2979563,12054,110.40,27290.08,2,2987209,7646,2979563,12054,110.40,97.81,27290.08,0,10.31,9.31,0.72
280,0,2981313,1750,16.03,27306.11,2,2994628,13315,2981313,1750,16.03,97.52,27306.11,1,9.51,10.29,1.08
281,0,2998001,16688,152.85,27458.96,2,3002972,4971,2998001,16688,152.85,97.72,27458.96,0,9.73,10.29,0.59
282,0,3014623,16622,152.24,27611.20,2,3016292,1669,3014623,16622,152.24,97.91,27611.20,1,9.23,9.74,0.95
283,0,3015155,532,4.87,27616.07,2,3026262,11107,3015155,532,4.87,97.58,27616.07,0,10.42,9.42,0.43
284,0,3022527,7372,67.52,27683.59,2,3032949,10422,3022527,7372,67.52,97.48,27683.59,1,8.80,9.71,0.78
285,0,3044761,22234,203.64,27887.23,2,3045313,552,3044761,22234,203.64,97.85,27887.23,1,9.79,8.79,0.35
286,0,3044761,0,0.00,27887.23,2,3055800,11039,3044761,0,0.00,97.51,27887.23,0,10.00,9.00,0.35
287,0,3044761,0,0.00,27887.23,2,3061597,16836,3044761,0,0.00,97.17,27887.23,0,10.46,9.46,0.70
288,0,3050383,5622,51.49,27938.73,2,3066297,15914,3050383,5622,51.49,97.01,27938.73,1,9.42,9.61,1.05
289,0,3058687,8304,76.06,28014.78,2,3071251,12564,3058687,8304,76.06,96.94,28014.78,1,8.41,8.93,0.71
290,0,3070885,12198,111.72,28126.51,2,3077350,6465,3070885,12198,111.72,96.99,28126.51,0,8.77,8.93,0.36
291,0,3071292,407,3.73,28130.23,2,3084880,13588,3071292,407,3.73,96.67,28130.23,0,9.49,8.49,0.71
292,0,3084240,12948,118.59,28248.83,2,3092070,7830,3084240,12948,118.59,96.74,28248.83,1,8.33,8.49,1.05
293,0,3110972,26732,244.84,28493.67,2,3110972,0,3110972,26732,244.84,97.25,28493.67,1,8.72,9.56,0.87
294,0,3139729,28757,263.39,28757.05,2,3142165,2436,3139729,28757,263.39,97.81,28757.05,0,9.76,8.76,0.66
295,0,3160371,20642,189.06,28946.12,2,3163788,3417,3160371,20642,189.06,98.12,28946.12,1,9.21,8.21,1.00
296,0,3160371,0,0.00,28946.12,2,3172029,11658,3160371,0,0.00,97.79,28946.12,0,9.95,8.95,0.64
297,0,3170507,10136,92.84,29038.95,2,3178022,7515,3170507,10136,92.84,97.77,29038.95,1,8.45,8.95,0.98
298,0,3184721,14214,130.19,29169.14,2,3189090,4369,3184721,14214,130.19,97.88,29169.14,0,9.48,8.48,0.59
299,0,3190451,5730,52.48,29221.62,2,3197621,7170,3190451,5730,52.48,97.73,29221.62,1,8.46,8.84,0.93
300,0,3217551,27100,248.21,29469.83,2,3217551,0,3217551,27100,248.21,98.23,29469.83,0,9.59,9.95,0.47
301,0,3225911,8360,76.57,29546.40,2,3232264,6353,3225911,8360,76.57,98.16,29546.40,1,8.85,9.71,0.80
302,0,3240082,14171,129.79,29676.20,2,3245788,5706,3240082,14171,129.79,98.27,29676.20,0,10.85,9.85,0.33
303,0,3253089,13007,119.13,29795.33,2,3256059,2970,3253089,13007,119.13,98.33,29795.33,1,9.71,9.98,0.66
304,0,3272263,19174,175.62,29970.95,2,3277714,5451,3272263,19174,175.62,98.59,29970.95,0,10.67,9.67,0.33
305,0,3282865,10602,97.10,30068.05,2,3287245,4380,3282865,10602,97.10,98.58,30068.05,1,10.08,10.22,0.66
306,0,3283283,418,3.83,30071.88,2,3296088,12805,3283283,418,3.83,98.27,30071.88,0,10.94,9.94,0.33
307,0,3293856,10573,96.84,30168.72,2,3302062,8206,3293856,10573,96.84,98.27,30168.72,1,9.32,9.94,0.65
308,0,3312996,19140,175.30,30344.02,2,3316520,3524,3312996,19140,175.30,98.52,30344.02,0,10.43,9.43,0.33
309,0,3335203,22207,203.40,30547.42,2,3335203,0,3335203,22207,203.40,98.86,30547.42,1,9.43,9.65,0.65
310,0,3341429,6226,57.02,30604.44,2,3350540,9111,3341429,6226,57.02,98.72,30604.44,0,10.80,9.80,0.32
311,0,3346659,5230,47.90,30652.35,2,3357309,10650,3346659,5230,47.90,98.56,30652.35,1,8.80,9.93,0.65
312,0,3365203,18544,169.85,30822.19,2,3366581,1378,3365203,18544,169.85,98.79,30822.19,0,9.43,9.93,0.32
313,0,3382343,17140,156.99,30979.18,2,3382343,0,3382343,17140,156.99,98.98,30979.18,1,8.76,9.06,0.64
314,0,3385657,3314,30.35,31009.53,2,3395959,10302,3385657,3314,30.35,98.76,31009.53,0,9.40,8.40,0.32
315,0,3391015,5358,49.07,31058.61,2,3402213,11198,3391015,5358,49.07,98.60,31058.61,1,7.09,8.70,0.64
316,0,3410821,19806,181.40,31240.01,2,3412116,1295,3410821,19806,181.40,98.86,31240.01,0,8.35,8.70,0.32
317,0,3445601,34780,318.55,31558.56,2,3445601,0,3445601,34780,318.55,99.55,31558.56,1,8.23,9.81,0.63
318,0,3480684,35083,321.33,31879.89,2,3480684,0,3480684,35083,321.33,100.25,31879.89,0,9.60,9.81,0.32
319,0,3480684,0,0.00,31879.89,2,3491493,10809,3480684,0,0.00,99.94,31879.89,0,10.60,9.60,0.63
320,0,3487432,6748,61.81,31941.70,2,3498121,10689,3487432,6748,61.81,99.82,31941.70,1,9.04,9.94,0.94
321,0,3509479,22047,201.93,32143.63,2,3509479,0,3509479,22047,201.93,100.14,32143.63,0,9.86,9.94,0.49
322,0,3526210,16731,153.24,32296.87,2,3528664,2454,3526210,16731,153.24,100.30,32296.87,1,9.46,8.46,0.80
323,0,3526210,0,0.00,32296.87,2,3538251,12041,3526210,0,0.00,99.99,32296.87,0,10.88,9.88,0.41
324,0,3535887,9677,88.63,32385.50,2,3546096,10209,3535887,9677,88.63,99.96,32385.50,1,10.11,9.11,0.72
325,0,3538204,2317,21.22,32406.72,2,3551476,13272,3538204,2317,21.22,99.71,32406.72,1,9.39,9.77,0.38
326,0,3543363,5159,47.25,32453.97,2,3556839,13476,3543363,5159,47.25,99.55,32453.97,0,9.98,8.98,0.31
327,0,3547167,3804,34.84,32488.81,2,3561258,14091,3547167,3804,34.84,99.35,32488.81,1,8.62,9.32,0.61
328,0,3553226,6059,55.49,32544.31,2,3567073,13847,3553226,6059,55.49,99.22,32544.31,0,9.42,8.42,0.31
329,0,3564471,11245,102.99,32647.30,2,3573223,8752,3564471,11245,102.99,99.23,32647.30,1,8.64,9.58,0.61
330,0,3589277,24806,227.20,32874.50,2,3589277,0,3589277,24806,227.20,99.62,32874.50,0,8.98,9.58,0.30
331,0,3618903,29626,271.35,33145.85,2,3618903,0,3618903,29626,271.35,100.14,33145.85,1,8.67,9.59,0.61
332,0,3632813,13910,127.40,33273.25,2,3640363,7550,3632813,13910,127.40,100.22,33273.25,0,10.41,9.41,0.30
333,0,3638840,6027,55.20,33328.46,2,3647982,9142,3638840,6027,55.20,100.09,33328.46,1,9.25,9.67,0.60
334,0,3659173,20333,186.23,33514.69,2,3661099,1926,3659173,20333,186.23,100.34,33514.69,0,9.94,8.94,0.30
335,0,3659173,0,0.00,33514.69,2,3670895,11722,3659173,0,0.00,100.04,33514.69,0,10.66,9.66,0.60
336,0,3659765,592,5.42,33520.11,2,3676950,17185,3659765,592,5.42,99.76,33520.11,1,8.91,9.98,0.90
337,0,3669863,10098,92.49,33612.60,2,3681999,12136,3669863,10098,92.49,99.74,33612.60,0,9.55,9.98,0.40
338,0,3684081,14218,130.22,33742.82,2,3689108,5027,3684081,14218,130.22,99.83,33742.82,1,8.11,9.98,0.69
339,0,3715868,31787,291.14,34033.96,2,3715868,0,3715868,31787,291.14,100.40,34033.96,0,9.46,9.98,0.41
340,0,3716250,382,3.50,34037.46,2,3725988,9738,3716250,382,3.50,100.11,34037.46,0,11.36,10.36,0.70
341,0,3716250,0,0.00,34037.46,2,3731627,15377,3716250,0,0.00,99.82,34037.46,0,12.16,11.16,0.99
342,0,3722690,6440,58.98,34096.45,2,3736286,13596,3722690,6440,58.98,99.70,34096.45,1,10.79,11.28,1.28
343,0,3733876,11186,102.45,34198.90,2,3741879,8003,3733876,11186,102.45,99.71,34198.90,1,9.85,11.28,0.86
344,0,3756686,22810,208.92,34407.82,2,3756686,0,3756686,22810,208.92,100.02,34407.82,0,11.12,11.28,0.77
345,0,3756686,0,0.00,34407.82,2,3767124,10438,3756686,0,0.00,99.73,34407.82,0,11.65,10.65,1.06
346,0,3763509,6823,62.49,34470.31,2,3774757,11248,3763509,6823,62.49,99.63,34470.31,1,10.82,9.82,1.35
347,0,3768467,4958,45.41,34515.72,2,3779628,11161,3768467,4958,45.41,99.47,34515.72,1,9.72,9.89,1.07
348,0,3774088,5621,51.48,34567.20,2,3785203,11115,3774088,5621,51.48,99.33,34567.20,1,8.96,9.07,0.86
349,0,3776940,2852,26.12,34593.33,2,3790886,13946,3776940,2852,26.12,99.12,34593.33,0,9.76,8.76,0.74
350,0,3784513,7573,69.36,34662.69,2,3795811,11298,3784513,7573,69.36,99.04,34662.69,1,9.00,10.00,1.02
351,0,3802169,17656,161.71,34824.40,2,3804639,2470,3802169,17656,161.71,99.21,34824.40,1,8.43,10.00,0.88
352,0,3834257,32088,293.90,35118.30,2,3834550,293,3834257,32088,293.90,99.77,35118.30,0,10.10,9.10,0.70
353,0,3849917,15660,143.43,35261.73,2,3854795,4878,3849917,15660,143.43,99.89,35261.73,1,10.02,9.02,0.99
354,0,3849917,0,0.00,35261.73,2,3863223,13306,3849917,0,0.00,99.61,35261.73,0,10.82,9.82,0.78
355,0,3860590,10673,97.75,35359.48,2,3869559,8969,3860590,10673,97.75,99.60,35359.48,1,9.12,9.82,1.06
356,0,3884254,23664,216.74,35576.23,2,3885084,830,3884254,23664,216.74,99.93,35576.23,0,10.12,9.12,0.67
357,0,3906095,21841,200.04,35776.27,2,3906095,0,3906095,21841,200.04,100.21,35776.27,1,9.47,9.60,0.95
358,0,3906095,0,0.00,35776.27,2,3916089,9994,3906095,0,0.00,99.93,35776.27,0,9.94,8.94,0.59
359,0,3906095,0,0.00,35776.27,2,3921778,15683,3906095,0,0.00,99.66,35776.27,0,10.85,9.85,0.87
360,0,3907153,1058,9.69,35785.96,2,3926320,19167,3907153,1058,9.69,99.41,35785.96,1,9.71,10.81,1.14
361,0,3916051,8898,81.50,35867.46,2,3930769,14718,3916051,8898,81.50,99.36,35867.46,0,9.95,10.81,0.67
362,0,3925865,9814,89.89,35957.34,2,3935676,9811,3925865,9814,89.89,99.33,35957.34,1,9.30,10.81,0.94
363,0,3944467,18602,170.38,36127.72,2,3944977,510,3944467,18602,170.38,99.53,36127.72,1,8.64,10.81,0.73
364,0,3978944,34477,315.78,36443.50,2,3978944,0,3978944,34477,315.78,100.12,36443.50,0,9.91,10.81,0.48
365,0,4013117,34173,312.99,36756.49,2,4013117,0,4013117,34173,312.99,100.70,36756.49,1,10.16,10.81,0.75
366,0,4042204,29087,266.41,37022.90,2,4044331,2127,4042204,29087,266.41,101.16,37022.90,0,11.25,10.25,0.54
367,0,4044868,2664,24.40,37047.30,2,4054089,9221,4044868,2664,24.40,100.95,37047.30,1,9.89,10.87,0.81
368,0,4068048,23180,212.31,37259.61,2,4068048,0,4068048,23180,212.31,101.25,37259.61,0,10.52,10.87,0.29
369,0,4079747,11699,107.15,37366.76,2,4084628,4881,4079747,11699,107.15,101.26,37366.76,1,10.63,9.63,0.56
370,0,4079747,0,0.00,37366.76,2,4093587,13840,4079747,0,0.00,100.99,37366.76,0,11.90,10.90,0.38
371,0,4085696,5949,54.49,37421.25,2,4098917,13221,4085696,5949,54.49,100.87,37421.25,1,10.88,11.86,0.65
372,0,4098972,13276,121.60,37542.85,2,4105555,6583,4098972,13276,121.60,100.92,37542.85,0,11.49,11.86,0.27
373,0,4109607,10635,97.41,37640.25,2,4116385,6778,4109607,10635,97.41,100.91,37640.25,1,11.36,10.36,0.54
374,0,4109607,0,0.00,37640.25,2,4123691,14084,4109607,0,0.00,100.64,37640.25,0,11.80,10.80,0.27
375,0,4109607,0,0.00,37640.25,2,4127915,18308,4109607,0,0.00,100.37,37640.25,0,11.87,10.87,0.53
376,0,4114393,4786,43.84,37684.09,2,4130827,16434,4114393,4786,43.84,100.22,37684.09,1,10.80,10.87,0.80
377,0,4117511,3118,28.56,37712.64,2,4134612,17101,4117511,3118,28.56,100.03,37712.64,1,10.23,9.23,0.29
378,0,4117511,0,0.00,37712.64,2,4137742,20231,4117511,0,0.00,99.77,37712.64,0,10.26,9.26,0.27
379,0,4118090,579,5.30,37717.95,2,4140353,22263,4118090,579,5.30,99.52,37717.95,1,9.06,9.64,0.53
380,0,4123534,5444,49.86,37767.81,2,4143075,19541,4123534,5444,49.86,99.39,37767.81,0,9.13,9.64,0.26
381,0,4130068,6534,59.85,37827.66,2,4146342,16274,4130068,6534,59.85,99.29,37827.66,1,7.70,9.64,0.53
382,0,4139330,9262,84.83,37912.49,2,4150973,11643,4139330,9262,84.83,99.25,37912.49,1,7.01,9.64,0.29
383,0,4157542,18212,166.81,38079.29,2,4160079,2537,4157542,18212,166.81,99.42,38079.29,0,7.87,9.64,0.26
384,0,4191464,33922,310.69,38389.99,2,4191464,0,4191464,33922,310.69,99.97,38389.99,1,7.75,9.64,0.52
385,0,4226713,35249,322.85,38712.84,2,4226713,0,4226713,35249,322.85,100.55,38712.84,0,9.08,9.64,0.34
386,0,4240262,13549,124.10,38836.93,2,4246728,6466,4240262,13549,124.10,100.61,38836.93,1,8.46,9.14,0.60
387,0,4268628,28366,259.81,39096.74,2,4268628,0,4268628,28366,259.81,101.03,39096.74,0,8.90,9.14,0.31
388,0,4268639,11,0.10,39096.84,2,4279071,10432,4268639,11,0.10,100.77,39096.84,0,9.80,8.80,0.56
389,0,4283723,15084,138.16,39235.00,2,4287697,3974,4283723,15084,138.16,100.86,39235.00,1,8.38,8.80,0.82
390,0,4309273,25550,234.01,39469.01,2,4312204,2931,4309273,25550,234.01,101.20,39469.01,0,9.21,8.21,0.43
391,0,4309273,0,0.00,39469.01,2,4321436,12163,4309273,0,0.00,100.94,39469.01,0,11.04,10.04,0.68
392,0,4309273,0,0.00,39469.01,2,4326996,17723,4309273,0,0.00,100.69,39469.01,0,11.04,10.04,0.94
393,0,4317014,7741,70.90,39539.91,2,4331727,14713,4317014,7741,70.90,100.61,39539.91,1,9.49,10.04,1.19
394,0,4322865,5851,53.59,39593.50,2,4336564,13699,4322865,5851,53.59,100.49,39593.50,1,9.24,9.78,0.63
395,0,4335681,12816,117.38,39710.88,2,4342972,7291,4335681,12816,117.38,100.53,39710.88,0,9.65,9.78,0.38
396,0,4337864,2183,19.99,39730.88,2,4350895,13031,4337864,2183,19.99,100.33,39730.88,0,11.05,10.05,0.63
397,0,4347730,9866,90.36,39821.24,2,4356927,9197,4347730,9866,90.36,100.31,39821.24,1,8.35,10.07,0.88
398,0,4370962,23232,212.78,40034.03,2,4370962,0,4370962,23232,212.78,100.59,40034.03,1,8.06,10.07,0.25
399,0,4393398,22436,205.49,40239.52,2,4398402,5004,4393398,22436,205.49,100.85,40239.52,0,10.58,9.58,0.25
400,0,4393398,0,0.00,40239.52,2,4406654,13256,4393398,0,0.00,100.60,40239.52,0,11.28,10.28,0.50
401,0,4393398,0,0.00,40239.52,2,4412080,18682,4393398,0,0.00,100.35,40239.52,0,11.28,10.28,0.75
402,0,4394390,992,9.09,40248.61,2,4416489,22099,4394390,992,9.09,100.12,40248.61,1,9.62,10.28,1.00
403,0,4402228,7838,71.79,40320.39,2,4420408,18180,4402228,7838,71.79,100.05,40320.39,0,9.94,10.28,0.72
404,0,4410358,8130,74.46,40394.86,2,4424473,14115,4410358,8130,74.46,99.99,40394.86,1,8.34,10.28,0.96
405,0,4419564,9206,84.32,40479.18,2,4429076,9512,4419564,9206,84.32,99.95,40479.18,1,7.83,10.28,0.68
406,0,4444215,24651,225.78,40704.96,2,4444215,0,4444215,24651,225.78,100.26,40704.96,0,9.32,10.28,0.65
407,0,4479158,34943,320.05,41025.00,2,4479158,0,4479158,34943,320.05,100.80,41025.00,1,9.67,10.28,0.89
408,0,4486179,7021,64.31,41089.31,2,4495291,9112,4486179,7021,64.31,100.71,41089.31,1,10.99,9.99,0.82
409,0,4486179,0,0.00,41089.31,2,4501685,15506,4486179,0,0.00,100.46,41089.31,0,11.66,10.66,0.76
410,0,4490656,4477,41.01,41130.31,2,4506862,16206,4490656,4477,41.01,100.32,41130.31,1,10.89,9.89,1.00
411,0,4490656,0,0.00,41130.31,2,4510876,20220,4490656,0,0.00,100.07,41130.31,1,10.25,9.25,0.88
412,0,4490656,0,0.00,41130.31,2,4514251,23595,4490656,0,0.00,99.83,41130.31,0,10.45,9.45,0.91
413,0,4496536,5880,53.86,41184.17,2,4517494,20958,4496536,5880,53.86,99.72,41184.17,1,8.90,9.45,1.15
414,0,4503366,6830,62.56,41246.73,2,4520909,17543,4503366,6830,62.56,99.63,41246.73,0,8.98,9.45,0.91
415,0,4510860,7494,68.64,41315.36,2,4524656,13796,4510860,7494,68.64,99.56,41315.36,1,7.84,9.45,1.15
416,0,4521638,10778,98.72,41414.08,2,4530045,8407,4521638,10778,98.72,99.55,41414.08,0,8.38,9.45,0.97
417,0,4546933,25295,231.68,41645.76,2,4546933,0,4546933,25295,231.68,99.87,41645.76,1,8.06,9.45,1.21
418,0,4568614,21681,198.58,41844.34,2,4573655,5041,4568614,21681,198.58,100.11,41844.34,0,9.93,8.93,0.97
419,0,4568949,335,3.07,41847.41,2,4581812,12863,4568949,335,3.07,99.87,41847.41,1,10.01,9.01,1.20
420,0,4568949,0,0.00,41847.41,2,4587027,18078,4568949,0,0.00,99.64,41847.41,0,10.65,9.65,1.06
421,0,4570573,1624,14.87,41862.28,2,4591237,20664,4570573,1624,14.87,99.44,41862.28,1,10.07,9.07,1.30
422,0,4570573,0,0.00,41862.28,2,4594923,24350,4570573,0,0.00,99.20,41862.28,0,10.09,9.09,1.17
423,0,4577049,6476,59.31,41921.59,2,4598253,21204,4577049,6476,59.31,99.11,41921.59,1,8.76,9.09,1.41
424,0,4583707,6658,60.98,41982.58,2,4601582,17875,4583707,6658,60.98,99.02,41982.58,0,8.97,9.09,1.19
425,0,4590639,6932,63.49,42046.07,2,4605048,14409,4590639,6932,63.49,98.93,42046.07,1,7.30,9.09,1.43
426,0,4598283,7644,70.01,42116.08,2,4608870,10587,4598283,7644,70.01,98.86,42116.08,0,7.45,9.09,1.14
427,0,4615741,17458,159.90,42275.98,2,4617599,1858,4615741,17458,159.90,99.01,42275.98,1,6.41,9.09,1.37
428,0,4650279,34538,316.34,42592.32,2,4650279,0,4650279,34538,316.34,99.51,42592.32,0,7.67,9.09,1.10
429,0,4684672,34393,315.01,42907.32,2,4684672,0,4684672,34393,315.01,100.02,42907.32,1,8.23,9.09,1.34
430,0,4693814,9142,83.73,42991.05,2,4700270,6456,4693814,9142,83.73,99.98,42991.05,1,8.38,9.38,1.09
431,0,4723144,29330,268.64,43259.69,2,4723144,0,4723144,29330,268.64,100.37,43259.69,0,8.95,9.38,0.91
432,0,4729040,5896,54.00,43313.70,2,4738391,9351,4729040,5896,54.00,100.26,43313.70,0,10.03,9.03,1.14
433,0,4729040,0,0.00,43313.70,2,4744537,15497,4729040,0,0.00,100.03,43313.70,0,10.39,9.39,1.37
434,0,4737366,8326,76.26,43389.95,2,4749568,12202,4737366,8326,76.26,99.98,43389.95,1,8.88,9.39,1.60
435,0,4754954,17588,161.09,43551.04,2,4758362,3408,4754954,17588,161.09,100.12,43551.04,0,9.25,9.39,1.38
436,0,4775311,20357,186.45,43737.50,2,4775311,0,4775311,20357,186.45,100.32,43737.50,1,7.83,8.85,1.60
437,0,4799717,24406,223.54,43961.03,2,4803641,3924,4799717,24406,223.54,100.60,43961.03,0,11.39,10.39,1.14
438,0,4799717,0,0.00,43961.03,2,4812498,12781,4799717,0,0.00,100.37,43961.03,0,12.45,11.45,1.36
439,0,4807934,8217,75.26,44036.29,2,4818635,10701,4807934,8217,75.26,100.31,44036.29,1,10.91,11.45,1.59
440,0,4828606,20672,189.34,44225.63,2,4828971,365,4828606,20672,189.34,100.51,44225.63,0,11.39,11.45,1.23
441,0,4828735,129,1.18,44226.81,2,4838835,10100,4828735,129,1.18,100.29,44226.81,1,11.43,11.83,1.46
442,0,4835881,7146,65.45,44292.26,2,4846541,10660,4835881,7146,65.45,100.21,44292.26,0,12.70,11.70,1.27
443,0,4837335,1454,13.32,44305.58,2,4851901,14566,4837335,1454,13.32,100.01,44305.58,1,11.15,12.11,1.50
444,0,4849989,12654,115.90,44421.48,2,4858228,8239,4849989,12654,115.90,100.05,44421.48,0,11.35,12.11,1.16
445,0,4874510,24521,224.59,44646.07,2,4874510,0,4874510,24521,224.59,100.33,44646.07,1,11.36,12.11,1.38
446,0,4894858,20348,186.37,44832.44,2,4897796,2938,4894858,20348,186.37,100.52,44832.44,1,12.65,11.65,1.21
447,0,4894858,0,0.00,44832.44,2,4906581,11723,4894858,0,0.00,100.30,44832.44,0,13.48,12.48,1.13
448,0,4909772,14914,136.60,44969.04,2,4914533,4761,4909772,14914,136.60,100.38,44969.04,1,12.46,12.48,1.36
449,0,4915975,6203,56.81,45025.85,2,4922956,6981,4915975,6203,56.81,100.28,45025.85,1,11.76,11.90,1.22
450,0,4916210,235,2.15,45028.00,2,4929699,13489,4916210,235,2.15,100.06,45028.00,0,12.63,11.63,1.06
451,0,4923910,7700,70.52,45098.53,2,4935142,11232,4923910,7700,70.52,100.00,45098.53,1,11.74,10.74,1.28
452,0,4923910,0,0.00,45098.53,2,4940152,16242,4923910,0,0.00,99.78,45098.53,0,11.88,10.88,1.10
453,0,4930746,6836,62.61,45161.14,2,4944277,13531,4930746,6836,62.61,99.69,45161.14,1,10.17,10.88,1.32
454,0,4945058,14312,131.08,45292.22,2,4951433,6375,4945058,14312,131.08,99.76,45292.22,1,9.31,10.88,1.05
455,0,4973439,28381,259.94,45552.17,2,4973439,0,4973439,28381,259.94,100.11,45552.17,0,9.64,10.88,0.93
456,0,4989470,16031,146.83,45699.00,2,4995749,6279,4989470,16031,146.83,100.22,45699.00,0,11.81,10.81,1.15
457,0,4995604,6134,56.18,45755.18,2,5005187,9583,4995604,6134,56.18,100.12,45755.18,1,11.93,10.93,1.36
458,0,4995604,0,0.00,45755.18,2,5011280,15676,4995604,0,0.00,99.90,45755.18,0,12.14,11.14,1.13
459,0,4995604,0,0.00,45755.18,2,5015449,19845,4995604,0,0.00,99.68,45755.18,0,12.28,11.28,1.35
460,0,4995604,0,0.00,45755.18,2,5019064,23460,4995604,0,0.00,99.47,45755.18,0,12.56,11.56,1.56
461,0,4996310,706,6.47,45761.64,2,5022230,25920,4996310,706,6.47,99.27,45761.64,1,10.51,11.56,1.78
462,0,5002436,6126,56.11,45817.75,2,5025293,22857,5002436,6126,56.11,99.17,45817.75,0,10.94,11.56,1.42
463,0,5008904,6468,59.24,45876.99,2,5028527,19623,5008904,6468,59.24,99.09,45876.99,1,9.58,11.56,1.63
464,0,5015392,6488,59.42,45936.42,2,5031771,16379,5015392,6488,59.42,99.00,45936.42,0,9.74,11.56,1.42
465,0,5022240,6848,62.72,45999.14,2,5035195,12955,5022240,6848,62.72,98.92,45999.14,1,8.46,11.56,1.63
466,0,5031948,9708,88.92,46088.05,2,5040049,8101,5031948,9708,88.92,98.90,46088.05,1,7.39,11.56,1.42
467,0,5057548,25600,234.47,46322.53,2,5057548,0,5057548,25600,234.47,99.19,46322.53,1,6.66,11.56,1.25
468,0,5090982,33434,306.22,46628.75,2,5090982,0,5090982,33434,306.22,99.63,46628.75,0,8.41,11.56,1.16
469,0,5124863,33881,310.32,46939.07,2,5124863,0,5124863,33881,310.32,100.08,46939.07,1,9.74,11.56,1.37
470,0,5157720,32857,300.94,47240.01,2,5157720,0,5157720,32857,300.94,100.51,47240.01,0,10.39,11.56,1.15
471,0,5191337,33617,307.90,47547.91,2,5191337,0,5191337,33617,307.90,100.95,47547.91,1,9.72,11.56,1.36
472,0,5219048,27711,253.81,47801.72,2,5221603,2555,5219048,27711,253.81,101.27,47801.72,0,11.96,10.96,1.15
473,0,5241070,22022,201.70,48003.42,2,5244079,3009,5241070,22022,201.70,101.49,48003.42,1,11.75,10.75,1.36
474,0,5241070,0,0.00,48003.42,2,5253057,11987,5241070,0,0.00,101.27,48003.42,0,13.11,12.11,0.98
475,0,5250436,9366,85.78,48089.21,2,5259297,8861,5250436,9366,85.78,101.24,48089.21,1,11.92,12.11,1.18
476,0,5252716,2280,20.88,48110.09,2,5265796,13080,5252716,2280,20.88,101.07,48110.09,0,12.29,11.29,0.84
477,0,5252999,283,2.59,48112.68,2,5269935,16936,5252999,283,2.59,100.87,48112.68,1,10.56,12.20,1.05
478,0,5261327,8328,76.28,48188.96,2,5274099,12772,5261327,8328,76.28,100.81,48188.96,0,10.86,12.20,0.55
479,0,5276027,14700,134.64,48323.60,2,5281449,5422,5276027,14700,134.64,100.88,48323.60,0,11.88,12.20,0.76
480,0,5287307,11280,103.31,48426.91,2,5292473,5166,5287307,11280,103.31,100.89,48426.91,1,11.76,10.76,0.96
481,0,5287307,0,0.00,48426.91,2,5299756,12449,5287307,0,0.00,100.68,48426.91,0,12.45,11.45,0.67
482,0,5293543,6236,57.12,48484.03,2,5304835,11292,5293543,6236,57.12,100.59,48484.03,1,11.25,11.74,0.87
483,0,5296093,2550,23.36,48507.38,2,5310818,14725,5296093,2550,23.36,100.43,48507.38,0,12.19,11.19,0.46
484,0,5304811,8718,79.85,48587.23,2,5315620,10809,5304811,8718,79.85,100.39,48587.23,1,10.70,11.22,0.67
485,0,5321114,16303,149.32,48736.55,2,5324055,2941,5321114,16303,149.32,100.49,48736.55,0,11.28,10.28,0.41
486,0,5332668,11554,105.82,48842.38,2,5334725,2057,5332668,11554,105.82,100.50,48842.38,1,10.99,11.00,0.61
487,0,5332668,0,0.00,48842.38,2,5344024,11356,5332668,0,0.00,100.29,48842.38,0,11.82,10.82,0.40
488,0,5344326,11658,106.78,48949.15,2,5350725,6399,5344326,11658,106.78,100.31,48949.15,1,10.22,10.82,0.60
489,0,5368225,23899,218.89,49168.05,2,5370689,2464,5368225,23899,218.89,100.55,49168.05,0,11.24,10.24,0.35
490,0,5384249,16024,146.77,49314.81,2,5384249,0,5384249,16024,146.77,100.64,49314.81,1,10.45,10.74,0.56
491,0,5398622,14373,131.64,49446.45,2,5405545,6923,5398622,14373,131.64,100.71,49446.45,1,9.68,10.15,0.29
492,0,5407529,8907,81.58,49528.04,2,5416071,8542,5407529,8907,81.58,100.67,49528.04,0,10.66,9.66,0.20
493,0,5410553,3024,27.70,49555.73,2,5422718,12165,5410553,3024,27.70,100.52,49555.73,1,9.79,10.05,0.41
494,0,5428915,18362,168.18,49723.91,2,5431899,2984,5428915,18362,168.18,100.66,49723.91,0,9.96,10.05,0.24
495,0,5443063,14148,129.58,49853.49,2,5443374,311,5443063,14148,129.58,100.71,49853.49,1,8.57,9.13,0.45
496,0,5445611,2548,23.34,49876.83,2,5455588,9977,5445611,2548,23.34,100.56,49876.83,0,10.40,9.40,0.24
497,0,5452679,7068,64.74,49941.57,2,5462733,10054,5452679,7068,64.74,100.49,49941.57,1,9.87,8.87,0.45
498,0,5452679,0,0.00,49941.57,2,5468704,16025,5452679,0,0.00,100.28,49941.57,0,10.24,9.24,0.21
499,0,5452679,0,0.00,49941.57,2,5472499,19820,5452679,0,0.00,100.08,49941.57,0,10.81,9.81,0.41
500,0,5458891,6212,56.90,49998.46,2,5475802,16911,5458891,6212,56.90,100.00,49998.46,1,9.40,9.81,0.61
501,0,5466669,7778,71.24,50069.70,2,5479691,13022,5466669,7778,71.24,99.94,50069.70,1,8.04,9.81,0.38
502,0,5479813,13144,120.39,50190.09,2,5486263,6450,5479813,13144,120.39,99.98,50190.09,0,8.38,9.81,0.22
503,0,5509891,30078,275.49,50465.58,2,5509891,0,5509891,30078,275.49,100.33,50465.58,1,8.78,9.81,0.42
504,0,5544550,34659,317.44,50783.02,2,5544550,0,5544550,34659,317.44,100.76,50783.02,1,8.33,9.81,0.31
505,0,5565198,20648,189.12,50972.14,2,5570640,5442,5565198,20648,189.12,100.93,50972.14,0,10.13,9.13,0.20
506,0,5571268,6070,55.60,51027.73,2,5579401,8133,5571268,6070,55.60,100.85,51027.73,1,9.19,9.49,0.40
507,0,5581263,9995,91.55,51119.28,2,5590409,9146,5581263,9995,91.55,100.83,51119.28,0,9.79,8.79,0.27
508,0,5581347,84,0.77,51120.05,2,5596965,15618,5581347,84,0.77,100.63,51120.05,1,8.19,9.32,0.46
509,0,5592243,10896,99.80,51219.85,2,5602413,10170,5592243,10896,99.80,100.63,51219.85,0,8.59,9.32,0.20
510,0,5611581,19338,177.12,51396.96,2,5612082,501,5611581,19338,177.12,100.78,51396.96,0,9.06,9.32,0.39
511,0,5639090,27509,251.96,51648.92,2,5639090,0,5639090,27509,251.96,101.07,51648.92,1,8.43,8.85,0.59
512,0,5646092,7002,64.13,51713.05,2,5655375,9283,5646092,7002,64.13,101.00,51713.05,0,10.76,9.76,0.20
513,0,5659652,13560,124.20,51837.25,2,5664620,4968,5659652,13560,124.20,101.05,51837.25,1,10.25,9.25,0.39
514,0,5659652,0,0.00,51837.25,2,5672431,12779,5659652,0,0.00,100.85,51837.25,0,11.31,10.31,0.19
515,0,5659652,0,0.00,51837.25,2,5676873,17221,5659652,0,0.00,100.65,51837.25,0,11.38,10.38,0.39
516,0,5662518,2866,26.25,51863.50,2,5680266,17748,5662518,2866,26.25,100.51,51863.50,1,8.56,10.38,0.58
517,0,5670628,8110,74.28,51937.78,2,5684321,13693,5670628,8110,74.28,100.46,51937.78,0,8.66,10.38,0.19
518,0,5684258,13630,124.84,52062.62,2,5691136,6878,5684258,13630,124.84,100.51,52062.62,1,7.02,10.38,0.39
519,0,5712381,28123,257.58,52320.20,2,5712381,0,5712381,28123,257.58,100.81,52320.20,0,8.01,10.38,0.19
520,0,5743235,30854,282.59,52602.80,2,5743235,0,5743235,30854,282.59,101.16,52602.80,0,9.83,10.38,0.39
521,0,5753675,10440,95.62,52698.42,2,5756902,3227,5753675,10440,95.62,101.15,52698.42,1,9.17,9.87,0.58
522,0,5784957,31282,286.51,52984.93,2,5785697,740,5784957,31282,286.51,101.50,52984.93,0,10.11,9.11,0.29
523,0,5789287,4330,39.66,53024.59,2,5798102,8815,5789287,4330,39.66,101.39,53024.59,1,10.58,9.58,0.48
524,0,5798356,9069,83.06,53107.65,2,5806454,8098,5798356,9069,83.06,101.35,53107.65,1,9.81,8.81,0.39
525,0,5798356,0,0.00,53107.65,2,5813262,14906,5798356,0,0.00,101.16,53107.65,0,10.22,9.22,0.32
526,0,5800922,2566,23.50,53131.16,2,5817338,16416,5800922,2566,23.50,101.01,53131.16,1,8.43,9.34,0.51
527,0,5810680,9758,89.37,53220.53,2,5822217,11537,5810680,9758,89.37,100.99,53220.53,0,8.55,9.34,0.21
528,0,5827326,16646,152.46,53372.99,2,5830540,3214,5827326,16646,152.46,101.09,53372.99,1,8.37,9.34,0.40
529,0,5833931,6605,60.50,53433.49,2,5842786,8855,5833931,6605,60.50,101.01,53433.49,0,10.59,9.59,0.33
530,0,5851825,17894,163.89,53597.38,2,5853837,2012,5851825,17894,163.89,101.13,53597.38,1,9.78,8.78,0.52
531,0,5858202,6377,58.41,53655.79,2,5863553,5351,5858202,6377,58.41,101.05,53655.79,1,9.57,9.80,0.36
532,0,5858837,635,5.82,53661.61,2,5871668,12831,5858837,635,5.82,100.87,53661.61,0,10.77,9.77,0.19
533,0,5863347,4510,41.31,53702.91,2,5877626,14279,5863347,4510,41.31,100.76,53702.91,1,10.10,9.10,0.38
534,0,5863347,0,0.00,53702.91,2,5881781,18434,5863347,0,0.00,100.57,53702.91,0,10.72,9.72,0.27
535,0,5866023,2676,24.51,53727.42,2,5885079,19056,5866023,2676,24.51,100.43,53727.42,1,8.71,9.72,0.45
536,0,5873239,7216,66.09,53793.51,2,5888687,15448,5873239,7216,66.09,100.36,53793.51,0,9.00,9.72,0.19
537,0,5882125,8886,81.39,53874.90,2,5893130,11005,5882125,8886,81.39,100.33,53874.90,1,8.06,9.72,0.37
538,0,5899915,17790,162.94,54037.84,2,5902025,2110,5899915,17790,162.94,100.44,54037.84,0,8.41,9.72,0.30
539,0,5932666,32751,299.97,54337.81,2,5932666,0,5932666,32751,299.97,100.81,54337.81,0,9.56,9.72,0.49
540,0,5943991,11325,103.73,54441.54,2,5944260,269,5943991,11325,103.73,100.82,54441.54,1,8.48,9.26,0.67
541,0,5961788,17797,163.00,54604.54,2,5963861,2073,5961788,17797,163.00,100.93,54604.54,1,8.92,9.85,0.44
542,0,5982474,20686,189.46,54794.01,2,5987964,5490,5982474,20686,189.46,101.10,54794.01,0,9.91,8.91,0.32
543,0,6005129,22655,207.50,55001.50,2,6006177,1048,6005129,22655,207.50,101.29,55001.50,1,9.25,8.25,0.51
544,0,6005129,0,0.00,55001.50,2,6016801,11672,6005129,0,0.00,101.11,55001.50,0,10.19,9.19,0.32
545,0,6012659,7530,68.97,55070.47,2,6022703,10044,6012659,7530,68.97,101.05,55070.47,1,8.74,9.58,0.50
546,0,6025104,12445,113.98,55184.46,2,6032634,7530,6025104,12445,113.98,101.07,55184.46,1,8.38,9.12,0.23
547,0,6051312,26208,240.04,55424.50,2,6052535,1223,6051312,26208,240.04,101.32,55424.50,0,9.59,8.59,0.18
548,0,6051312,0,0.00,55424.50,2,6062519,11207,6051312,0,0.00,101.14,55424.50,0,10.92,9.92,0.37
549,0,6067895,16583,151.89,55576.39,2,6071244,3349,6067895,16583,151.89,101.23,55576.39,1,9.61,9.92,0.55
550,0,6072163,4268,39.09,55615.48,2,6082205,10042,6072163,4268,39.09,101.12,55615.48,0,10.72,9.72,0.23
551,0,6081515,9352,85.66,55701.13,2,6089033,7518,6081515,9352,85.66,101.09,55701.13,1,8.54,9.96,0.41
552,0,6110557,29042,266.00,55967.13,2,6110557,0,6110557,29042,266.00,101.39,55967.13,0,9.71,9.96,0.18
553,0,6132935,22378,204.96,56172.09,2,6132935,0,6132935,22378,204.96,101.58,56172.09,1,9.01,9.54,0.36
554,0,6152910,19975,182.95,56355.05,2,6158422,5512,6152910,19975,182.95,101.72,56355.05,0,10.41,9.41,0.18
555,0,6152910,0,0.00,56355.05,2,6166631,13721,6152910,0,0.00,101.54,56355.05,0,11.49,10.49,0.36
556,0,6160888,7978,73.07,56428.12,2,6172368,11480,6160888,7978,73.07,101.49,56428.12,1,8.50,10.49,0.54
557,0,6177778,16890,154.70,56582.81,2,6180813,3035,6177778,16890,154.70,101.58,56582.81,0,8.82,10.49,0.18
558,0,6210740,32962,301.90,56884.71,2,6210740,0,6210740,32962,301.90,101.94,56884.71,0,10.35,10.49,0.36
559,0,6239506,28766,263.47,57148.18,2,6239506,0,6239506,28766,263.47,102.23,57148.18,1,9.66,9.83,0.54
560,0,6239506,0,0.00,57148.18,2,6250539,11033,6239506,0,0.00,102.05,57148.18,0,9.92,8.92,0.35
561,0,6239506,0,0.00,57148.18,2,6256413,16907,6239506,0,0.00,101.87,57148.18,0,11.35,10.35,0.52
562,0,6245731,6225,57.02,57205.20,2,6261234,15503,6245731,6225,57.02,101.79,57205.20,1,10.10,10.83,0.70
563,0,6253471,7740,70.89,57276.09,2,6266118,12647,6253471,7740,70.89,101.73,57276.09,0,11.08,10.08,0.40
564,0,6256241,2770,25.37,57301.46,2,6270232,13991,6256241,2770,25.37,101.60,57301.46,1,8.60,10.15,0.57
565,0,6266021,9780,89.58,57391.04,2,6275122,9101,6266021,9780,89.58,101.58,57391.04,0,9.18,10.15,0.18
566,0,6288875,22854,209.32,57600.36,2,6288875,0,6288875,22854,209.32,101.77,57600.36,0,10.02,10.15,0.35
567,0,6288875,0,0.00,57600.36,2,6299390,10515,6288875,0,0.00,101.59,57600.36,1,9.92,8.92,0.53
568,0,6290141,1266,11.60,57611.96,2,6304970,14829,6290141,1266,11.60,101.43,57611.96,1,9.43,8.43,0.52
569,0,6290141,0,0.00,57611.96,2,6309202,19061,6290141,0,0.00,101.25,57611.96,0,10.01,9.01,0.46
570,0,6291465,1324,12.13,57624.08,2,6313121,21656,6291465,1324,12.13,101.09,57624.08,1,9.39,8.39,0.64
571,0,6293043,1578,14.45,57638.54,2,6316614,23571,6293043,1578,14.45,100.94,57638.54,1,7.80,8.69,0.55
572,0,6299763,6720,61.55,57700.09,2,6319974,20211,6299763,6720,61.55,100.87,57700.09,1,7.40,8.69,0.30
573,0,6306561,6798,62.26,57762.35,2,6323373,16812,6306561,6798,62.26,100.81,57762.35,1,7.03,8.69,0.39
574,0,6313823,7262,66.51,57828.86,2,6327004,13181,6313823,7262,66.51,100.75,57828.86,0,7.66,8.69,0.34
575,0,6325077,11254,103.08,57931.94,2,6332631,7554,6325077,11254,103.08,100.75,57931.94,1,6.95,8.69,0.51
576,0,6352462,27385,250.82,58182.76,2,6352462,0,6352462,27385,250.82,101.01,58182.76,0,7.83,8.69,0.39
577,0,6387570,35108,321.56,58504.32,2,6387570,0,6387570,35108,321.56,101.39,58504.32,1,8.05,8.69,0.56
578,0,6422339,34769,318.45,58822.77,2,6422339,0,6422339,34769,318.45,101.77,58822.77,0,9.58,9.69,0.53
579,0,6422339,0,0.00,58822.77,2,6433526,11187,6422339,0,0.00,101.59,58822.77,0,9.89,8.89,0.70
580,0,6431667,9328,85.44,58908.20,2,6440417,8750,6431667,9328,85.44,101.57,58908.20,1,9.19,9.27,0.87
581,0,6437544,5877,53.83,58962.03,2,6447281,9737,6437544,5877,53.83,101.48,58962.03,1,8.67,9.67,0.69
582,0,6463209,25665,235.07,59197.10,2,6463209,0,6463209,25665,235.07,101.71,59197.10,1,8.00,9.67,0.63
583,0,6491728,28519,261.21,59458.31,2,6494371,2643,6491728,28519,261.21,101.99,59458.31,0,10.52,9.52,0.52
584,0,6497185,5457,49.98,59508.29,2,6504031,6846,6497185,5457,49.98,101.90,59508.29,1,10.45,9.45,0.69
585,0,6497185,0,0.00,59508.29,2,6511204,14019,6497185,0,0.00,101.72,59508.29,0,11.36,10.36,0.55
586,0,6499227,2042,18.70,59526.99,2,6515747,16520,6499227,2042,18.70,101.58,59526.99,1,10.48,11.05,0.72
587,0,6507250,8023,73.48,59600.48,2,6520636,13386,6507250,8023,73.48,101.53,59600.48,0,11.32,10.32,0.55
588,0,6507250,0,0.00,59600.48,2,6524964,17714,6507250,0,0.00,101.36,59600.48,0,11.82,10.82,0.72
589,0,6513178,5928,54.30,59654.77,2,6528501,15323,6513178,5928,54.30,101.28,59654.77,1,10.45,10.82,0.89
590,0,6523178,10000,91.59,59746.36,2,6533501,10323,6523178,10000,91.59,101.27,59746.36,0,10.57,10.82,0.58
591,0,6529272,6094,55.82,59802.18,2,6539857,10585,6529272,6094,55.82,101.19,59802.18,1,8.49,9.97,0.75
592,0,6548738,19466,178.29,59980.47,2,6549590,852,6548738,19466,178.29,101.32,59980.47,0,8.75,9.97,0.38
593,0,6583784,35046,320.99,60301.46,2,6583784,0,6583784,35046,320.99,101.69,60301.46,1,8.38,9.97,0.55
594,0,6604657,20873,191.18,60492.64,2,6609892,5235,6604657,20873,191.18,101.84,60492.64,0,10.74,9.74,0.34
595,0,6607639,2982,27.31,60519.95,2,6618112,10473,6607639,2982,27.31,101.71,60519.95,1,8.94,10.74,0.51
596,0,6627777,20138,184.45,60704.39,2,6628181,404,6627777,20138,184.45,101.85,60704.39,0,9.30,10.74,0.17
597,0,6660537,32760,300.05,61004.45,2,6660537,0,6660537,32760,300.05,102.18,61004.45,1,8.46,10.74,0.34
598,0,6692888,32351,296.31,61300.75,2,6692888,0,6692888,32351,296.31,102.51,61300.75,0,9.36,10.74,0.17
599,0,6705911,13023,119.28,61420.03,2,6711432,5521,6705911,13023,119.28,102.54,61420.03,1,9.18,10.36,0.33
600,0,6721933,16022,146.75,61566.78,2,6727527,5594,6721933,16022,146.75,102.61,61566.78,0,10.73,9.73,0.17
601,0,6721933,0,0.00,61566.78,2,6735387,13454,6721933,0,0.00,102.44,61566.78,0,12.24,11.24,0.33
602,0,6733237,11304,103.53,61670.31,2,6741925,8688,6733237,11304,103.53,102.44,61670.31,1,10.31,11.24,0.50
603,0,6749432,16195,148.33,61818.64,2,6753641,4209,6749432,16195,148.33,102.52,61818.64,0,11.30,10.30,0.21
604,0,6749432,0,0.00,61818.64,2,6761507,12075,6749432,0,0.00,102.35,61818.64,0,12.06,11.06,0.38
605,0,6762106,12674,116.08,61934.73,2,6768554,6448,6762106,12674,116.08,102.37,61934.73,1,10.93,11.06,0.54
606,0,6769904,7798,71.42,62006.15,2,6778536,8632,6769904,7798,71.42,102.32,62006.15,1,10.54,11.18,0.30
607,0,6776626,6722,61.57,62067.71,2,6786827,10201,6776626,6722,61.57,102.25,62067.71,0,11.35,10.35,0.17
608,0,6777012,386,3.54,62071.25,2,6792113,15101,6777012,386,3.54,102.09,62071.25,1,10.04,11.15,0.33
609,0,6788640,11628,106.50,62177.75,2,6797927,9287,6788640,11628,106.50,102.10,62177.75,0,10.56,11.15,0.16
610,0,6811298,22658,207.53,62385.28,2,6811298,0,6811298,22658,207.53,102.27,62385.28,1,10.53,11.15,0.33
611,0,6823631,12333,112.96,62498.24,2,6828278,4647,6823631,12333,112.96,102.29,62498.24,1,9.57,10.21,0.25
612,0,6835966,12335,112.98,62611.21,2,6842752,6786,6835966,12335,112.98,102.31,62611.21,0,10.80,9.80,0.16
613,0,6836717,751,6.88,62618.09,2,6850220,13503,6836717,751,6.88,102.15,62618.09,1,10.72,9.72,0.33
614,0,6836717,0,0.00,62618.09,2,6854984,18267,6836717,0,0.00,101.98,62618.09,0,10.94,9.94,0.28
615,0,6841533,4816,44.11,62662.20,2,6859045,17512,6841533,4816,44.11,101.89,62662.20,1,9.10,9.94,0.44
616,0,6849891,8358,76.55,62738.75,2,6863224,13333,6849891,8358,76.55,101.85,62738.75,0,9.24,9.94,0.19
617,0,6861071,11180,102.40,62841.15,2,6868814,7743,6861071,11180,102.40,101.85,62841.15,1,7.88,9.94,0.35
618,0,6888464,27393,250.89,63092.05,2,6888464,0,6888464,27393,250.89,102.09,63092.05,0,8.92,9.94,0.22
619,0,6910621,22157,202.94,63294.99,2,6915102,4481,6910621,22157,202.94,102.25,63294.99,0,10.01,9.01,0.38
620,0,6923217,12596,115.37,63410.36,2,6925309,2092,6923217,12596,115.37,102.27,63410.36,1,9.75,10.00,0.54
621,0,6928257,5040,46.16,63456.52,2,6935159,6902,6928257,5040,46.16,102.18,63456.52,1,9.71,9.80,0.36
622,0,6934377,6120,56.05,63512.57,2,6944279,9902,6934377,6120,56.05,102.11,63512.57,0,10.79,9.79,0.30
623,0,6947615,13238,121.25,63633.82,2,6951983,4368,6947615,13238,121.25,102.14,63633.82,1,9.85,9.96,0.46
624,0,6947615,0,0.00,63633.82,2,6960046,12431,6947615,0,0.00,101.98,63633.82,0,10.03,9.03,0.34
625,0,6956614,8999,82.42,63716.24,2,6966111,9497,6956614,8999,82.42,101.95,63716.24,1,8.09,9.05,0.50
626,0,6977458,20844,190.91,63907.15,2,6978536,1078,6977458,20844,190.91,102.09,63907.15,0,9.05,8.05,0.23
627,0,6997405,19947,182.70,64089.85,2,6997405,0,6997405,19947,182.70,102.22,64089.85,1,8.16,8.39,0.39
628,0,7015752,18347,168.04,64257.89,2,7021235,5483,7015752,18347,168.04,102.32,64257.89,0,10.30,9.30,0.16
629,0,7019858,4106,37.61,64295.50,2,7029696,9838,7019858,4106,37.61,102.22,64295.50,1,8.24,9.46,0.32
630,0,7043793,23935,219.22,64514.72,2,7043793,0,7043793,23935,219.22,102.40,64514.72,0,9.14,9.46,0.16
631,0,7043942,149,1.36,64516.09,2,7054304,10362,7043942,149,1.36,102.24,64516.09,1,8.54,9.50,0.32
632,0,7065469,21527,197.17,64713.25,2,7065469,0,7065469,21527,197.17,102.39,64713.25,0,8.54,9.50,0.16
633,0,7088357,22888,209.63,64922.89,2,7089506,1149,7088357,22888,209.63,102.56,64922.89,1,7.85,8.77,0.32
634,0,7121440,33083,303.01,65225.90,2,7121440,0,7121440,33083,303.01,102.88,65225.90,0,9.26,9.84,0.16
635,0,7123404,1964,17.99,65243.89,2,7133821,10417,7123404,1964,17.99,102.75,65243.89,0,11.18,10.18,0.32
636,0,7136328,12924,118.37,65362.26,2,7141469,5141,7136328,12924,118.37,102.77,65362.26,1,9.25,10.20,0.47
637,0,7151419,15091,138.22,65500.48,2,7157209,5790,7151419,15091,138.22,102.83,65500.48,0,10.75,9.75,0.25
638,0,7170937,19518,178.77,65679.24,2,7170937,0,7170937,19518,178.77,102.95,65679.24,1,9.74,10.17,0.40
639,0,7174327,3390,31.05,65710.30,2,7183975,9648,7174327,3390,31.05,102.83,65710.30,0,10.78,9.78,0.19
640,0,7174327,0,0.00,65710.30,2,7189888,15561,7174327,0,0.00,102.67,65710.30,0,10.99,9.99,0.35
641,0,7180399,6072,55.61,65765.91,2,7194386,13987,7180399,6072,55.61,102.60,65765.91,1,9.03,9.99,0.50
642,0,7191052,10653,97.57,65863.48,2,7200477,9425,7191052,10653,97.57,102.59,65863.48,0,10.25,9.25,0.27
643,0,7200557,9505,87.06,65950.54,2,7208958,8401,7200557,9505,87.06,102.57,65950.54,1,9.95,8.95,0.43
644,0,7206287,5730,52.48,66003.02,2,7216476,10189,7206287,5730,52.48,102.49,66003.02,1,9.33,9.43,0.27
645,0,7207094,807,7.39,66010.41,2,7223202,16108,7207094,807,7.39,102.34,66010.41,0,10.24,9.24,0.16
646,0,7212341,5247,48.06,66058.47,2,7228324,15983,7212341,5247,48.06,102.26,66058.47,1,9.38,8.38,0.31
647,0,7215547,3206,29.36,66087.83,2,7232347,16800,7215547,3206,29.36,102.15,66087.83,1,8.13,8.43,0.19
648,0,7224612,9065,83.03,66170.86,2,7236880,12268,7224612,9065,83.03,102.12,66170.86,0,8.53,9.53,0.15
649,0,7239518,14906,136.53,66307.38,2,7244333,4815,7239518,14906,136.53,102.17,66307.38,1,7.34,9.53,0.31
650,0,7268899,29381,269.10,66576.48,2,7268899,0,7268899,29381,269.10,102.43,66576.48,0,8.62,9.53,0.17
651,0,7301269,32370,296.48,66872.97,2,7301269,0,7301269,32370,296.48,102.72,66872.97,1,7.32,9.53,0.32
652,0,7334531,33262,304.65,67177.62,2,7334531,0,7334531,33262,304.65,103.03,67177.62,0,8.93,9.53,0.15
653,0,7342650,8119,74.36,67251.98,2,7350059,7409,7342650,8119,74.36,102.99,67251.98,1,8.13,8.96,0.31
654,0,7370013,27363,250.62,67502.60,2,7370013,0,7370013,27363,250.62,103.21,67502.60,0,8.20,8.96,0.15
655,0,7395522,25509,233.64,67736.23,2,7397565,2043,7395522,25509,233.64,103.41,67736.23,1,8.18,9.23,0.31
656,0,7409560,14038,128.58,67864.81,2,7416646,7086,7409560,14038,128.58,103.45,67864.81,0,9.95,8.95,0.15
657,0,7410216,656,6.01,67870.82,2,7423997,13781,7410216,656,6.01,103.30,67870.82,1,9.21,10.42,0.30
658,0,7422762,12546,114.91,67985.73,2,7430270,7508,7422762,12546,114.91,103.32,67985.73,0,9.85,10.42,0.15
659,0,7436124,13362,122.38,68108.12,2,7441738,5614,7436124,13362,122.38,103.35,68108.12,1,10.03,10.97,0.30
660,0,7457901,21777,199.46,68307.57,2,7461061,3160,7457901,21777,199.46,103.50,68307.57,0,11.20,10.20,0.15
661,0,7462163,4262,39.04,68346.61,2,7470352,8189,7462163,4262,39.04,103.40,68346.61,1,9.53,10.53,0.30
662,0,7486157,23994,219.76,68566.38,2,7487059,902,7486157,23994,219.76,103.57,68566.38,0,10.91,9.91,0.15
663,0,7498878,12721,116.51,68682.88,2,7501692,2814,7498878,12721,116.51,103.59,68682.88,1,11.13,10.13,0.30
664,0,7499526,648,5.94,68688.82,2,7510854,11328,7499526,648,5.94,103.45,68688.82,1,9.41,10.24,0.15
665,0,7518522,18996,173.99,68862.80,2,7520352,1830,7518522,18996,173.99,103.55,68862.80,0,9.41,10.24,0.15
666,0,7523430,4908,44.95,68907.76,2,7532422,8992,7523430,4908,44.95,103.47,68907.76,0,11.47,10.47,0.30
667,0,7546996,23566,215.84,69123.60,2,7547715,719,7546996,23566,215.84,103.63,69123.60,1,10.73,9.73,0.45
668,0,7546996,0,0.00,69123.60,2,7557719,10723,7546996,0,0.00,103.48,69123.60,0,11.73,10.73,0.21
669,0,7559302,12306,112.71,69236.31,2,7565141,5839,7559302,12306,112.71,103.49,69236.31,1,9.07,10.73,0.36
670,0,7585097,25795,236.26,69472.57,2,7586498,1401,7585097,25795,236.26,103.69,69472.57,0,11.06,10.06,0.15
671,0,7585097,0,0.00,69472.57,2,7596047,10950,7585097,0,0.00,103.54,69472.57,0,11.42,10.42,0.30
672,0,7585097,0,0.00,69472.57,2,7601526,16429,7585097,0,0.00,103.38,69472.57,0,11.42,10.42,0.45
673,0,7591067,5970,54.68,69527.25,2,7605977,14910,7591067,5970,54.68,103.31,69527.25,1,9.08,10.42,0.60
674,0,7601521,10454,95.75,69623.00,2,7611204,9683,7601521,10454,95.75,103.30,69623.00,0,9.42,10.42,0.31
675,0,7622716,21195,194.13,69817.12,2,7622716,0,7622716,21195,194.13,103.43,69817.12,1,9.25,10.42,0.46
676,0,7646807,24091,220.65,70037.78,2,7650385,3578,7646807,24091,220.65,103.61,70037.78,0,10.63,9.63,0.30
677,0,7649065,2258,20.68,70058.46,2,7659070,10005,7649065,2258,20.68,103.48,70058.46,1,9.28,10.77,0.44
678,0,7672291,23226,212.73,70271.19,2,7672291,0,7672291,23226,212.73,103.64,70271.19,0,9.54,10.77,0.15
679,0,7704593,32302,295.86,70567.05,2,7704593,0,7704593,32302,295.86,103.93,70567.05,1,10.11,10.77,0.29
680,0,7713578,8985,82.29,70649.34,2,7720997,7419,7713578,8985,82.29,103.90,70649.34,0,11.17,10.17,0.22
681,0,7713578,0,0.00,70649.34,2,7727509,13931,7713578,0,0.00,103.74,70649.34,0,11.65,10.65,0.36
682,0,7721839,8261,75.66,70725.01,2,7732551,10712,7721839,8261,75.66,103.70,70725.01,1,10.53,10.65,0.51
683,0,7728005,6166,56.47,70781.48,2,7738452,10447,7728005,6166,56.47,103.63,70781.48,1,9.32,9.85,0.43
684,0,7744518,16513,151.24,70932.73,2,7747261,2743,7744518,16513,151.24,103.70,70932.73,0,9.87,8.87,0.30
685,0,7753099,8581,78.59,71011.32,2,7757483,4384,7753099,8581,78.59,103.67,71011.32,1,10.04,9.04,0.44
686,0,7754159,1060,9.71,71021.02,2,7765538,11379,7754159,1060,9.71,103.53,71021.02,1,9.16,9.57,0.28
687,0,7764139,9980,91.41,71112.43,2,7773651,9512,7764139,9980,91.41,103.51,71112.43,0,9.65,8.65,0.17
688,0,7775327,11188,102.47,71214.91,2,7780997,5670,7775327,11188,102.47,103.51,71214.91,1,9.03,9.91,0.31
689,0,7799403,24076,220.51,71435.42,2,7801384,1981,7799403,24076,220.51,103.68,71435.42,0,10.49,9.49,0.26
690,0,7799683,280,2.56,71437.98,2,7810832,11149,7799683,280,2.56,103.53,71437.98,1,11.26,11.79,0.40
691,0,7817997,18314,167.74,71605.73,2,7819989,1992,7817997,18314,167.74,103.63,71605.73,0,11.64,11.79,0.27
692,0,7826283,8286,75.89,71681.62,2,7830358,4075,7826283,8286,75.89,103.59,71681.62,1,10.65,11.03,0.42
693,0,7833995,7712,70.63,71752.25,2,7842202,8207,7833995,7712,70.63,103.54,71752.25,0,11.68,10.68,0.30
694,0,7839211,5216,47.77,71800.02,2,7848917,9706,7839211,5216,47.77,103.46,71800.02,1,10.19,10.79,0.44
695,0,7855214,16003,146.57,71946.59,2,7859151,3937,7855214,16003,146.57,103.52,71946.59,1,10.16,9.16,0.30
696,0,7855214,0,0.00,71946.59,2,7867818,12604,7855214,0,0.00,103.37,71946.59,0,11.25,10.25,0.28
697,0,7859807,4593,42.07,71988.66,2,7872920,13113,7859807,4593,42.07,103.28,71988.66,1,9.95,10.33,0.43
698,0,7870534,10727,98.25,72086.91,2,7879800,9266,7870534,10727,98.25,103.28,72086.91,0,10.35,9.35,0.30
699,0,7873423,2889,26.46,72113.38,2,7886589,13166,7873423,2889,26.46,103.17,72113.38,1,9.95,8.95,0.44
700,0,7873423,0,0.00,72113.38,2,7891403,17980,7873423,0,0.00,103.02,72113.38,0,10.52,9.52,0.36
701,0,7880707,7284,66.71,72180.09,2,7895413,14706,7880707,7284,66.71,102.97,72180.09,1,9.41,9.52,0.50
702,0,7888261,7554,69.19,72249.28,2,7901530,13269,7888261,7554,69.19,102.92,72249.28,0,9.57,8.57,0.36
703,0,7900959,12698,116.30,72365.58,2,7908087,7128,7900959,12698,116.30,102.94,72365.58,1,7.95,8.64,0.50
704,0,7927267,26308,240.96,72606.54,2,7927267,0,7927267,26308,240.96,103.13,72606.54,1,7.39,9.87,0.33
705,0,7961359,34092,312.25,72918.79,2,7961359,0,7961359,34092,312.25,103.43,72918.79,0,8.76,9.87,0.18
706,0,7995041,33682,308.50,73227.29,2,7995041,0,7995041,33682,308.50,103.72,73227.29,0,9.65,9.87,0.32
707,0,8017728,22687,207.79,73435.08,2,8017728,0,8017728,22687,207.79,103.87,73435.08,1,8.58,8.99,0.47
708,0,8028359,10631,97.37,73532.45,2,8036299,7940,8028359,10631,97.37,103.86,73532.45,0,9.32,8.32,0.20
709,0,8028359,0,0.00,73532.45,2,8043207,14848,8028359,0,0.00,103.71,73532.45,0,10.13,9.13,0.34
710,0,8030067,1708,15.64,73548.09,2,8047843,17776,8030067,1708,15.64,103.59,73548.09,1,8.21,9.43,0.48
711,0,8039317,9250,84.72,73632.81,2,8052468,13151,8039317,9250,84.72,103.56,73632.81,0,8.53,9.43,0.23
712,0,8052537,13220,121.08,73753.90,2,8059078,6541,8052537,13220,121.08,103.59,73753.90,0,9.33,9.43,0.37
713,0,8052891,354,3.24,73757.14,2,8065936,13045,8052891,354,3.24,103.45,73757.14,1,8.31,9.31,0.51
714,0,8067209,14318,131.14,73888.28,2,8073095,5886,8067209,14318,131.14,103.48,73888.28,0,8.89,9.31,0.30
715,0,8069932,2723,24.94,73913.22,2,8081404,11472,8069932,2723,24.94,103.38,73913.22,0,10.45,9.45,0.44
716,0,8085412,15480,141.78,74055.00,2,8089422,4010,8085412,15480,141.78,103.43,74055.00,1,8.82,9.47,0.58
717,0,8098380,12968,118.78,74173.77,2,8101149,2769,8098380,12968,118.78,103.45,74173.77,1,9.03,8.03,0.29
718,0,8098380,0,0.00,74173.77,2,8109912,11532,8098380,0,0.00,103.31,74173.77,0,9.91,8.91,0.19
719,0,8116679,18299,167.60,74341.38,2,8119062,2383,8116679,18299,167.60,103.40,74341.38,1,9.60,9.94,0.11
720,0,8118982,2303,21.09,74362.47,2,8128653,9671,8118982,2303,21.09,103.28,74362.47,1,9.32,9.70,0.25
721,0,8139237,20255,185.52,74547.99,2,8139237,0,8139237,20255,185.52,103.40,74547.99,0,9.61,9.70,0.15
722,0,8146050,6813,62.40,74610.39,2,8151111,5061,8146050,6813,62.40,103.34,74610.39,1,8.82,9.39,0.29
723,0,8155737,9687,88.72,74699.12,2,8163554,7817,8155737,9687,88.72,103.32,74699.12,0,9.62,8.62,0.14
724,0,8182281,26544,243.12,74942.23,2,8182281,0,8182281,26544,243.12,103.51,74942.23,1,9.75,9.84,0.28
725,0,8187527,5246,48.05,74990.28,2,8194104,6577,8187527,5246,48.05,103.43,74990.28,1,9.61,8.61,0.26
726,0,8187527,0,0.00,74990.28,2,8201192,13665,8187527,0,0.00,103.29,74990.28,0,9.66,8.66,0.17
727,0,8199643,12116,110.97,75101.25,2,8207696,8053,8199643,12116,110.97,103.30,75101.25,1,8.24,8.66,0.31
728,0,8224079,24436,223.81,75325.06,2,8225079,1000,8224079,24436,223.81,103.47,75325.06,0,10.06,9.06,0.20
729,0,8247614,23535,215.56,75540.62,2,8247614,0,8247614,23535,215.56,103.62,75540.62,1,8.90,9.63,0.34
730,0,8266253,18639,170.72,75711.34,2,8271782,5529,8266253,18639,170.72,103.71,75711.34,0,10.48,9.48,0.16
731,0,8267255,1002,9.18,75720.52,2,8279426,12171,8267255,1002,9.18,103.58,75720.52,1,9.53,10.33,0.29
732,0,8285185,17930,164.22,75884.74,2,8288391,3206,8285185,17930,164.22,103.67,75884.74,0,10.00,10.33,0.14
733,0,8289865,4680,42.86,75927.60,2,8297402,7537,8289865,4680,42.86,103.58,75927.60,1,9.26,10.00,0.27
734,0,8317764,27899,255.53,76183.13,2,8317764,0,8317764,27899,255.53,103.79,76183.13,0,9.95,10.00,0.14
735,0,8326186,8422,77.14,76260.27,2,8329219,3033,8326186,8422,77.14,103.76,76260.27,1,8.63,9.44,0.27
736,0,8351674,25488,233.45,76493.72,2,8355077,3403,8351674,25488,233.45,103.93,76493.72,0,9.95,8.95,0.14
737,0,8365849,14175,129.83,76623.55,2,8366089,240,8365849,14175,129.83,103.97,76623.55,1,10.31,10.39,0.27
738,0,8365849,0,0.00,76623.55,2,8376848,10999,8365849,0,0.00,103.83,76623.55,0,10.84,9.84,0.14
739,0,8365849,0,0.00,76623.55,2,8382390,16541,8365849,0,0.00,103.69,76623.55,0,10.84,9.84,0.27
740,0,8368873,3024,27.70,76651.24,2,8386049,17176,8368873,3024,27.70,103.58,76651.24,1,9.22,9.84,0.41
741,0,8376043,7170,65.67,76716.91,2,8390258,14215,8376043,7170,65.67,103.53,76716.91,0,10.10,9.10,0.22
742,0,8383367,7324,67.08,76784.00,2,8395147,11780,8383367,7324,67.08,103.48,76784.00,1,8.50,9.17,0.36
743,0,8402389,19022,174.22,76958.22,2,8404658,2269,8402389,19022,174.22,103.58,76958.22,1,7.55,9.17,0.18
744,0,8422445,20056,183.69,77141.91,2,8427566,5121,8422445,20056,183.69,103.69,77141.91,0,9.97,8.97,0.13
745,0,8435102,12657,115.93,77257.84,2,8437800,2698,8435102,12657,115.93,103.70,77257.84,1,9.13,9.25,0.27
746,0,8437007,1905,17.45,77275.29,2,8448067,11060,8437007,1905,17.45,103.59,77275.29,0,10.32,9.32,0.18
747,0,8451519,14512,132.92,77408.21,2,8455889,4370,8451519,14512,132.92,103.63,77408.21,1,9.14,9.33,0.32
748,0,8451995,476,4.36,77412.57,2,8464534,12539,8451995,476,4.36,103.49,77412.57,0,9.78,8.78,0.16
749,0,8460368,8373,76.69,77489.26,2,8470640,10272,8460368,8373,76.69,103.46,77489.26,1,8.53,8.96,0.30
750,0,8481144,20776,190.29,77679.55,2,8481144,0,8481144,20776,190.29,103.57,77679.55,0,8.73,8.96,0.13
751,0,8514091,32947,301.76,77981.31,2,8514091,0,8514091,32947,301.76,103.84,77981.31,1,7.79,9.99,0.27
752,0,8539717,25626,234.71,78216.02,2,8543078,3361,8539717,25626,234.71,104.01,78216.02,0,10.10,9.10,0.13
753,0,8542613,2896,26.52,78242.55,2,8551781,9168,8542613,2896,26.52,103.91,78242.55,1,8.17,9.33,0.27
754,0,8553777,11164,102.25,78344.80,2,8562216,8439,8553777,11164,102.25,103.91,78344.80,0,9.63,8.63,0.13
755,0,8562481,8704,79.72,78424.52,2,8570363,7882,8562481,8704,79.72,103.87,78424.52,1,9.02,9.30,0.27
756,0,8577222,14741,135.01,78559.53,2,8581914,4692,8577222,14741,135.01,103.91,78559.53,0,9.73,8.73,0.19
757,0,8586804,9582,87.76,78647.30,2,8591016,4212,8586804,9582,87.76,103.89,78647.30,1,8.21,9.01,0.32
758,0,8601764,14960,137.02,78784.31,2,8608381,6617,8601764,14960,137.02,103.94,78784.31,0,9.46,8.46,0.13
759,0,8601764,0,0.00,78784.31,2,8615524,13760,8601764,0,0.00,103.80,78784.31,0,10.01,9.01,0.26
760,0,8611752,9988,91.48,78875.80,2,8621460,9708,8611752,9988,91.48,103.78,78875.80,1,8.43,9.01,0.40
761,0,8621428,9676,88.62,78964.42,2,8629949,8521,8621428,9676,88.62,103.76,78964.42,1,8.85,8.99,0.27
762,0,8624010,2582,23.65,78988.07,2,8637681,13671,8624010,2582,23.65,103.66,78988.07,0,10.26,9.26,0.13
763,0,8630642,6632,60.74,79048.81,2,8642788,12146,8630642,6632,60.74,103.60,79048.81,1,8.99,9.45,0.26
764,0,8646200,15558,142.50,79191.30,2,8650567,4367,8646200,15558,142.50,103.65,79191.30,1,7.79,9.45,0.13
765,0,8677624,31424,287.82,79479.12,2,8677624,0,8677624,31424,287.82,103.89,79479.12,0,8.82,9.45,0.13
766,0,8687619,9995,91.55,79570.67,2,8693584,5965,8687619,9995,91.55,103.88,79570.67,1,7.95,8.72,0.26
767,0,8717403,29784,272.79,79843.46,2,8717403,0,8717403,29784,272.79,104.10,79843.46,0,9.45,9.89,0.13
768,0,8718387,984,9.01,79852.48,2,8728752,10365,8718387,984,9.01,103.97,79852.48,0,10.55,9.55,0.26
769,0,8728393,10006,91.65,79944.12,2,8736081,7688,8728393,10006,91.65,103.96,79944.12,1,8.62,9.56,0.39
770,0,8754437,26044,238.54,80182.66,2,8754437,0,8754437,26044,238.54,104.13,80182.66,0,9.12,9.56,0.14
771,0,8787571,33134,303.48,80486.14,2,8787571,0,8787571,33134,303.48,104.39,80486.14,1,7.94,8.65,0.27
772,0,8807521,19950,182.72,80668.86,2,8812502,4981,8807521,19950,182.72,104.49,80668.86,0,10.61,9.61,0.13
773,0,8812395,4874,44.64,80713.50,2,8821105,8710,8812395,4874,44.64,104.42,80713.50,1,8.65,10.02,0.26
774,0,8838020,25625,234.70,80948.20,2,8838020,0,8838020,25625,234.70,104.58,80948.20,0,9.93,10.02,0.13
775,0,8846833,8813,80.72,81028.92,2,8849578,2745,8846833,8813,80.72,104.55,81028.92,1,8.03,9.16,0.26
776,0,8865931,19098,174.92,81203.84,2,8871281,5350,8865931,19098,174.92,104.64,81203.84,0,9.47,8.47,0.13
777,0,8873787,7856,71.95,81275.80,2,8880163,6376,8873787,7856,71.95,104.60,81275.80,1,8.55,9.21,0.26
778,0,8888448,14661,134.28,81410.08,2,8894412,5964,8888448,14661,134.28,104.64,81410.08,0,9.77,8.77,0.13
779,0,8888448,0,0.00,81410.08,2,8901711,13263,8888448,0,0.00,104.51,81410.08,0,11.34,10.34,0.26
780,0,8888448,0,0.00,81410.08,2,8906297,17849,8888448,0,0.00,104.37,81410.08,0,11.68,10.68,0.39
781,0,8895472,7024,64.33,81474.41,2,8910631,15159,8895472,7024,64.33,104.32,81474.41,1,9.70,10.97,0.51
782,0,8905666,10194,93.37,81567.78,2,8915728,10062,8905666,10194,93.37,104.31,81567.78,1,7.42,10.97,0.28
783,0,8928886,23220,212.67,81780.45,2,8928886,0,8928886,23220,212.67,104.45,81780.45,0,8.64,10.97,0.13
784,0,8962490,33604,307.78,82088.23,2,8962490,0,8962490,33604,307.78,104.70,82088.23,1,7.64,10.97,0.26
785,0,8996151,33661,308.30,82396.54,2,8996151,0,8996151,33661,308.30,104.96,82396.54,0,9.23,10.97,0.13
786,0,9029514,33363,305.57,82702.12,2,9029514,0,9029514,33363,305.57,105.22,82702.12,1,10.02,10.97,0.25
787,0,9047886,18372,168.27,82870.38,2,9049275,1389,9047886,18372,168.27,105.30,82870.38,1,9.78,9.97,0.25
788,0,9050691,2805,25.69,82896.08,2,9060603,9912,9050691,2805,25.69,105.20,82896.08,0,10.40,9.40,0.16
789,0,9057909,7218,66.11,82962.19,2,9067558,9649,9057909,7218,66.11,105.15,82962.19,1,9.23,9.66,0.29
790,0,9072775,14866,136.16,83098.34,2,9078789,6014,9072775,14866,136.16,105.19,83098.34,0,10.06,9.06,0.13
791,0,9099637,26862,246.03,83344.38,2,9099637,0,9099637,26862,246.03,105.37,83344.38,1,8.50,9.19,0.25
792,0,9134416,34779,318.54,83662.92,2,9134416,0,9134416,34779,318.54,105.64,83662.92,0,8.74,9.19,0.13
793,0,9136513,2097,19.21,83682.12,2,9146726,10213,9136513,2097,19.21,105.53,83682.12,0,14.14,13.14,0.25
794,0,9153461,16948,155.23,83837.36,2,9156091,2630,9153461,16948,155.23,105.59,83837.36,1,12.59,13.16,0.38
795,0,9158529,5068,46.42,83883.77,2,9167998,9469,9158529,5068,46.42,105.51,83883.77,0,14.68,13.68,0.14
796,0,9172444,13915,127.45,84011.23,2,9176979,4535,9172444,13915,127.45,105.54,84011.23,1,13.66,14.01,0.26
797,0,9181011,8567,78.47,84089.69,2,9188878,7867,9181011,8567,78.47,105.51,84089.69,0,14.27,13.27,0.15
798,0,9195577,14566,133.41,84223.10,2,9198250,2673,9195577,14566,133.41,105.54,84223.10,1,12.43,13.43,0.27
799,0,9218416,22839,209.18,84432.28,2,9222624,4208,9218416,22839,209.18,105.67,84432.28,0,14.25,13.25,0.13
800,0,9218416,0,0.00,84432.28,2,9230903,12487,9218416,0,0.00,105.54,84432.28,0,15.67,14.67,0.25
801,0,9229974,11558,105.86,84538.15,2,9237504,7530,9229974,11558,105.86,105.54,84538.15,1,14.25,14.67,0.38
802,0,9246398,16424,150.43,84688.57,2,9248298,1900,9246398,16424,150.43,105.60,84688.57,1,13.76,13.91,0.24
803,0,9246398,0,0.00,84688.57,2,9257050,10652,9246398,0,0.00,105.47,84688.57,0,14.77,13.77,0.14
804,0,9249898,3500,32.06,84720.63,2,9262441,12543,9249898,3500,32.06,105.37,84720.63,1,12.88,13.77,0.27
805,0,9265588,15690,143.71,84864.34,2,9270286,4698,9265588,15690,143.71,105.42,84864.34,0,13.27,13.77,0.12
806,0,9268100,2512,23.01,84887.34,2,9279413,11313,9268100,2512,23.01,105.32,84887.34,1,13.53,12.53,0.25
807,0,9268100,0,0.00,84887.34,2,9284194,16094,9268100,0,0.00,105.19,84887.34,0,14.05,13.05,0.23
808,0,9275926,7826,71.68,84959.02,2,9288852,12926,9275926,7826,71.68,105.15,84959.02,1,12.45,13.15,0.35
809,0,9291696,15770,144.44,85103.46,2,9296737,5041,9291696,15770,144.44,105.20,85103.46,1,11.25,13.15,0.22
810,0,9322386,30690,281.09,85384.55,2,9322386,0,9322386,30690,281.09,105.41,85384.55,0,12.55,13.15,0.12
811,0,9354786,32400,296.75,85681.31,2,9354786,0,9354786,32400,296.75,105.65,85681.31,1,12.63,13.15,0.25
812,0,9358733,3947,36.15,85717.46,2,9368363,9630,9358733,3947,36.15,105.56,85717.46,0,13.90,12.90,0.19
813,0,9363085,4352,39.86,85757.32,2,9375050,11965,9363085,4352,39.86,105.48,85757.32,1,11.73,12.93,0.31
814,0,9378537,15452,141.53,85898.84,2,9382776,4239,9378537,15452,141.53,105.53,85898.84,0,12.40,12.93,0.12
815,0,9409926,31389,287.49,86186.34,2,9409926,0,9409926,31389,287.49,105.75,86186.34,1,12.66,12.93,0.25
816,0,9409926,0,0.00,86186.34,2,9420457,10531,9409926,0,0.00,105.62,86186.34,0,13.24,12.24,0.17
817,0,9416554,6628,60.71,86247.05,2,9426936,10382,9416554,6628,60.71,105.57,86247.05,1,11.07,12.34,0.30
818,0,9438343,21789,199.57,86446.62,2,9438343,0,9438343,21789,199.57,105.68,86446.62,0,11.21,12.34,0.12
819,0,9448975,10632,97.38,86543.99,2,9456556,7581,9448975,10632,97.38,105.67,86543.99,1,12.38,11.38,0.24
820,0,9448975,0,0.00,86543.99,2,9463446,14471,9448975,0,0.00,105.54,86543.99,0,13.41,12.41,0.17
821,0,9456735,7760,71.07,86615.07,2,9468690,11955,9456735,7760,71.07,105.50,86615.07,1,11.09,12.41,0.29
822,0,9471939,15204,139.25,86754.32,2,9476292,4353,9471939,15204,139.25,105.54,86754.32,0,11.16,12.41,0.12
823,0,9504142,32203,294.95,87049.27,2,9504142,0,9504142,32203,294.95,105.77,87049.27,1,11.31,12.41,0.24
824,0,9511671,7529,68.96,87118.23,2,9520443,8772,9511671,7529,68.96,105.73,87118.23,0,13.31,12.31,0.12
825,0,9529995,18324,167.83,87286.06,2,9530944,949,9529995,18324,167.83,105.80,87286.06,1,11.66,12.66,0.24
826,0,9546307,16312,149.40,87435.47,2,9552307,6000,9546307,16312,149.40,105.85,87435.47,0,13.39,12.39,0.12
827,0,9552629,6322,57.90,87493.37,2,9560435,7806,9552629,6322,57.90,105.80,87493.37,1,11.14,12.82,0.24
828,0,9579140,26511,242.82,87736.19,2,9579140,0,9579140,26511,242.82,105.96,87736.19,0,12.21,12.82,0.12
829,0,9596242,17102,156.64,87892.83,2,9596242,0,9596242,17102,156.64,106.02,87892.83,1,11.46,12.10,0.24
830,0,9611955,15713,143.92,88036.74,2,9618268,6313,9611955,15713,143.92,106.07,88036.74,0,13.21,12.21,0.12
831,0,9618559,6604,60.49,88097.23,2,9626718,8159,9618559,6604,60.49,106.01,88097.23,1,11.27,12.92,0.24
832,0,9644296,25737,235.73,88332.96,2,9644296,0,9644296,25737,235.73,106.17,88332.96,0,12.40,12.92,0.12
833,0,9660958,16662,152.61,88485.56,2,9662218,1260,9660958,16662,152.61,106.23,88485.56,1,11.81,12.72,0.24
834,0,9677504,16546,151.55,88637.11,2,9683593,6089,9677504,16546,151.55,106.28,88637.11,0,13.30,12.30,0.12
835,0,9677980,476,4.36,88641.47,2,9691503,13523,9677980,476,4.36,106.16,88641.47,1,11.45,12.67,0.24
836,0,9692468,14488,132.70,88774.17,2,9698747,6279,9692468,14488,132.70,106.19,88774.17,0,11.53,12.67,0.12
837,0,9709800,17332,158.75,88932.91,2,9712155,2355,9709800,17332,158.75,106.25,88932.91,1,11.15,12.09,0.24
838,0,9734919,25119,230.07,89162.98,2,9738151,3232,9734919,25119,230.07,106.40,89162.98,0,12.28,11.28,0.12
839,0,9734992,73,0.67,89163.65,2,9747170,12178,9734992,73,0.67,106.27,89163.65,1,11.95,12.71,0.24
840,0,9752750,17758,162.65,89326.30,2,9756049,3299,9752750,17758,162.65,106.34,89326.30,0,12.35,12.71,0.12
841,0,9754550,1800,16.49,89342.78,2,9764709,10159,9754550,1800,16.49,106.23,89342.78,1,11.72,12.71,0.24
842,0,9775045,20495,187.72,89530.50,2,9775045,0,9775045,20495,187.72,106.33,89530.50,0,12.49,12.71,0.12
843,0,9807464,32419,296.93,89827.43,2,9807464,0,9807464,32419,296.93,106.56,89827.43,1,11.13,12.71,0.24
844,0,9826515,19051,174.49,90001.91,2,9831771,5256,9826515,19051,174.49,106.64,90001.91,0,13.23,12.23,0.12
845,0,9838518,12003,109.94,90111.85,2,9842300,3782,9838518,12003,109.94,106.64,90111.85,1,12.94,11.94,0.24
846,0,9838518,0,0.00,90111.85,2,9850956,12438,9838518,0,0.00,106.52,90111.85,0,13.45,12.45,0.12
847,0,9841592,3074,28.16,90140.01,2,9855905,14313,9841592,3074,28.16,106.42,90140.01,1,11.06,12.45,0.24
848,0,9852366,10774,98.68,90238.69,2,9861292,8926,9852366,10774,98.68,106.41,90238.69,0,11.82,12.45,0.12
849,0,9876327,23961,219.46,90458.15,2,9876327,0,9876327,23961,219.46,106.55,90458.15,1,11.53,12.45,0.24
850,0,9905276,28949,265.15,90723.30,2,9907094,1818,9905276,28949,265.15,106.73,90723.30,0,12.45,11.45,0.15
851,0,9922472,17196,157.50,90880.80,2,9922472,0,9922472,17196,157.50,106.79,90880.80,1,10.15,11.71,0.26
852,0,9932347,9875,90.45,90971.24,2,9939163,6816,9932347,9875,90.45,106.77,90971.24,1,11.77,11.81,0.12
853,0,9932347,0,0.00,90971.24,2,9946419,14072,9932347,0,0.00,106.65,90971.24,0,12.37,11.37,0.12
854,0,9932347,0,0.00,90971.24,2,9951335,18988,9932347,0,0.00,106.52,90971.24,0,12.37,11.37,0.23
855,0,9938141,5794,53.07,91024.31,2,9955131,16990,9938141,5794,53.07,106.46,91024.31,1,9.79,11.37,0.35
856,0,9946563,8422,77.14,91101.45,2,9959342,12779,9946563,8422,77.14,106.43,91101.45,0,9.85,11.37,0.12
857,0,9958979,12416,113.72,91215.16,2,9965550,6571,9958979,12416,113.72,106.44,91215.16,1,7.60,11.37,0.23
858,0,9987675,28696,262.83,91477.99,2,9987675,0,9987675,28696,262.83,106.62,91477.99,0,9.70,11.37,0.12
859,0,10005756,18081,165.61,91643.60,2,10011711,5955,10005756,18081,165.61,106.69,91643.60,0,11.98,10.98,0.23
860,0,10014118,8362,76.59,91720.19,2,10020291,6173,10014118,8362,76.59,106.65,91720.19,1,10.12,11.14,0.35
861,0,10024877,10759,98.54,91818.73,2,10032085,7208,10024877,10759,98.54,106.64,91818.73,0,11.90,10.90,0.18
862,0,10035591,10714,98.13,91916.86,2,10040793,5202,10035591,10714,98.13,106.63,91916.86,1,9.63,11.28,0.30
863,0,10065834,30243,277.00,92193.86,2,10065834,0,10065834,30243,277.00,106.83,92193.86,0,9.72,11.28,0.12
864,0,10098148,32314,295.97,92489.83,2,10098148,0,10098148,32314,295.97,107.05,92489.83,1,9.67,11.28,0.23
865,0,10118106,19958,182.80,92672.62,2,10121764,3658,10118106,19958,182.80,107.14,92672.62,1,10.34,10.66,0.12
866,0,10124474,6368,58.33,92730.95,2,10133364,8890,10124474,6368,58.33,107.08,92730.95,0,11.95,10.95,0.12
867,0,10129668,5194,47.57,92778.52,2,10140202,10534,10129668,5194,47.57,107.01,92778.52,1,10.65,11.69,0.23
868,0,10149632,19964,182.85,92961.38,2,10150184,552,10149632,19964,182.85,107.10,92961.38,0,10.81,11.69,0.12
869,0,10182857,33225,304.31,93265.69,2,10182857,0,10182857,33225,304.31,107.33,93265.69,1,9.57,11.69,0.23
870,0,10215724,32867,301.03,93566.72,2,10215724,0,10215724,32867,301.03,107.55,93566.72,0,10.61,11.69,0.12
871,0,10249189,33465,306.51,93873.23,2,10249205,16,10249189,33465,306.51,107.78,93873.23,1,11.96,10.96,0.23
872,0,10249189,0,0.00,93873.23,2,10259969,10780,10249189,0,0.00,107.65,93873.23,0,13.44,12.44,0.11
873,0,10249189,0,0.00,93873.23,2,10265860,16671,10249189,0,0.00,107.53,93873.23,0,13.91,12.91,0.23
874,0,10259315,10126,92.74,93965.97,2,10271021,11706,10259315,10126,92.74,107.51,93965.97,1,11.44,12.91,0.34
875,0,10274079,14764,135.22,94101.20,2,10278403,4324,10274079,14764,135.22,107.54,94101.20,1,10.29,12.91,0.11
876,0,10305127,31048,284.37,94385.57,2,10305127,0,10305127,31048,284.37,107.75,94385.57,0,11.39,12.91,0.11
877,0,10336499,31372,287.34,94672.91,2,10336499,0,10336499,31372,287.34,107.95,94672.91,1,10.96,12.91,0.23
878,0,10360008,23509,215.32,94888.23,2,10364218,4210,10360008,23509,215.32,108.07,94888.23,0,13.55,12.55,0.11
879,0,10360008,0,0.00,94888.23,2,10372646,12638,10360008,0,0.00,107.95,94888.23,0,15.26,14.26,0.23
880,0,10367824,7816,71.59,94959.81,2,10378544,10720,10367824,7816,71.59,107.91,94959.81,1,13.31,14.31,0.34
881,0,10389100,21276,194.87,95154.68,2,10389182,82,10389100,21276,194.87,108.01,95154.68,0,13.38,14.31,0.18
882,0,10419248,30148,276.13,95430.81,2,10419248,0,10419248,30148,276.13,108.20,95430.81,1,12.63,14.31,0.30
883,0,10441652,22404,205.20,95636.01,2,10442123,471,10441652,22404,205.20,108.31,95636.01,1,12.44,13.62,0.11
884,0,10459773,18121,165.97,95801.98,2,10465374,5601,10459773,18121,165.97,108.37,95801.98,0,14.65,13.65,0.11
885,0,10465975,6202,56.80,95858.79,2,10473790,7815,10465975,6202,56.80,108.32,95858.79,1,13.85,14.38,0.23
886,0,10472351,6376,58.40,95917.19,2,10483184,10833,10472351,6376,58.40,108.26,95917.19,0,15.33,14.33,0.11
887,0,10478007,5656,51.80,95968.99,2,10489264,11257,10478007,5656,51.80,108.20,95968.99,1,13.59,14.68,0.23
888,0,10496129,18122,165.98,96134.97,2,10498325,2196,10496129,18122,165.98,108.26,96134.97,0,13.87,14.68,0.11
889,0,10527672,31543,288.91,96423.88,2,10527672,0,10527672,31543,288.91,108.46,96423.88,1,13.02,14.68,0.23
890,0,10553869,26197,239.94,96663.81,2,10556781,2912,10553869,26197,239.94,108.61,96663.81,0,15.03,14.03,0.11
891,0,10562151,8282,75.86,96739.67,2,10566645,4494,10562151,8282,75.86,108.57,96739.67,1,13.81,15.07,0.22
892,0,10577960,15809,144.80,96884.47,2,10584278,6318,10577960,15809,144.80,108.61,96884.47,0,15.93,14.93,0.11
893,0,10593466,15506,142.02,97026.49,2,10594935,1469,10593466,15506,142.02,108.65,97026.49,1,14.38,15.16,0.22
894,0,10620749,27283,249.89,97276.38,2,10623396,2647,10620749,27283,249.89,108.81,97276.38,0,15.19,14.19,0.11
895,0,10621007,258,2.36,97278.74,2,10632488,11481,10621007,258,2.36,108.69,97278.74,1,12.83,15.02,0.22
896,0,10640393,19386,177.56,97456.30,2,10642181,1788,10640393,19386,177.56,108.77,97456.30,0,14.23,15.02,0.11
897,0,10658357,17964,164.53,97620.83,2,10659545,1188,10658357,17964,164.53,108.83,97620.83,1,14.63,13.63,0.22
898,0,10658357,0,0.00,97620.83,2,10669223,10866,10658357,0,0.00,108.71,97620.83,0,15.94,14.94,0.11
899,0,10658357,0,0.00,97620.83,2,10674902,16545,10658357,0,0.00,108.59,97620.83,0,16.08,15.08,0.22
900,0,10658357,0,0.00,97620.83,2,10678743,20386,10658357,0,0.00,108.47,97620.83,0,16.15,15.15,0.33
901,0,10662460,4103,37.58,97658.41,2,10682229,19769,10662460,4103,37.58,108.39,97658.41,1,14.31,15.36,0.44
902,0,10670230,7770,71.17,97729.58,2,10686114,15884,10670230,7770,71.17,108.35,97729.58,0,14.56,15.36,0.23
903,0,10677962,7732,70.82,97800.40,2,10689980,12018,10677962,7732,70.82,108.31,97800.40,1,12.69,15.36,0.34
904,0,10691146,13184,120.75,97921.15,2,10696572,5426,10691146,13184,120.75,108.32,97921.15,1,11.67,15.36,0.17
905,0,10720443,29297,268.33,98189.48,2,10720443,0,10720443,29297,268.33,108.50,98189.48,1,11.75,15.36,0.11
906,0,10752667,32224,295.14,98484.62,2,10752667,0,10752667,32224,295.14,108.70,98484.62,0,13.45,15.36,0.11
907,0,10785464,32797,300.39,98785.02,2,10785464,0,10785464,32797,300.39,108.91,98785.02,1,13.39,15.36,0.22
908,0,10818585,33121,303.36,99088.38,2,10818585,0,10818585,33121,303.36,109.13,99088.38,0,14.47,15.36,0.12
909,0,10848463,29878,273.66,99362.03,2,10849864,1401,10848463,29878,273.66,109.31,99362.03,0,15.62,14.62,0.23
910,0,10878090,29627,271.36,99633.38,2,10878266,176,10878090,29627,271.36,109.49,99633.38,1,15.09,14.09,0.34
911,0,10887887,9797,89.73,99723.12,2,10889824,1937,10887887,9797,89.73,109.47,99723.12,1,14.87,14.94,0.17
912,0,10887887,0,0.00,99723.12,2,10899459,11572,10887887,0,0.00,109.35,99723.12,0,16.10,15.10,0.11
913,0,10900443,12556,115.00,99838.12,2,10907134,6691,10900443,12556,115.00,109.35,99838.12,1,14.83,15.41,0.22
914,0,10906222,5779,52.93,99891.05,2,10916371,10149,10906222,5779,52.93,109.29,99891.05,0,16.10,15.10,0.11
915,0,10916895,10673,97.75,99988.80,2,10923536,6641,10916895,10673,97.75,109.28,99988.80,1,14.61,15.44,0.22
916,0,10922003,5108,46.78,100035.59,2,10932502,10499,10922003,5108,46.78,109.21,100035.59,0,15.83,14.83,0.11
917,0,10929483,7480,68.51,100104.10,2,10939056,9573,10929483,7480,68.51,109.16,100104.10,1,14.14,15.43,0.22
918,0,10944725,15242,139.60,100243.70,2,10948612,3887,10944725,15242,139.60,109.20,100243.70,0,15.58,14.58,0.11
919,0,10945131,406,3.72,100247.42,2,10956619,11488,10945131,406,3.72,109.08,100247.42,1,14.06,15.29,0.22
920,0,10961891,16760,153.51,100400.93,2,10965797,3906,10961891,16760,153.51,109.13,100400.93,0,15.50,14.50,0.11
921,0,10966819,4928,45.14,100446.06,2,10974362,7543,10966819,4928,45.14,109.06,100446.06,1,14.47,15.22,0.22
922,0,10990150,23331,213.69,100659.75,2,10990816,666,10990150,23331,213.69,109.18,100659.75,0,15.38,14.38,0.11
923,0,10993772,3622,33.17,100692.93,2,11001409,7637,10993772,3622,33.17,109.09,100692.93,1,14.27,15.15,0.22
924,0,11020316,26544,243.12,100936.05,2,11020316,0,11020316,26544,243.12,109.24,100936.05,0,14.89,15.15,0.11
925,0,11046605,26289,240.78,101176.83,2,11046605,0,11046605,26289,240.78,109.38,101176.83,1,14.16,14.31,0.22
926,0,11046605,0,0.00,101176.83,2,11057348,10743,11046605,0,0.00,109.26,101176.83,0,15.42,14.42,0.14
927,0,11052222,5617,51.45,101228.27,2,11063752,11530,11052222,5617,51.45,109.20,101228.27,1,13.27,14.63,0.25
928,0,11071096,18874,172.87,101401.14,2,11073189,2093,11071096,18874,172.87,109.27,101401.14,0,14.28,14.63,0.11
929,0,11103539,32443,297.15,101698.29,2,11103539,0,11103539,32443,297.15,109.47,101698.29,1,14.09,14.63,0.22
930,0,11122822,19283,176.61,101874.91,2,11128165,5343,11122822,19283,176.61,109.54,101874.91,0,15.11,14.11,0.14
931,0,11127932,5110,46.80,101921.71,2,11136475,8543,11127932,5110,46.80,109.48,101921.71,1,14.02,14.91,0.25
932,0,11149550,21618,198.00,102119.71,2,11151248,1698,11149550,21618,198.00,109.57,102119.71,0,15.21,14.21,0.11
933,0,11162148,12598,115.39,102235.09,2,11167730,5582,11162148,12598,115.39,109.58,102235.09,1,14.71,13.71,0.21
934,0,11162148,0,0.00,102235.09,2,11175391,13243,11162148,0,0.00,109.46,102235.09,0,14.82,13.82,0.13
935,0,11166312,4164,38.14,102273.23,2,11180431,14119,11166312,4164,38.14,109.38,102273.23,1,12.09,13.82,0.24
936,0,11178248,11936,109.32,102382.56,2,11186399,8151,11178248,11936,109.32,109.38,102382.56,0,13.25,13.82,0.11
937,0,11202554,24306,222.62,102605.18,2,11202554,0,11202554,24306,222.62,109.50,102605.18,1,13.20,13.82,0.21
938,0,11208094,5540,50.74,102655.92,2,11217377,9283,11208094,5540,50.74,109.44,102655.92,0,14.90,13.90,0.13
939,0,11208744,650,5.95,102661.88,2,11223755,15011,11208744,650,5.95,109.33,102661.88,1,13.35,14.80,0.24
940,0,11220568,11824,108.30,102770.17,2,11229667,9099,11220568,11824,108.30,109.33,102770.17,0,13.89,14.80,0.11
941,0,11243145,22577,206.78,102976.95,2,11243145,0,11243145,22577,206.78,109.43,102976.95,1,13.15,14.80,0.21
942,0,11272114,28969,265.33,103242.29,2,11273959,1845,11272114,28969,265.33,109.60,103242.29,0,14.85,13.85,0.11
943,0,11297960,25846,236.73,103479.01,2,11297960,0,11297960,25846,236.73,109.73,103479.01,1,13.86,14.15,0.22
944,0,11300948,2988,27.37,103506.38,2,11311140,10192,11300948,2988,27.37,109.65,103506.38,0,14.74,13.74,0.11
945,0,11309234,8286,75.89,103582.27,2,11318135,8901,11309234,8286,75.89,109.61,103582.27,1,13.17,14.24,0.21
946,0,11334334,25100,229.89,103812.16,2,11334334,0,11334334,25100,229.89,109.74,103812.16,0,13.67,14.24,0.11
947,0,11365559,31225,285.99,104098.16,2,11365559,0,11365559,31225,285.99,109.92,104098.16,1,13.31,14.24,0.21
948,0,11379178,13619,124.74,104222.89,2,11386626,7448,11379178,13619,124.74,109.94,104222.89,0,15.47,14.47,0.11
949,0,11390226,11048,101.19,104324.09,2,11395498,5272,11390226,11048,101.19,109.93,104324.09,1,14.02,14.65,0.21
950,0,11408743,18517,169.60,104493.68,2,11413958,5215,11408743,18517,169.60,109.99,104493.68,0,15.29,14.29,0.11
951,0,11418717,9974,91.35,104585.04,2,11425985,7268,11418717,9974,91.35,109.97,104585.04,1,14.68,13.68,0.21
952,0,11418717,0,0.00,104585.04,2,11432762,14045,11418717,0,0.00,109.86,104585.04,0,14.77,13.77,0.11
953,0,11422425,3708,33.96,104619.00,2,11437163,14738,11422425,3708,33.96,109.78,104619.00,1,11.96,13.77,0.21
954,0,11435531,13106,120.04,104739.04,2,11443716,8185,11435531,13106,120.04,109.79,104739.04,0,12.92,13.77,0.10
955,0,11458045,22514,206.21,104945.24,2,11459771,1726,11458045,22514,206.21,109.89,104945.24,1,13.88,12.88,0.21
956,0,11458045,0,0.00,104945.24,2,11469389,11344,11458045,0,0.00,109.78,104945.24,0,14.85,13.85,0.15
957,0,11460843,2798,25.63,104970.88,2,11474879,14036,11460843,2798,25.63,109.69,104970.88,1,13.04,14.66,0.25
958,0,11474305,13462,123.30,105094.17,2,11481610,7305,11474305,13462,123.30,109.70,105094.17,0,13.67,14.66,0.10
959,0,11501684,27379,250.77,105344.94,2,11501684,0,11501684,27379,250.77,109.85,105344.94,0,14.40,14.66,0.21
960,0,11518961,17277,158.24,105503.18,2,11525002,6041,11518961,17277,158.24,109.90,105503.18,0,15.76,14.76,0.31
961,0,11518961,0,0.00,105503.18,2,11532559,13598,11518961,0,0.00,109.78,105503.18,0,16.82,15.82,0.42
962,0,11531435,12474,114.25,105617.43,2,11539292,7857,11531435,12474,114.25,109.79,105617.43,1,15.63,15.82,0.52
963,0,11534373,2938,26.91,105644.34,2,11547359,12986,11534373,2938,26.91,109.70,105644.34,0,15.96,14.96,0.47
964,0,11536793,2420,22.16,105666.50,2,11551710,14917,11536793,2420,22.16,109.61,105666.50,1,14.50,15.08,0.57
965,0,11544652,7859,71.98,105738.48,2,11557256,12604,11544652,7859,71.98,109.57,105738.48,0,15.14,14.14,0.45
966,0,11548068,3416,31.29,105769.77,2,11562244,14176,11548068,3416,31.29,109.49,105769.77,1,13.58,14.40,0.55
967,0,11561954,13886,127.18,105896.95,2,11569187,7233,11561954,13886,127.18,109.51,105896.95,0,14.40,14.40,0.41
968,0,11570230,8276,75.80,105972.76,2,11576965,6735,11570230,8276,75.80,109.48,105972.76,1,13.08,13.52,0.51
969,0,11596871,26641,244.01,106216.77,2,11596871,0,11596871,26641,244.01,109.61,106216.77,1,12.92,13.52,0.40
970,0,11613130,16259,148.92,106365.68,2,11619556,6426,11613130,16259,148.92,109.66,106365.68,0,14.73,13.73,0.43
971,0,11619592,6462,59.19,106424.87,2,11629418,9826,11619592,6462,59.19,109.60,106424.87,1,14.92,13.92,0.53
972,0,11622766,3174,29.07,106453.94,2,11635547,12781,11622766,3174,29.07,109.52,106453.94,1,13.86,14.10,0.50
973,0,11628259,5493,50.31,106504.25,2,11641957,13698,11628259,5493,50.31,109.46,106504.25,0,14.12,13.12,0.44
974,0,11634666,6407,58.68,106562.93,2,11647415,12749,11634666,6407,58.68,109.41,106562.93,1,13.41,12.41,0.54
975,0,11634666,0,0.00,106562.93,2,11651604,16938,11634666,0,0.00,109.30,106562.93,1,12.52,11.52,0.50
976,0,11634666,0,0.00,106562.93,2,11654680,20014,11634666,0,0.00,109.18,106562.93,0,12.85,11.85,0.49
977,0,11637488,2822,25.85,106588.78,2,11657455,19967,11637488,2822,25.85,109.10,106588.78,1,11.64,12.02,0.59
978,0,11643864,6376,58.40,106647.18,2,11660643,16779,11643864,6376,58.40,109.05,106647.18,0,11.98,12.02,0.53
979,0,11643864,0,0.00,106647.18,2,11663786,19922,11643864,0,0.00,108.93,106647.18,0,12.33,11.33,0.63
980,0,11644661,797,7.30,106654.48,2,11666434,21773,11644661,797,7.30,108.83,106654.48,1,11.46,10.46,0.73
981,0,11645591,930,8.52,106662.99,2,11668825,23234,11645591,930,8.52,108.73,106662.99,1,10.05,10.47,0.69
982,0,11650563,4972,45.54,106708.53,2,11671311,20748,11650563,4972,45.54,108.66,106708.53,0,10.06,10.47,0.62
983,0,11655807,5244,48.03,106756.56,2,11673933,18126,11655807,5244,48.03,108.60,106756.56,1,8.84,10.47,0.72
984,0,11661641,5834,53.43,106810.00,2,11676850,15209,11661641,5834,53.43,108.55,106810.00,0,9.20,10.47,0.67
985,0,11670175,8534,78.16,106888.16,2,11681117,10942,11670175,8534,78.16,108.52,106888.16,1,7.81,10.47,0.77
986,0,11687729,17554,160.78,107048.94,2,11689894,2165,11687729,17554,160.78,108.57,107048.94,1,7.08,10.47,0.70
987,0,11721087,33358,305.53,107354.47,2,11721087,0,11721087,33358,305.53,108.77,107354.47,0,10.16,10.47,0.65
988,0,11743038,21951,201.05,107555.52,2,11747603,4565,11743038,21951,201.05,108.86,107555.52,0,11.10,10.10,0.75
989,0,11763964,20926,191.66,107747.18,2,11768200,4236,11763964,20926,191.66,108.95,107747.18,1,10.68,9.68,0.86
990,0,11763964,0,0.00,107747.18,2,11777050,13086,11763964,0,0.00,108.84,107747.18,0,11.27,10.27,0.77
991,0,11770692,6728,61.62,107808.80,2,11782650,11958,11770692,6728,61.62,108.79,107808.80,1,9.37,10.28,0.87
992,0,11788018,17326,158.69,107967.49,2,11791313,3295,11788018,17326,158.69,108.84,107967.49,0,9.73,10.28,0.74
993,0,11820602,32584,298.44,108265.94,2,11820602,0,11820602,32584,298.44,109.03,108265.94,1,9.66,10.28,0.84
994,0,11829371,8769,80.32,108346.25,2,11838127,8756,11829371,8769,80.32,109.00,108346.25,0,10.70,9.70,0.75
995,0,11831429,2058,18.85,108365.10,2,11844377,12948,11831429,2058,18.85,108.91,108365.10,1,9.72,10.64,0.85
996,0,11844693,13264,121.49,108486.59,2,11852372,7679,11844693,13264,121.49,108.92,108486.59,0,11.11,10.11,0.67
997,0,11852032,7339,67.22,108553.80,2,11860352,8320,11852032,7339,67.22,108.88,108553.80,1,10.84,11.16,0.77
998,0,11863891,11859,108.62,108662.42,2,11871333,7442,11863891,11859,108.62,108.88,108662.42,0,12.14,11.14,0.71
999,0,11863891,0,0.00,108662.42,2,11877886,13995,11863891,0,0.00,108.77,108662.42,0,12.73,11.73,0.81
1000,0,11867783,3892,35.65,108698.07,2,11882180,14397,11867783,3892,35.65,108.70,108698.07,1,11.00,11.98,0.91
1001,0,11880579,12796,117.20,108815.27,2,11888578,7999,11880579,12796,117.20,108.71,108815.27,0,11.26,11.98,0.78
1002,0,11907144,26565,243.31,109058.58,2,11907144,0,11907144,26565,243.31,108.84,109058.58,1,9.90,11.98,0.87
1003,0,11939814,32670,299.23,109357.81,2,11939814,0,11939814,32670,299.23,109.03,109357.81,0,11.62,11.98,0.77
1004,0,11944855,5041,46.17,109403.98,2,11952266,7411,11944855,5041,46.17,108.97,109403.98,1,12.47,11.47,0.87
1005,0,11945452,597,5.47,109409.45,2,11959362,13910,11945452,597,5.47,108.87,109409.45,1,11.42,11.71,0.80
1006,0,11960360,14908,136.54,109545.99,2,11966816,6456,11960360,14908,136.54,108.89,109545.99,0,11.58,11.71,0.75
1007,0,11963060,2700,24.73,109570.72,2,11974896,11836,11963060,2700,24.73,108.81,109570.72,0,12.41,11.41,0.85
1008,0,11970556,7496,68.66,109639.38,2,11980895,10339,11970556,7496,68.66,108.77,109639.38,1,11.48,11.68,0.95
1009,0,11971185,629,5.76,109645.14,2,11987109,15924,11971185,629,5.76,108.67,109645.14,0,12.03,11.03,0.88
1010,0,11979873,8688,79.57,109724.71,2,11992098,12225,11979873,8688,79.57,108.64,109724.71,1,10.86,11.04,0.98
1011,0,11993495,13622,124.77,109849.48,2,12000090,6595,11993495,13622,124.77,108.65,109849.48,1,9.87,10.10,0.91
1012,0,12020456,26961,246.94,110096.41,2,12020456,0,12020456,26961,246.94,108.79,110096.41,0,10.07,10.10,0.86
1013,0,12024069,3613,33.09,110129.51,2,12032186,8117,12024069,3613,33.09,108.72,110129.51,1,11.52,10.52,0.96
1014,0,12024069,0,0.00,110129.51,2,12038668,14599,12024069,0,0.00,108.61,110129.51,0,12.54,11.54,0.91
1015,0,12030663,6594,60.40,110189.91,2,12043462,12799,12030663,6594,60.40,108.56,110189.91,1,11.07,11.54,1.01
1016,0,12047187,16524,151.34,110341.25,2,12051724,4537,12047187,16524,151.34,108.60,110341.25,0,11.13,11.54,0.94
1017,0,12056618,9431,86.38,110427.62,2,12064877,8259,12056618,9431,86.38,108.58,110427.62,0,12.71,11.71,1.03
1018,0,12066356,9738,89.19,110516.82,2,12072739,6383,12066356,9738,89.19,108.56,110516.82,1,11.67,12.08,1.13
1019,0,12084185,17829,163.30,110680.12,2,12088652,4467,12084185,17829,163.30,108.62,110680.12,0,12.39,11.39,1.03
1020,0,12087512,3327,30.47,110710.59,2,12097479,9967,12087512,3327,30.47,108.54,110710.59,1,12.26,11.26,1.13
1021,0,12087512,0,0.00,110710.59,2,12103088,15576,12087512,0,0.00,108.43,110710.59,0,12.69,11.69,1.08
1022,0,12093824,6312,57.81,110768.40,2,12107533,13709,12093824,6312,57.81,108.38,110768.40,1,11.19,11.69,1.18
1023,0,12098951,5127,46.96,110815.36,2,12112493,13542,12098951,5127,46.96,108.32,110815.36,1,11.17,10.17,1.10
1024,0,12098951,0,0.00,110815.36,2,12116524,17573,12098951,0,0.00,108.22,110815.36,0,11.52,10.52,1.06
1025,0,12100342,1391,12.74,110828.10,2,12119742,19400,12100342,1391,12.74,108.12,110828.10,1,10.90,9.90,1.16
1026,0,12100342,0,0.00,110828.10,2,12122569,22227,12100342,0,0.00,108.02,110828.10,0,10.94,9.94,1.11
1027,0,12103128,2786,25.52,110853.62,2,12125211,22083,12103128,2786,25.52,107.94,110853.62,1,9.17,9.96,1.21
1028,0,12108478,5350,49.00,110902.62,2,12127886,19408,12108478,5350,49.00,107.88,110902.62,0,9.19,9.96,1.10
1029,0,12114382,5904,54.08,110956.70,2,12130838,16456,12114382,5904,54.08,107.83,110956.70,1,8.29,9.96,1.20
1030,0,12121680,7298,66.84,111023.54,2,12134487,12807,12121680,7298,66.84,107.79,111023.54,0,8.39,9.96,1.17
1031,0,12134180,12500,114.49,111138.02,2,12140737,6557,12134180,12500,114.49,107.80,111138.02,1,6.90,9.96,1.27
1032,0,12163702,29522,270.39,111408.42,2,12163702,0,12163702,29522,270.39,107.95,111408.42,1,7.28,9.96,1.14
1033,0,12198692,34990,320.48,111728.90,2,12198692,0,12198692,34990,320.48,108.16,111728.90,0,8.46,9.96,1.10
1034,0,12232202,33510,306.92,112035.81,2,12232202,0,12232202,33510,306.92,108.35,112035.81,0,9.92,9.96,1.20
1035,0,12240013,7811,71.54,112107.36,2,12243962,3949,12240013,7811,71.54,108.32,112107.36,1,8.89,9.60,1.30
1036,0,12273731,33718,308.83,112416.19,2,12273731,0,12273731,33718,308.83,108.51,112416.19,0,9.51,9.60,1.18
1037,0,12287923,14192,129.99,112546.17,2,12287923,0,12287923,14192,129.99,108.53,112546.17,1,9.14,9.31,1.28
1038,0,12295028,7105,65.08,112611.24,2,12304261,9233,12295028,7105,65.08,108.49,112611.24,0,10.66,9.66,1.20
1039,0,12295028,0,0.00,112611.24,2,12310980,15952,12295028,0,0.00,108.38,112611.24,0,11.95,10.95,1.30
1040,0,12300233,5205,47.67,112658.92,2,12316028,15795,12300233,5205,47.67,108.33,112658.92,1,11.05,10.05,1.39
1041,0,12300233,0,0.00,112658.92,2,12320215,19982,12300233,0,0.00,108.22,112658.92,0,11.43,10.43,1.31
1042,0,12306071,5838,53.47,112712.39,2,12323663,17592,12306071,5838,53.47,108.17,112712.39,1,10.17,10.77,1.41
1043,0,12311684,5613,51.41,112763.80,2,12327350,15666,12311684,5613,51.41,108.11,112763.80,0,11.07,10.07,1.32
1044,0,12315458,3774,34.57,112798.37,2,12331108,15650,12315458,3774,34.57,108.04,112798.37,1,10.54,9.54,1.42
1045,0,12317613,2155,19.74,112818.10,2,12334279,16666,12317613,2155,19.74,107.96,112818.10,1,9.34,9.61,1.35
1046,0,12321358,3745,34.30,112852.41,2,12337709,16351,12321358,3745,34.30,107.89,112852.41,0,9.62,8.62,1.30
1047,0,12324438,3080,28.21,112880.62,2,12340744,16306,12324438,3080,28.21,107.81,112880.62,1,8.17,8.65,1.39
1048,0,12333409,8971,82.17,112962.78,2,12345230,11821,12333409,8971,82.17,107.79,112962.78,0,8.80,9.80,1.32
1049,0,12350949,17540,160.65,113123.43,2,12354000,3051,12350949,17540,160.65,107.84,113123.43,1,8.42,9.80,1.42
1050,0,12384379,33430,306.19,113429.62,2,12384379,0,12384379,33430,306.19,108.03,113429.62,1,8.42,9.80,1.35
1051,0,12397820,13441,123.11,113552.73,2,12405374,7554,12397820,13441,123.11,108.04,113552.73,0,10.44,9.44,1.35
1052,0,12397820,0,0.00,113552.73,2,12412688,14868,12397820,0,0.00,107.94,113552.73,0,10.56,9.56,1.44
1053,0,12407466,9646,88.35,113641.08,2,12418174,10708,12407466,9646,88.35,107.92,113641.08,1,9.16,9.56,1.54
1054,0,12427366,19900,182.27,113823.34,2,12428124,758,12427366,19900,182.27,107.99,113823.34,0,9.25,9.56,1.47
1055,0,12445529,18163,166.36,113989.70,2,12449845,4316,12445529,18163,166.36,108.05,113989.70,1,9.83,8.83,1.57
1056,0,12445529,0,0.00,113989.70,2,12458482,12953,12445529,0,0.00,107.94,113989.70,0,10.31,9.31,1.45
1057,0,12452483,6954,63.69,114053.39,2,12464477,11994,12452483,6954,63.69,107.90,114053.39,1,9.67,8.67,1.54
1058,0,12452483,0,0.00,114053.39,2,12469535,17052,12452483,0,0.00,107.80,114053.39,0,10.08,9.08,1.47
1059,0,12452483,0,0.00,114053.39,2,12473324,20841,12452483,0,0.00,107.70,114053.39,0,10.27,9.27,1.56
1060,0,12459261,6778,62.08,114115.47,2,12476772,17511,12459261,6778,62.08,107.66,114115.47,1,8.81,9.27,1.66
1061,0,12466533,7272,66.60,114182.08,2,12480408,13875,12466533,7272,66.60,107.62,114182.08,1,8.70,9.27,1.53
1062,0,12476571,10038,91.94,114274.02,2,12485681,9110,12476571,10038,91.94,107.60,114274.02,0,9.34,8.34,1.54
1063,0,12499284,22713,208.03,114482.05,2,12499284,0,12499284,22713,208.03,107.70,114482.05,1,9.11,9.60,1.63
1064,0,12524540,25256,231.32,114713.37,2,12524800,260,12524540,25256,231.32,107.81,114713.37,1,8.68,9.22,1.60
1065,0,12525020,480,4.40,114717.77,2,12535974,10954,12525020,480,4.40,107.72,114717.77,0,10.03,9.03,1.52
1066,0,12525020,0,0.00,114717.77,2,12542014,16994,12525020,0,0.00,107.62,114717.77,0,10.99,9.99,1.61
1067,0,12532098,7078,64.83,114782.59,2,12546636,14538,12532098,7078,64.83,107.58,114782.59,1,9.35,10.08,1.70
1068,0,12542982,10884,99.69,114882.28,2,12552078,9096,12542982,10884,99.69,107.57,114882.28,0,9.92,10.08,1.58
1069,0,12560510,17528,160.54,115042.82,2,12562416,1906,12560510,17528,160.54,107.62,115042.82,1,8.62,9.24,1.68
1070,0,12594406,33896,310.46,115353.27,2,12594406,0,12594406,33896,310.46,107.81,115353.27,1,7.81,9.24,1.55
1071,0,12626046,31640,289.79,115643.07,2,12626206,160,12626046,31640,289.79,107.98,115643.07,0,9.35,8.35,1.49
1072,0,12626046,0,0.00,115643.07,2,12637414,11368,12626046,0,0.00,107.88,115643.07,0,11.07,10.07,1.58
1073,0,12632118,6072,55.61,115698.68,2,12643452,11334,12632118,6072,55.61,107.83,115698.68,1,8.66,10.07,1.67
1074,0,12651262,19144,175.34,115874.02,2,12653024,1762,12651262,19144,175.34,107.89,115874.02,0,8.72,10.07,1.50
1075,0,12684595,33333,305.30,116179.32,2,12684595,0,12684595,33333,305.30,108.07,116179.32,1,8.85,10.07,1.59
1076,0,12707588,22993,210.59,116389.92,2,12711956,4368,12707588,22993,210.59,108.17,116389.92,0,10.87,9.87,1.52
1077,0,12708294,706,6.47,116396.38,2,12720363,12069,12708294,706,6.47,108.07,116396.38,1,9.34,10.93,1.62
1078,0,12727960,19666,180.12,116576.51,2,12730196,2236,12727960,19666,180.12,108.14,116576.51,0,10.78,10.93,1.43
1079,0,12730169,2209,20.23,116596.74,2,12739631,9462,12730169,2209,20.23,108.06,116596.74,1,11.00,10.00,1.52
1080,0,12730169,0,0.00,116596.74,2,12745771,15602,12730169,0,0.00,107.96,116596.74,0,11.88,10.88,1.49
1081,0,12733824,3655,33.48,116630.22,2,12749636,15812,12733824,3655,33.48,107.89,116630.22,1,10.06,10.90,1.58
1082,0,12744476,10652,97.56,116727.78,2,12754962,10486,12744476,10652,97.56,107.88,116727.78,0,10.38,10.90,1.44
1083,0,12766155,21679,198.56,116926.34,2,12766155,0,12766155,21679,198.56,107.97,116926.34,1,9.20,10.90,1.53
1084,0,12798265,32110,294.10,117220.44,2,12798265,0,12798265,32110,294.10,108.14,117220.44,0,9.69,10.90,1.44
1085,0,12819395,21130,193.53,117413.97,2,12819486,91,12819395,21130,193.53,108.22,117413.97,1,11.27,10.27,1.53
1086,0,12819547,152,1.39,117415.36,2,12830077,10530,12819547,152,1.39,108.12,117415.36,1,11.03,11.11,1.41
1087,0,12826660,7113,65.15,117480.51,2,12837976,11316,12826660,7113,65.15,108.08,117480.51,0,11.77,10.77,1.38
1088,0,12826660,0,0.00,117480.51,2,12843165,16505,12826660,0,0.00,107.98,117480.51,0,12.20,11.20,1.47
1089,0,12831246,4586,42.00,117522.52,2,12847062,15816,12831246,4586,42.00,107.92,117522.52,1,9.95,11.20,1.56
1090,0,12840998,9752,89.32,117611.84,2,12851938,10940,12840998,9752,89.32,107.90,117611.84,1,8.93,11.20,1.40
1091,0,12859570,18572,170.10,117781.94,2,12861224,1654,12859570,18572,170.10,107.96,117781.94,0,9.34,11.20,1.36
1092,0,12891809,32239,295.28,118077.22,2,12891809,0,12891809,32239,295.28,108.13,118077.22,0,10.62,11.20,1.45
1093,0,12923963,32154,294.50,118371.72,2,12923963,0,12923963,32154,294.50,108.30,118371.72,1,10.90,11.20,1.54
1094,0,12926888,2925,26.79,118398.51,2,12936515,9627,12926888,2925,26.79,108.23,118398.51,0,12.16,11.16,1.43
1095,0,12929459,2571,23.55,118422.05,2,12943049,13590,12929459,2571,23.55,108.15,118422.05,1,11.69,10.69,1.52
1096,0,12930237,778,7.13,118429.18,2,12947760,17523,12930237,778,7.13,108.06,118429.18,1,10.97,11.28,1.46
1097,0,12939199,8962,82.08,118511.27,2,12952241,13042,12939199,8962,82.08,108.03,118511.27,0,11.26,11.28,1.41
1098,0,12939199,0,0.00,118511.27,2,12956623,17424,12939199,0,0.00,107.93,118511.27,0,11.60,10.60,1.50
1099,0,12939199,0,0.00,118511.27,2,12959948,20749,12939199,0,0.00,107.84,118511.27,0,11.68,10.68,1.59
1100,0,12943189,3990,36.54,118547.81,2,12962652,19463,12943189,3990,36.54,107.77,118547.81,1,10.10,10.68,1.68
1101,0,12948831,5642,51.68,118599.48,2,12965473,16642,12948831,5642,51.68,107.72,118599.48,1,8.25,10.68,1.59
1102,0,12956555,7724,70.74,118670.23,2,12969335,12780,12956555,7724,70.74,107.69,118670.23,0,8.47,10.68,1.47
1103,0,12970869,14314,131.10,118801.34,2,12976492,5623,12970869,14314,131.10,107.71,118801.34,1,7.14,10.68,1.56
1104,0,12999898,29029,265.88,119067.21,2,12999898,0,12999898,29029,265.88,107.85,119067.21,1,5.89,10.68,1.47
1105,0,13032137,32239,295.28,119362.49,2,13032137,0,13032137,32239,295.28,108.02,119362.49,0,7.41,10.68,1.38
1106,0,13063570,31433,287.90,119650.39,2,13063570,0,13063570,31433,287.90,108.18,119650.39,1,9.54,10.16,1.47
1107,0,13079209,15639,143.24,119793.62,2,13085654,6445,13079209,15639,143.24,108.21,119793.62,0,10.54,9.54,1.39
1108,0,13079209,0,0.00,119793.62,2,13093008,13799,13079209,0,0.00,108.12,119793.62,0,10.97,9.97,1.47
1109,0,13087699,8490,77.76,119871.39,2,13098410,10711,13087699,8490,77.76,108.09,119871.39,1,8.61,9.97,1.56
1110,0,13108561,20862,191.08,120062.47,2,13108841,280,13108561,20862,191.08,108.16,120062.47,0,9.47,9.97,1.39
1111,0,13119701,11140,102.03,120164.50,2,13125377,5676,13119701,11140,102.03,108.16,120164.50,1,7.18,9.01,1.48
1112,0,13143938,24237,221.99,120386.48,2,13146149,2211,13143938,24237,221.99,108.26,120386.48,0,9.57,8.57,1.23
1113,0,13147392,3454,31.64,120418.12,2,13155584,8192,13147392,3454,31.64,108.19,120418.12,1,9.03,9.86,1.32
1114,0,13152858,5466,50.06,120468.19,2,13164454,11596,13152858,5466,50.06,108.14,120468.19,0,10.48,9.48,1.21
1115,0,13154893,2035,18.64,120486.83,2,13169725,14832,13154893,2035,18.64,108.06,120486.83,1,8.90,10.10,1.30
1116,0,13167827,12934,118.46,120605.29,2,13176192,8365,13167827,12934,118.46,108.07,120605.29,0,9.78,10.10,1.16
1117,0,13169655,1828,16.74,120622.03,2,13183667,14012,13169655,1828,16.74,107.99,120622.03,0,10.75,9.75,1.25
1118,0,13170263,608,5.57,120627.60,2,13187597,17334,13170263,608,5.57,107.90,120627.60,1,9.22,10.22,1.34
1119,0,13179027,8764,80.27,120707.87,2,13191979,12952,13179027,8764,80.27,107.87,120707.87,0,9.28,10.22,1.22
1120,0,13194793,15766,144.40,120852.27,2,13199862,5069,13194793,15766,144.40,107.90,120852.27,1,8.21,10.22,1.30
1121,0,13225878,31085,284.71,121136.98,2,13225878,0,13225878,31085,284.71,108.06,121136.98,0,9.17,10.22,1.22
1122,0,13250592,24714,226.36,121363.34,2,13252626,2034,13250592,24714,226.36,108.17,121363.34,1,9.54,8.54,1.31
1123,0,13250592,0,0.00,121363.34,2,13262126,11534,13250592,0,0.00,108.07,121363.34,0,10.51,9.51,1.23
1124,0,13259974,9382,85.93,121449.27,2,13269779,9805,13259974,9382,85.93,108.05,121449.27,1,9.66,8.66,1.31
1125,0,13266110,6136,56.20,121505.47,2,13276183,10073,13266110,6136,56.20,108.00,121505.47,1,8.56,9.02,1.28
1126,0,13276065,9955,91.18,121596.65,2,13284968,8903,13276065,9955,91.18,107.99,121596.65,0,9.28,8.28,1.22
1127,0,13291985,15920,145.81,121742.46,2,13294045,2060,13291985,15920,145.81,108.02,121742.46,1,8.28,8.52,1.31
1128,0,13324045,32060,293.64,122036.10,2,13324045,0,13324045,32060,293.64,108.19,122036.10,0,8.66,9.65,1.22
1129,0,13349158,25113,230.01,122266.12,2,13349158,0,13349158,25113,230.01,108.30,122266.12,1,8.92,9.12,1.31
1130,0,13349158,0,0.00,122266.12,2,13359289,10131,13349158,0,0.00,108.20,122266.12,0,10.44,9.44,1.17
1131,0,13367312,18154,166.27,122432.39,2,13368742,1430,13367312,18154,166.27,108.25,122432.39,1,9.42,9.44,1.26
1132,0,13367312,0,0.00,122432.39,2,13377901,10589,13367312,0,0.00,108.16,122432.39,0,10.20,9.20,1.18
1133,0,13373544,6232,57.08,122489.47,2,13383950,10406,13373544,6232,57.08,108.11,122489.47,1,7.99,9.52,1.27
1134,0,13395529,21985,201.36,122690.83,2,13395529,0,13395529,21985,201.36,108.19,122690.83,0,8.83,9.52,1.08
1135,0,13426042,30513,279.47,122970.30,2,13426042,0,13426042,30513,279.47,108.34,122970.30,1,8.69,9.52,1.17
1136,0,13443234,17192,157.46,123127.77,2,13448736,5502,13443234,17192,157.46,108.39,123127.77,0,10.72,9.72,1.10
1137,0,13443234,0,0.00,123127.77,2,13456647,13413,13443234,0,0.00,108.29,123127.77,0,11.69,10.69,1.18
1138,0,13456234,13000,119.07,123246.84,2,13463775,7541,13456234,13000,119.07,108.30,123246.84,1,9.25,10.94,1.27
1139,0,13483878,27644,253.19,123500.02,2,13483878,0,13483878,27644,253.19,108.43,123500.02,0,9.85,10.94,1.06
1140,0,13495436,11558,105.86,123605.89,2,13503158,7722,13495436,11558,105.86,108.43,123605.89,0,11.65,10.65,1.14
1141,0,13519289,23853,218.47,123824.36,2,13519289,0,13519289,23853,218.47,108.52,123824.36,1,10.57,10.75,1.23
1142,0,13519289,0,0.00,123824.36,2,13530395,11106,13519289,0,0.00,108.43,123824.36,0,10.79,9.79,1.17
1143,0,13533854,14565,133.40,123957.76,2,13539524,5670,13533854,14565,133.40,108.45,123957.76,1,10.33,9.33,1.26
1144,0,13533854,0,0.00,123957.76,2,13547088,13234,13533854,0,0.00,108.35,123957.76,0,12.29,11.29,1.14
1145,0,13548904,15050,137.84,124095.61,2,13554867,5963,13548904,15050,137.84,108.38,124095.61,1,10.44,11.29,1.22
1146,0,13578099,29195,267.40,124363.01,2,13578099,0,13578099,29195,267.40,108.52,124363.01,1,10.50,11.29,1.06
1147,0,13592589,14490,132.72,124495.72,2,13599059,6470,13592589,14490,132.72,108.54,124495.72,0,11.75,10.75,1.04
1148,0,13592589,0,0.00,124495.72,2,13606097,13508,13592589,0,0.00,108.45,124495.72,0,13.08,12.08,1.13
1149,0,13600219,7630,69.88,124565.60,2,13612740,12521,13600219,7630,69.88,108.41,124565.60,1,12.28,11.28,1.22
1150,0,13603964,3745,34.30,124599.91,2,13618127,14163,13603964,3745,34.30,108.35,124599.91,1,11.38,10.38,1.14
1151,0,13603964,0,0.00,124599.91,2,13622126,18162,13603964,0,0.00,108.25,124599.91,0,11.47,10.47,1.12
1152,0,13610416,6452,59.09,124659.00,2,13625710,15294,13610416,6452,59.09,108.21,124659.00,1,9.79,10.47,1.21
1153,0,13621290,10874,99.60,124758.59,2,13631147,9857,13621290,10874,99.60,108.20,124758.59,1,8.90,10.47,1.12
1154,0,13640554,19264,176.44,124935.04,2,13640779,225,13640554,19264,176.44,108.26,124935.04,0,10.24,10.47,1.11
1155,0,13662438,21884,200.44,125135.48,2,13665603,3165,13662438,21884,200.44,108.34,125135.48,1,9.79,8.79,1.20
1156,0,13663066,628,5.75,125141.23,2,13674451,11385,13663066,628,5.75,108.25,125141.23,1,9.46,9.85,1.12
1157,0,13673978,10912,99.94,125241.17,2,13682688,8710,13673978,10912,99.94,108.25,125241.17,0,9.99,8.99,1.06
1158,0,13673978,0,0.00,125241.17,2,13688484,14506,13673978,0,0.00,108.15,125241.17,0,10.95,9.95,1.15
1159,0,13673978,0,0.00,125241.17,2,13692257,18279,13673978,0,0.00,108.06,125241.17,0,11.52,10.52,1.23
1160,0,13679582,5604,51.33,125292.50,2,13695719,16137,13679582,5604,51.33,108.01,125292.50,1,10.05,10.52,1.32
1161,0,13688308,8726,79.92,125372.42,2,13700082,11774,13688308,8726,79.92,107.99,125372.42,0,10.39,10.52,1.23
1162,0,13704430,16122,147.66,125520.09,2,13708143,3713,13704430,16122,147.66,108.02,125520.09,1,8.68,10.52,1.31
1163,0,13736376,31946,292.60,125812.68,2,13736376,0,13736376,31946,292.60,108.18,125812.68,1,8.10,10.52,1.19
1164,0,13767619,31243,286.16,126098.84,2,13767619,0,13767619,31243,286.16,108.33,126098.84,0,9.10,10.52,1.11
1165,0,13791417,23798,217.97,126316.80,2,13791417,0,13791417,23798,217.97,108.43,126316.80,1,9.60,9.64,1.20
1166,0,13791417,0,0.00,126316.80,2,13801850,10433,13791417,0,0.00,108.33,126316.80,0,10.28,9.28,1.12
1167,0,13802605,11188,102.47,126419.27,2,13809616,7011,13802605,11188,102.47,108.33,126419.27,1,9.20,9.44,1.20
1168,0,13806342,3737,34.23,126453.50,2,13818727,12385,13806342,3737,34.23,108.26,126453.50,0,9.89,8.89,1.13
1169,0,13811676,5334,48.85,126502.36,2,13824199,12523,13811676,5334,48.85,108.21,126502.36,1,8.22,9.04,1.21
1170,0,13826504,14828,135.81,126638.17,2,13831613,5109,13826504,14828,135.81,108.24,126638.17,0,8.74,9.04,1.09
1171,0,13857847,31343,287.07,126925.24,2,13857847,0,13857847,31343,287.07,108.39,126925.24,1,8.50,9.04,1.17
1172,0,13857870,23,0.21,126925.45,2,13867587,9717,13857870,23,0.21,108.30,126925.45,0,10.32,9.32,1.10
1173,0,13863964,6094,55.82,126981.27,2,13873643,9679,13863964,6094,55.82,108.25,126981.27,1,8.73,10.23,1.19
1174,0,13884300,20336,186.26,127167.53,2,13884300,0,13884300,20336,186.26,108.32,127167.53,0,10.05,10.23,1.01
1175,0,13893364,9064,83.02,127250.55,2,13899542,6178,13893364,9064,83.02,108.30,127250.55,1,9.83,8.83,1.09
1176,0,13893364,0,0.00,127250.55,2,13907364,14000,13893364,0,0.00,108.21,127250.55,0,9.91,8.91,1.02
1177,0,13893364,0,0.00,127250.55,2,13912232,18868,13893364,0,0.00,108.11,127250.55,0,10.31,9.31,1.11
1178,0,13899600,6236,57.12,127307.66,2,13916490,16890,13899600,6236,57.12,108.07,127307.66,1,7.79,9.51,1.19
1179,0,13908220,8620,78.95,127386.61,2,13920800,12580,13908220,8620,78.95,108.05,127386.61,0,8.05,9.51,1.01
1180,0,13919696,11476,105.11,127491.72,2,13926538,6842,13919696,11476,105.11,108.04,127491.72,0,8.33,9.51,1.09
1181,0,13950235,30539,279.71,127771.43,2,13950235,0,13950235,30539,279.71,108.19,127771.43,1,8.62,9.51,1.17
1182,0,13967722,17487,160.16,127931.59,2,13971123,3401,13967722,17487,160.16,108.23,127931.59,1,8.36,9.03,1.12
1183,0,13982884,15162,138.87,128070.47,2,13989442,6558,13982884,15162,138.87,108.26,128070.47,0,9.84,8.84,1.03
1184,0,13985172,2288,20.96,128091.42,2,13997000,11828,13985172,2288,20.96,108.19,128091.42,1,8.28,9.60,1.12
1185,0,14003718,18546,169.86,128261.29,2,14006273,2555,14003718,18546,169.86,108.24,128261.29,1,8.15,9.60,0.96
1186,0,14036230,32512,297.78,128559.07,2,14036230,0,14036230,32512,297.78,108.40,128559.07,0,8.66,9.60,0.97
1187,0,14066188,29958,274.39,128833.45,2,14066188,0,14066188,29958,274.39,108.54,128833.45,1,8.26,8.69,1.06
1188,0,14084941,18753,171.76,129005.22,2,14090469,5528,14084941,18753,171.76,108.59,129005.22,0,10.53,9.53,0.97
1189,0,14101639,16698,152.94,129158.16,2,14104100,2461,14101639,16698,152.94,108.63,129158.16,1,9.96,8.96,1.05
1190,0,14101639,0,0.00,129158.16,2,14113521,11882,14101639,0,0.00,108.54,129158.16,0,11.25,10.25,0.98
1191,0,14109241,7602,69.63,129227.78,2,14119168,9927,14109241,7602,69.63,108.50,129227.78,1,9.60,10.25,1.06
1192,0,14130747,21506,196.98,129424.76,2,14130747,0,14130747,21506,196.98,108.58,129424.76,1,8.55,10.25,0.95
1193,0,14163087,32340,296.20,129720.96,2,14163087,0,14163087,32340,296.20,108.74,129720.96,0,9.73,10.25,0.87
1194,0,14164127,1040,9.53,129730.48,2,14174517,10390,14164127,1040,9.53,108.65,129730.48,0,11.33,10.33,0.95
1195,0,14176919,12792,117.16,129847.65,2,14182403,5484,14176919,12792,117.16,108.66,129847.65,1,10.43,9.43,1.04
1196,0,14176919,0,0.00,129847.65,2,14190142,13223,14176919,0,0.00,108.57,129847.65,0,11.29,10.29,0.90
1197,0,14181248,4329,39.65,129887.30,2,14194663,13415,14181248,4329,39.65,108.51,129887.30,1,9.73,11.17,0.98
1198,0,14195902,14654,134.22,130021.52,2,14201990,6088,14195902,14654,134.22,108.53,130021.52,0,9.77,11.17,0.82
1199,0,14212223,16321,149.49,130171.00,2,14216807,4584,14212223,16321,149.49,108.57,130171.00,0,11.52,10.52,0.90
1200,0,14213541,1318,12.07,130183.08,2,14224855,11314,14213541,1318,12.07,108.49,130183.08,1,10.10,11.05,0.99
1201,0,14231399,17858,163.56,130346.64,2,14233784,2385,14231399,17858,163.56,108.53,130346.64,0,10.64,11.05,0.88
1202,0,14247733,16334,149.60,130496.24,2,14253801,6068,14247733,16334,149.60,108.57,130496.24,0,11.78,10.78,0.96
1203,0,14260382,12649,115.85,130612.09,2,14265272,4890,14260382,12649,115.85,108.57,130612.09,1,11.35,10.35,1.04
1204,0,14260382,0,0.00,130612.09,2,14273232,12850,14260382,0,0.00,108.48,130612.09,0,12.09,11.09,0.89
1205,0,14273166,12784,117.09,130729.19,2,14279892,6726,14273166,12784,117.09,108.49,130729.19,1,9.85,11.09,0.98
1206,0,14301875,28709,262.95,130992.13,2,14301875,0,14301875,28709,262.95,108.62,130992.13,1,9.26,11.09,0.83
1207,0,14334045,32170,294.65,131286.78,2,14334045,0,14334045,32170,294.65,108.77,131286.78,0,10.65,11.09,0.78
1208,0,14366619,32574,298.35,131585.12,2,14366619,0,14366619,32574,298.35,108.93,131585.12,1,10.76,11.09,0.86
1209,0,14372138,5519,50.55,131635.67,2,14378897,6759,14372138,5519,50.55,108.88,131635.67,1,10.78,9.78,0.78
1210,0,14372138,0,0.00,131635.67,2,14386475,14337,14372138,0,0.00,108.79,131635.67,0,11.36,10.36,0.74
1211,0,14382821,10683,97.85,131733.53,2,14392488,9667,14382821,10683,97.85,108.78,131733.53,1,10.30,10.53,0.82
1212,0,14391706,8885,81.38,131814.91,2,14401430,9724,14391706,8885,81.38,108.76,131814.91,0,10.72,9.72,0.74
1213,0,14401416,9710,88.93,131903.84,2,14408418,7002,14401416,9710,88.93,108.74,131903.84,1,8.93,9.87,0.82
1214,0,14429841,28425,260.35,132164.19,2,14429841,0,14429841,28425,260.35,108.87,132164.19,1,7.77,9.87,0.69
1215,0,14455401,25560,234.11,132398.30,2,14458683,3282,14455401,25560,234.11,108.97,132398.30,0,10.50,9.50,0.63
1216,0,14455401,0,0.00,132398.30,2,14467351,11950,14455401,0,0.00,108.88,132398.30,0,12.00,11.00,0.71
1217,0,14462451,7050,64.57,132462.86,2,14473226,10775,14462451,7050,64.57,108.84,132462.86,1,10.52,11.62,0.79
1218,0,14477797,15346,140.56,132603.42,2,14482850,5053,14477797,15346,140.56,108.87,132603.42,0,11.66,10.66,0.64
1219,0,14485791,7994,73.22,132676.64,2,14491834,6043,14485791,7994,73.22,108.84,132676.64,1,10.02,11.03,0.73
1220,0,14511112,25321,231.92,132908.55,2,14512500,1388,14511112,25321,231.92,108.94,132908.55,0,11.04,10.04,0.61
1221,0,14533941,22829,209.09,133117.64,2,14533941,0,14533941,22829,209.09,109.02,133117.64,1,9.63,10.42,0.70
1222,0,14543056,9115,83.49,133201.12,2,14551227,8171,14543056,9115,83.49,109.00,133201.12,0,11.55,10.55,0.57
1223,0,14555078,12022,110.11,133311.25,2,14560024,4946,14555078,12022,110.11,109.00,133311.25,1,10.61,10.92,0.65
1224,0,14557747,2669,24.45,133335.69,2,14568739,10992,14557747,2669,24.45,108.93,133335.69,0,11.86,10.86,0.52
1225,0,14575831,18084,165.63,133501.33,2,14577948,2117,14575831,18084,165.63,108.98,133501.33,1,10.05,10.88,0.60
1226,0,14607347,31516,288.66,133789.98,2,14607809,462,14607347,31516,288.66,109.13,133789.98,0,11.04,10.04,0.49
1227,0,14621179,13832,126.69,133916.67,2,14621179,0,14621179,13832,126.69,109.14,133916.67,1,8.78,10.98,0.57
1228,0,14649870,28691,262.78,134179.45,2,14649870,0,14649870,28691,262.78,109.27,134179.45,0,10.19,10.98,0.34
1229,0,14676006,26136,239.38,134418.83,2,14676006,0,14676006,26136,239.38,109.37,134418.83,1,9.48,10.12,0.42
1230,0,14691442,15436,141.38,134560.22,2,14697084,5642,14691442,15436,141.38,109.40,134560.22,0,10.85,9.85,0.32
1231,0,14692165,723,6.62,134566.83,2,14704888,12723,14692165,723,6.62,109.32,134566.83,1,8.49,10.96,0.40
1232,0,14708875,16710,153.05,134719.88,2,14713243,4368,14708875,16710,153.05,109.35,134719.88,0,8.74,10.96,0.14
1233,0,14739643,30768,281.81,135001.69,2,14739643,0,14739643,30768,281.81,109.49,135001.69,1,8.71,10.96,0.22
1234,0,14771409,31766,290.95,135292.64,2,14771409,0,14771409,31766,290.95,109.64,135292.64,0,10.42,10.96,0.14
1235,0,14787172,15763,144.37,135437.02,2,14787172,0,14787172,15763,144.37,109.67,135437.02,1,9.76,10.27,0.22
1236,0,14795863,8691,79.60,135516.61,2,14804353,8490,14795863,8691,79.60,109.64,135516.61,0,11.33,10.33,0.08
1237,0,14804435,8572,78.51,135595.12,2,14812247,7812,14804435,8572,78.51,109.62,135595.12,1,9.85,10.98,0.16
1238,0,14824134,19699,180.42,135775.55,2,14826649,2515,14824134,19699,180.42,109.67,135775.55,0,10.99,9.99,0.08
1239,0,14824134,0,0.00,135775.55,2,14835865,11731,14824134,0,0.00,109.58,135775.55,0,11.82,10.82,0.16
1240,0,14824200,66,0.60,135776.16,2,14841258,17058,14824200,66,0.60,109.50,135776.16,1,9.39,10.82,0.24
1241,0,14833788,9588,87.82,135863.97,2,14846052,12264,14833788,9588,87.82,109.48,135863.97,0,9.39,10.82,0.09
1242,0,14847176,13388,122.62,135986.59,2,14852746,5570,14847176,13388,122.62,109.49,135986.59,1,8.21,10.82,0.17
1243,0,14875847,28671,262.60,136249.19,2,14875847,0,14875847,28671,262.60,109.61,136249.19,0,10.68,10.82,0.08
1244,0,14876676,829,7.59,136256.78,2,14886062,9386,14876676,829,7.59,109.53,136256.78,1,9.59,11.11,0.16
1245,0,14900025,23349,213.86,136470.64,2,14900025,0,14900025,23349,213.86,109.61,136470.64,0,9.60,11.11,0.08
1246,0,14932734,32709,299.58,136770.23,2,14932734,0,14932734,32709,299.58,109.77,136770.23,1,9.50,11.11,0.16
1247,0,14963992,31258,286.29,137056.52,2,14963992,0,14963992,31258,286.29,109.91,137056.52,0,11.07,11.11,0.11
1248,0,14993656,29664,271.70,137328.22,2,14993656,0,14993656,29664,271.70,110.04,137328.22,1,10.17,10.35,0.19
1249,0,14993656,0,0.00,137328.22,2,15004667,11011,14993656,0,0.00,109.95,137328.22,0,11.09,10.09,0.08
1250,0,14999487,5831,53.41,137381.62,2,15010395,10908,14999487,5831,53.41,109.91,137381.62,1,10.48,10.95,0.16
1251,0,15008700,9213,84.38,137466.00,2,15018620,9920,15008700,9213,84.38,109.88,137466.00,0,11.39,10.39,0.08
1252,0,15019678,10978,100.55,137566.55,2,15026414,6736,15019678,10978,100.55,109.88,137566.55,1,9.95,10.58,0.16
1253,0,15047317,27639,253.15,137819.70,2,15047317,0,15047317,27639,253.15,109.99,137819.70,0,10.41,10.58,0.08
1254,0,15061896,14579,133.53,137953.23,2,15067767,5871,15061896,14579,133.53,110.01,137953.23,1,10.95,9.95,0.16
1255,0,15067312,5416,49.61,138002.84,2,15075570,8258,15067312,5416,49.61,109.96,138002.84,1,10.78,11.00,0.08
1256,0,15069613,2301,21.08,138023.91,2,15082910,13297,15069613,2301,21.08,109.89,138023.91,0,11.97,10.97,0.08
1257,0,15075381,5768,52.83,138076.75,2,15087843,12462,15075381,5768,52.83,109.85,138076.75,1,10.63,10.99,0.16
1258,0,15087267,11886,108.86,138185.61,2,15095919,8652,15087267,11886,108.86,109.85,138185.61,0,11.55,10.55,0.08
1259,0,15091827,4560,41.77,138227.38,2,15103013,11186,15091827,4560,41.77,109.79,138227.38,1,10.62,11.24,0.16
1260,0,15107731,15904,145.67,138373.05,2,15110965,3234,15107731,15904,145.67,109.82,138373.05,0,11.03,11.24,0.08
1261,0,15131783,24052,220.29,138593.33,2,15131783,0,15131783,24052,220.29,109.91,138593.33,1,9.72,10.32,0.16
1262,0,15147128,15345,140.55,138733.88,2,15150306,3178,15147128,15345,140.55,109.93,138733.88,1,9.19,9.53,0.08
1263,0,15160581,13453,123.22,138857.09,2,15167300,6719,15160581,13453,123.22,109.94,138857.09,0,11.17,10.17,0.08
1264,0,15160581,0,0.00,138857.09,2,15174182,13601,15160581,0,0.00,109.86,138857.09,0,12.00,11.00,0.16
1265,0,15173133,12552,114.96,138972.06,2,15180727,7594,15173133,12552,114.96,109.86,138972.06,1,10.07,11.00,0.24
1266,0,15200380,27247,249.56,139221.62,2,15200380,0,15200380,27247,249.56,109.97,139221.62,0,10.77,11.00,0.12
1267,0,15222653,22273,204.00,139425.62,2,15222653,0,15222653,22273,204.00,110.04,139425.62,1,9.17,10.04,0.19
1268,0,15240230,17577,160.99,139586.61,2,15245815,5585,15240230,17577,160.99,110.08,139586.61,0,10.52,9.52,0.08
1269,0,15250321,10091,92.42,139679.03,2,15255106,4785,15250321,10091,92.42,110.07,139679.03,1,9.47,10.11,0.16
1270,0,15270629,20308,186.00,139865.03,2,15275019,4390,15270629,20308,186.00,110.13,139865.03,0,10.76,9.76,0.08
1271,0,15282201,11572,105.99,139971.03,2,15285188,2987,15282201,11572,105.99,110.13,139971.03,1,9.88,10.52,0.16
1272,0,15313625,31424,287.82,140258.84,2,15313721,96,15313625,31424,287.82,110.27,140258.84,0,10.55,9.55,0.08
1273,0,15328742,15117,138.46,140397.30,2,15328742,0,15328742,15117,138.46,110.29,140397.30,1,8.40,9.83,0.16
1274,0,15345734,16992,155.63,140552.94,2,15351820,6086,15345734,16992,155.63,110.32,140552.94,0,10.98,9.98,0.08
1275,0,15357316,11582,106.08,140659.02,2,15361101,3785,15357316,11582,106.08,110.32,140659.02,1,10.21,11.12,0.16
1276,0,15375798,18482,169.28,140828.28,2,15380814,5016,15375798,18482,169.28,110.37,140828.28,0,11.67,10.67,0.08
1277,0,15388082,12284,112.51,140940.80,2,15391062,2980,15388082,12284,112.51,110.37,140940.80,1,9.81,10.91,0.16
1278,0,15409464,21382,195.84,141136.64,2,15412986,3522,15409464,21382,195.84,110.44,141136.64,0,11.45,10.45,0.08
1279,0,15409464,0,0.00,141136.64,2,15421827,12363,15409464,0,0.00,110.35,141136.64,0,11.93,10.93,0.16
1280,0,15412050,2586,23.69,141160.33,2,15426754,14704,15412050,2586,23.69,110.28,141160.33,1,10.40,11.50,0.23
1281,0,15423018,10968,100.46,141260.78,2,15432238,9220,15423018,10968,100.46,110.27,141260.78,0,11.00,11.50,0.10
1282,0,15438545,15527,142.21,141403.00,2,15441689,3144,15438545,15527,142.21,110.30,141403.00,1,9.59,10.68,0.17
1283,0,15454024,15479,141.77,141544.77,2,15459927,5903,15454024,15479,141.77,110.32,141544.77,0,11.42,10.42,0.08
1284,0,15464197,10173,93.18,141637.94,2,15468887,4690,15464197,10173,93.18,110.31,141637.94,1,9.79,10.84,0.16
1285,0,15493782,29585,270.97,141908.92,2,15493782,0,15493782,29585,270.97,110.43,141908.92,0,10.16,10.84,0.08
1286,0,15523790,30008,274.85,142183.77,2,15523790,0,15523790,30008,274.85,110.56,142183.77,1,10.62,10.84,0.16
1287,0,15526310,2520,23.08,142206.84,2,15534509,8199,15526310,2520,23.08,110.49,142206.84,1,10.57,11.32,0.09
1288,0,15553070,26760,245.10,142451.94,2,15553070,0,15553070,26760,245.10,110.60,142451.94,0,11.27,11.32,0.08
1289,0,15555578,2508,22.97,142474.91,2,15563367,7789,15555578,2508,22.97,110.53,142474.91,1,9.85,10.71,0.16
1290,0,15565946,10368,94.96,142569.88,2,15573841,7895,15565946,10368,94.96,110.52,142569.88,0,11.11,10.11,0.08
1291,0,15568594,2648,24.25,142594.12,2,15580955,12361,15568594,2648,24.25,110.45,142594.12,1,10.13,10.88,0.16
1292,0,15583856,15262,139.79,142733.91,2,15588586,4730,15583856,15262,139.79,110.48,142733.91,0,10.15,10.88,0.08
1293,0,15606133,22277,204.04,142937.95,2,15606980,847,15606133,22277,204.04,110.55,142937.95,1,10.38,9.38,0.15
1294,0,15606133,0,0.00,142937.95,2,15617279,11146,15606133,0,0.00,110.46,142937.95,0,11.70,10.70,0.08
1295,0,15617755,11622,106.45,143044.39,2,15624192,6437,15617755,11622,106.45,110.46,143044.39,1,10.72,10.90,0.15
1296,0,15641215,23460,214.87,143259.27,2,15643188,1973,15641215,23460,214.87,110.54,143259.27,0,11.39,10.39,0.08
1297,0,15650637,9422,86.30,143345.56,2,15653344,2707,15650637,9422,86.30,110.52,143345.56,1,10.70,11.46,0.15
1298,0,15675844,25207,230.87,143576.44,2,15678166,2322,15675844,25207,230.87,110.61,143576.44,0,11.65,10.65,0.08
1299,0,15675844,0,0.00,143576.44,2,15686947,11103,15675844,0,0.00,110.53,143576.44,0,12.02,11.02,0.15
1300,0,15682270,6426,58.86,143635.30,2,15693017,10747,15682270,6426,58.86,110.49,143635.30,1,11.05,11.45,0.23
1301,0,15694473,12203,111.77,143747.06,2,15702489,8016,15694473,12203,111.77,110.49,143747.06,0,11.75,10.75,0.16
1302,0,15707842,13369,122.45,143869.52,2,15711454,3612,15707842,13369,122.45,110.50,143869.52,1,10.61,10.86,0.24
1303,0,15709022,1180,10.81,143880.31,2,15719749,10727,15709022,1180,10.81,110.42,143880.31,0,11.50,10.50,0.11
1304,0,15723766,14744,135.04,144015.36,2,15727618,3852,15723766,14744,135.04,110.44,144015.36,1,9.50,10.51,0.19
1305,0,15754662,30896,282.98,144298.34,2,15754662,0,15754662,30896,282.98,110.57,144298.34,1,9.63,10.51,0.08
1306,0,15781775,27113,248.33,144546.67,2,15783421,1646,15781775,27113,248.33,110.68,144546.67,0,10.96,9.96,0.08
1307,0,15798729,16954,155.28,144701.95,2,15798729,0,15798729,16954,155.28,110.71,144701.95,1,10.54,10.78,0.15
1308,0,15809610,10881,99.66,144801.61,2,15817082,7472,15809610,10881,99.66,110.70,144801.61,0,11.11,10.11,0.08
1309,0,15820414,10804,98.95,144900.56,2,15825599,5185,15820414,10804,98.95,110.70,144900.56,1,9.93,10.44,0.15
1310,0,15829737,9323,85.39,144985.95,2,15837854,8117,15829737,9323,85.39,110.68,144985.95,0,11.36,10.36,0.08
1311,0,15845945,16208,148.45,145134.41,2,15847222,1277,15845945,16208,148.45,110.71,145134.41,1,9.69,10.45,0.15
1312,0,15867538,21593,197.77,145332.17,2,15872149,4611,15867538,21593,197.77,110.77,145332.17,0,10.88,9.88,0.08
1313,0,15873854,6316,57.85,145390.03,2,15880491,6637,15873854,6316,57.85,110.73,145390.03,1,10.08,10.68,0.15
1314,0,15878326,4472,40.96,145430.98,2,15889905,11579,15878326,4472,40.96,110.68,145430.98,0,11.19,10.19,0.08
1315,0,15887022,8696,79.65,145510.64,2,15896439,9417,15887022,8696,79.65,110.65,145510.64,1,9.35,10.23,0.15
1316,0,15890707,3685,33.75,145544.39,2,15904022,13315,15890707,3685,33.75,110.60,145544.39,0,10.57,9.57,0.08
1317,0,15897042,6335,58.02,145602.41,2,15908740,11698,15897042,6335,58.02,110.56,145602.41,1,8.90,9.89,0.15
1318,0,15914574,17532,160.58,145762.98,2,15917506,2932,15914574,17532,160.58,110.59,145762.98,0,9.40,9.89,0.08
1319,0,15920759,6185,56.65,145819.64,2,15930264,9505,15920759,6185,56.65,110.55,145819.64,0,11.06,10.06,0.15
1320,0,15926409,5650,51.75,145871.39,2,15936788,10379,15926409,5650,51.75,110.51,145871.39,1,9.49,10.22,0.23
1321,0,15945285,18876,172.89,146044.27,2,15946226,941,15945285,18876,172.89,110.56,146044.27,0,9.54,10.22,0.13
1322,0,15969893,24608,225.39,146269.66,2,15969893,0,15969893,24608,225.39,110.64,146269.66,1,9.73,9.89,0.21
1323,0,15969893,0,0.00,146269.66,2,15980337,10444,15969893,0,0.00,110.56,146269.66,0,9.95,8.95,0.09
1324,0,15982474,12581,115.23,146384.89,2,15989223,6749,15982474,12581,115.23,110.56,146384.89,1,9.11,8.11,0.17
1325,0,15987195,4721,43.24,146428.12,2,15997155,9960,15987195,4721,43.24,110.51,146428.12,1,8.44,8.84,0.12
1326,0,16007411,20216,185.16,146613.28,2,16007411,0,16007411,20216,185.16,110.57,146613.28,0,9.11,9.99,0.08
1327,0,16040577,33166,303.77,146917.06,2,16040577,0,16040577,33166,303.77,110.71,146917.06,1,7.60,9.99,0.15
1328,0,16073147,32570,298.31,147215.38,2,16073147,0,16073147,32570,298.31,110.85,147215.38,0,9.81,9.99,0.08
1329,0,16081612,8465,77.53,147292.91,2,16086339,4727,16081612,8465,77.53,110.83,147292.91,1,9.73,8.73,0.15
1330,0,16081612,0,0.00,147292.91,2,16094832,13220,16081612,0,0.00,110.75,147292.91,0,10.65,9.65,0.09
1331,0,16090896,9284,85.03,147377.94,2,16100330,9434,16090896,9284,85.03,110.73,147377.94,1,9.00,9.65,0.17
1332,0,16106827,15931,145.91,147523.84,2,16111669,4842,16106827,15931,145.91,110.75,147523.84,0,9.85,8.85,0.09
1333,0,16117322,10495,96.12,147619.97,2,16121536,4214,16117322,10495,96.12,110.74,147619.97,1,8.51,9.14,0.16
1334,0,16138428,21106,193.31,147813.28,2,16142485,4057,16138428,21106,193.31,110.80,147813.28,0,10.01,9.01,0.08
1335,0,16148809,10381,95.08,147908.36,2,16153853,5044,16148809,10381,95.08,110.79,147908.36,1,10.03,9.03,0.15
1336,0,16148809,0,0.00,147908.36,2,16161680,12871,16148809,0,0.00,110.71,147908.36,0,11.60,10.60,0.09
1337,0,16149595,786,7.20,147915.56,2,16165960,16365,16149595,786,7.20,110.63,147915.56,1,9.47,10.83,0.16
1338,0,16159875,10280,94.16,148009.72,2,16171100,11225,16159875,10280,94.16,110.62,148009.72,0,9.47,10.83,0.07
1339,0,16179399,19524,178.82,148188.55,2,16180862,1463,16179399,19524,178.82,110.67,148188.55,0,10.71,10.83,0.15
1340,0,16179930,531,4.86,148193.41,2,16190782,10852,16179930,531,4.86,110.59,148193.41,1,10.29,10.76,0.22
1341,0,16196510,16580,151.86,148345.27,2,16199072,2562,16196510,16580,151.86,110.62,148345.27,0,10.49,10.76,0.17
1342,0,16215182,18672,171.02,148516.28,2,16216591,1409,16215182,18672,171.02,110.67,148516.28,1,9.73,10.09,0.25
1343,0,16215216,34,0.31,148516.59,2,16226229,11013,16215216,34,0.31,110.59,148516.59,0,10.72,9.72,0.15
1344,0,16216908,1692,15.50,148532.09,2,16231403,14495,16216908,1692,15.50,110.51,148532.09,1,8.60,9.72,0.22
1345,0,16230482,13574,124.33,148656.42,2,16238190,7708,16230482,13574,124.33,110.53,148656.42,0,9.50,9.72,0.11
1346,0,16254228,23746,217.49,148873.91,2,16256048,1820,16254228,23746,217.49,110.60,148873.91,1,9.77,8.77,0.19
1347,0,16256286,2058,18.85,148892.75,2,16265501,9215,16256286,2058,18.85,110.54,148892.75,1,8.18,9.11,0.19
1348,0,16281150,24864,227.73,149120.48,2,16281150,0,16281150,24864,227.73,110.62,149120.48,0,8.95,9.11,0.10
1349,0,16289213,8063,73.85,149194.34,2,16292682,3469,16289213,8063,73.85,110.60,149194.34,1,8.85,9.28,0.17
1350,0,16309151,19938,182.61,149376.95,2,16314149,4998,16309151,19938,182.61,110.65,149376.95,0,9.86,8.86,0.12
1351,0,16319198,10047,92.02,149468.97,2,16325738,6540,16319198,10047,92.02,110.64,149468.97,1,9.58,8.58,0.20
1352,0,16319198,0,0.00,149468.97,2,16333179,13981,16319198,0,0.00,110.55,149468.97,0,9.86,8.86,0.14
1353,0,16327386,8188,74.99,149543.97,2,16338646,11260,16327386,8188,74.99,110.53,149543.97,1,7.95,8.86,0.21
1354,0,16347905,20519,187.94,149731.91,2,16348906,1001,16347905,20519,187.94,110.58,149731.91,0,9.12,9.90,0.12
1355,0,16381670,33765,309.26,150041.16,2,16381670,0,16381670,33765,309.26,110.73,150041.16,1,8.49,8.94,0.19
1356,0,16390977,9307,85.24,150126.41,2,16396784,5807,16390977,9307,85.24,110.71,150126.41,1,8.56,8.82,0.10
1357,0,16421565,30588,280.16,150406.56,2,16421565,0,16421565,30588,280.16,110.84,150406.56,0,9.64,9.98,0.07
1358,0,16423376,1811,16.59,150423.14,2,16433537,10161,16423376,1811,16.59,110.77,150423.14,0,11.10,10.10,0.15
1359,0,16434864,11488,105.22,150528.38,2,16441351,6487,16434864,11488,105.22,110.76,150528.38,1,9.40,10.27,0.22
1360,0,16461809,26945,246.79,150775.16,2,16462769,960,16461809,26945,246.79,110.86,150775.16,0,10.53,9.53,0.13
1361,0,16461809,0,0.00,150775.16,2,16473057,11248,16461809,0,0.00,110.78,150775.16,0,11.17,10.17,0.21
1362,0,16478019,16210,148.47,150923.62,2,16481974,3955,16478019,16210,148.47,110.81,150923.62,1,8.45,10.17,0.28
1363,0,16509758,31739,290.70,151214.33,2,16509758,0,16509758,31739,290.70,110.94,151214.33,1,9.31,10.17,0.09
1364,0,16529630,19872,182.01,151396.34,2,16534913,5283,16529630,19872,182.01,110.99,151396.34,0,10.99,9.99,0.07
1365,0,16533385,3755,34.39,151430.73,2,16543513,10128,16533385,3755,34.39,110.94,151430.73,1,9.93,11.12,0.15
1366,0,16553680,20295,185.88,151616.61,2,16553680,0,16553680,20295,185.88,110.99,151616.61,0,10.76,11.12,0.07
1367,0,16562899,9219,84.44,151701.05,2,16566823,3924,16562899,9219,84.44,110.97,151701.05,1,9.76,10.58,0.15
1368,0,16593957,31058,284.46,151985.52,2,16593957,0,16593957,31058,284.46,111.10,151985.52,0,10.28,10.58,0.07
1369,0,16618178,24221,221.84,152207.36,2,16618178,0,16618178,24221,221.84,111.18,152207.36,1,10.06,10.25,0.15
1370,0,16618178,0,0.00,152207.36,2,16628965,10787,16618178,0,0.00,111.10,152207.36,0,11.71,10.71,0.07
1371,0,16629328,11150,102.12,152309.48,2,16636595,7267,16629328,11150,102.12,111.09,152309.48,1,10.46,11.00,0.15
1372,0,16634165,4837,44.30,152353.78,2,16645354,11189,16634165,4837,44.30,111.05,152353.78,0,11.70,10.70,0.07
1373,0,16636603,2438,22.33,152376.11,2,16650703,14100,16636603,2438,22.33,110.98,152376.11,1,9.66,11.32,0.15
1374,0,16651577,14974,137.15,152513.27,2,16658190,6613,16651577,14974,137.15,111.00,152513.27,0,9.69,11.32,0.07
1375,0,16681029,29452,269.75,152783.02,2,16681029,0,16681029,29452,269.75,111.11,152783.02,1,9.02,11.32,0.15
1376,0,16713209,32180,294.74,153077.75,2,16713209,0,16713209,32180,294.74,111.25,153077.75,0,10.69,11.32,0.07
1377,0,16724126,10917,99.99,153177.75,2,16727528,3402,16724126,10917,99.99,111.24,153177.75,1,10.14,10.95,0.15
1378,0,16755543,31417,287.75,153465.50,2,16755543,0,16755543,31417,287.75,111.37,153465.50,0,10.23,10.95,0.07
1379,0,16764774,9231,84.55,153550.05,2,16773121,8347,16764774,9231,84.55,111.35,153550.05,0,12.12,11.12,0.15
1380,0,16770788,6014,55.08,153605.12,2,16780402,9614,16770788,6014,55.08,111.31,153605.12,1,10.83,11.85,0.22
1381,0,16794557,23769,217.69,153822.81,2,16794557,0,16794557,23769,217.70,111.39,153822.81,0,11.04,11.85,0.11
1382,0,16824689,30132,275.98,154098.80,2,16824689,0,16824689,30132,275.98,111.50,154098.80,1,10.80,10.92,0.19
1383,0,16824689,0,0.00,154098.80,2,16835010,10321,16824689,0,0.00,111.42,154098.80,0,12.94,11.94,0.08
1384,0,16839569,14880,136.29,154235.09,2,16843481,3912,16839569,14880,136.29,111.44,154235.09,1,11.09,11.94,0.16
1385,0,16861278,21709,198.84,154433.94,2,16861424,146,16861278,21709,198.83,111.50,154433.94,1,11.34,11.37,0.07
1386,0,16861278,0,0.00,154433.94,2,16871709,10431,16861278,0,0.00,111.42,154433.94,0,13.01,12.01,0.07
1387,0,16866980,5702,52.23,154486.16,2,16877682,10702,16866980,5702,52.23,111.38,154486.16,1,11.50,12.30,0.14
1388,0,16887068,20088,183.99,154670.14,2,16887726,658,16887068,20088,183.99,111.43,154670.14,0,11.97,12.30,0.07
1389,0,16918429,31361,287.23,154957.38,2,16918429,0,16918429,31361,287.24,111.56,154957.38,1,10.50,12.30,0.14
1390,0,16940803,22374,204.94,155162.31,2,16944412,3609,16940803,22374,204.93,111.63,155162.31,0,13.11,12.11,0.07
1391,0,16948395,7592,69.54,155231.86,2,16954007,5612,16948395,7592,69.54,111.60,155231.86,1,11.78,13.25,0.14
1392,0,16977329,28934,264.99,155496.84,2,16977329,0,16977329,28934,265.01,111.71,155496.84,0,13.22,13.25,0.07
1393,0,16977329,0,0.00,155496.84,2,16988120,10791,16977329,0,0.00,111.63,155496.84,0,14.00,13.00,0.14
1394,0,16979341,2012,18.43,155515.27,2,16994050,14709,16979341,2012,18.43,111.56,155515.27,1,12.53,13.33,0.22
1395,0,16991557,12216,111.89,155627.16,2,17000158,8601,16991557,12216,111.89,111.56,155627.16,0,12.76,13.33,0.14
1396,0,17009204,17647,161.64,155788.80,2,17011495,2291,17009204,17647,161.63,111.60,155788.80,1,11.15,12.36,0.21
1397,0,17032452,23248,212.93,156001.73,2,17036222,3770,17032452,23248,212.93,111.67,156001.73,0,12.95,11.95,0.08
1398,0,17032696,244,2.23,156003.97,2,17044661,11965,17032696,244,2.23,111.59,156003.97,1,11.76,13.28,0.15
1399,0,17050282,17586,161.07,156165.03,2,17053454,3172,17050282,17586,161.07,111.63,156165.03,0,12.50,13.28,0.07
1400,0,17066158,15876,145.41,156310.44,2,17071460,5302,17066158,15876,145.41,111.65,156310.44,0,13.85,12.85,0.14
1401,0,17068597,2439,22.33,156332.78,2,17079737,11140,17068597,2439,22.34,111.59,156332.78,1,13.74,12.74,0.21
1402,0,17068597,0,0.00,156332.78,2,17085190,16593,17068597,0,0.00,111.51,156332.78,0,14.34,13.34,0.19
1403,0,17072025,3428,31.40,156364.17,2,17089037,17012,17072025,3428,31.40,111.45,156364.17,1,12.12,13.34,0.26
1404,0,17079917,7892,72.28,156436.45,2,17092983,13066,17079917,7892,72.28,111.42,156436.45,0,12.44,13.34,0.13
1405,0,17093595,13678,125.30,156561.75,2,17099822,6227,17093595,13678,125.28,111.43,156561.75,1,11.09,13.34,0.20
1406,0,17122521,28926,264.92,156826.67,2,17122521,0,17122521,28926,264.94,111.54,156826.67,1,10.97,13.34,0.14
1407,0,17153409,30888,282.91,157109.58,2,17153409,0,17153409,30888,282.91,111.66,157109.58,0,12.33,13.34,0.13
1408,0,17184586,31177,285.56,157395.14,2,17184586,0,17184586,31177,285.55,111.79,157395.14,1,11.86,13.34,0.20
1409,0,17215805,31219,285.93,157681.06,2,17215805,0,17215805,31219,285.94,111.91,157681.06,1,13.03,13.34,0.12
1410,0,17225124,9319,85.36,157766.42,2,17233106,7982,17225124,9319,85.35,111.89,157766.42,0,13.98,12.98,0.12
1411,0,17235454,10330,94.61,157861.05,2,17241633,6179,17235454,10330,94.61,111.88,157861.05,1,12.27,13.19,0.19
1412,0,17263253,27799,254.60,158115.64,2,17263253,0,17263253,27799,254.61,111.98,158115.64,1,12.17,13.19,0.09
1413,0,17276060,12807,117.31,158232.95,2,17282795,6735,17276060,12807,117.30,111.98,158232.95,0,14.19,13.19,0.07
1414,0,17276060,0,0.00,158232.95,2,17290196,14136,17276060,0,0.00,111.90,158232.95,0,15.10,14.10,0.14
1415,0,17285532,9472,86.75,158319.72,2,17295939,10407,17285532,9472,86.75,111.89,158319.72,1,13.43,14.10,0.21
1416,0,17293196,7664,70.20,158389.91,2,17304830,11634,17293196,7664,70.20,111.86,158389.91,0,14.95,13.95,0.10
1417,0,17302134,8938,81.86,158471.77,2,17311783,9649,17302134,8938,81.86,111.84,158471.77,1,13.43,14.01,0.17
1418,0,17307665,5531,50.65,158522.42,2,17319018,11353,17307665,5531,50.66,111.79,158522.42,0,14.65,13.65,0.07
1419,0,17307665,0,0.00,158522.42,2,17324121,16456,17307665,0,0.00,111.71,158522.42,0,15.27,14.27,0.14
1420,0,17311745,4080,37.37,158559.78,2,17327894,16149,17311745,4080,37.37,111.66,158559.78,1,13.80,14.56,0.21
1421,0,17321929,10184,93.28,158653.06,2,17332986,11057,17321929,10184,93.28,111.65,158653.06,0,14.49,14.56,0.12
1422,0,17332159,10230,93.72,158746.78,2,17339624,7465,17332159,10230,93.70,111.64,158746.78,1,12.72,13.58,0.19
1423,0,17356320,24161,221.28,158968.06,2,17356320,0,17356320,24161,221.29,111.71,158968.06,0,13.02,13.58,0.08
1424,0,17379912,23592,216.08,159184.14,2,17382891,2979,17379912,23592,216.08,111.79,159184.14,1,13.43,12.43,0.15
1425,0,17386818,6906,63.25,159247.41,2,17392393,5575,17386818,6906,63.25,111.75,159247.41,1,12.75,13.01,0.07
1426,0,17394298,7480,68.51,159315.91,2,17403466,9168,17394298,7480,68.51,111.72,159315.91,0,13.29,12.29,0.07
1427,0,17402380,8082,74.02,159389.94,2,17410694,8314,17402380,8082,74.02,111.70,159389.94,1,11.34,12.45,0.14
1428,0,17424651,22271,203.99,159593.92,2,17425530,879,17424651,22271,203.98,111.76,159593.92,0,12.55,11.55,0.07
1429,0,17451230,26579,243.43,159837.36,2,17451230,0,17451230,26579,243.44,111.85,159837.36,1,11.70,11.93,0.14
1430,0,17451230,0,0.00,159837.36,2,17461445,10215,17451230,0,0.00,111.77,159837.36,0,12.22,11.22,0.07
1431,0,17455460,4230,38.74,159876.09,2,17467643,12183,17455460,4230,38.74,111.72,159876.09,1,10.74,11.56,0.14
1432,0,17468050,12590,115.31,159991.41,2,17475526,7476,17468050,12590,115.31,111.73,159991.41,0,11.68,10.68,0.07
1433,0,17483166,15116,138.45,160129.86,2,17484811,1645,17483166,15116,138.45,111.74,160129.86,1,11.39,11.68,0.14
1434,0,17483431,265,2.44,160132.30,2,17494873,11442,17483431,265,2.43,111.67,160132.30,0,12.31,11.31,0.08
1435,0,17486977,3546,32.46,160164.75,2,17500525,13548,17486977,3546,32.48,111.61,160164.75,1,10.30,11.88,0.15
1436,0,17499981,13004,119.10,160283.86,2,17507027,7046,17499981,13004,119.10,111.62,160283.86,0,10.70,11.88,0.07
1437,0,17525787,25806,236.38,160520.23,2,17525787,0,17525787,25806,236.36,111.71,160520.23,1,9.41,11.88,0.14
1438,0,17557846,32059,293.62,160813.86,2,17557846,0,17557846,32059,293.63,111.83,160813.86,0,11.30,11.88,0.09
1439,0,17569592,11746,107.58,160921.44,2,17576762,7170,17569592,11746,107.58,111.83,160921.44,0,12.80,11.80,0.16
1440,0,17587211,17619,161.38,161082.83,2,17587340,129,17587211,17619,161.37,111.86,161082.83,1,10.74,11.90,0.23
1441,0,17619399,32188,294.81,161377.64,2,17619399,0,17619399,32188,294.81,111.99,161377.64,1,9.84,11.90,0.08
1442,0,17650337,30938,283.35,161660.98,2,17650337,0,17650337,30938,283.36,112.11,161660.98,0,11.69,11.90,0.07
1443,0,17662432,12095,110.79,161771.77,2,17662923,491,17662432,12095,110.78,112.11,161771.77,1,10.75,11.30,0.14
1444,0,17667184,4752,43.52,161815.30,2,17676285,9101,17667184,4752,43.52,112.06,161815.30,0,12.29,11.29,0.07
1445,0,17678528,11344,103.90,161919.20,2,17684437,5909,17678528,11344,103.90,112.05,161919.20,1,11.54,11.61,0.14
1446,0,17678528,0,0.00,161919.20,2,17692207,13679,17678528,0,0.00,111.98,161919.20,0,12.50,11.50,0.07
1447,0,17689578,11050,101.21,162020.41,2,17698364,8786,17689578,11050,101.21,111.97,162020.41,1,11.09,11.79,0.14
1448,0,17707268,17690,162.02,162182.42,2,17708754,1486,17707268,17690,162.02,112.00,162182.42,0,11.80,10.80,0.07
1449,0,17715187,7919,72.54,162254.97,2,17719535,4348,17715187,7919,72.53,111.98,162254.97,1,9.58,11.11,0.14
1450,0,17729036,13849,126.84,162381.80,2,17735119,6083,17729036,13849,126.84,111.99,162381.80,0,12.18,11.18,0.07
1451,0,17737832,8796,80.56,162462.36,2,17744071,6239,17737832,8796,80.56,111.97,162462.36,1,11.79,10.79,0.14
1452,0,17737832,0,0.00,162462.36,2,17751585,13753,17737832,0,0.00,111.89,162462.36,0,12.79,11.79,0.07
1453,0,17744890,7058,64.64,162527.02,2,17756632,11742,17744890,7058,64.64,111.86,162527.02,1,10.97,12.16,0.14
1454,0,17760878,15988,146.44,162673.45,2,17764626,3748,17760878,15988,146.44,111.88,162673.45,0,11.29,12.16,0.07
1455,0,17791089,30211,276.70,162950.14,2,17791089,0,17791089,30211,276.71,111.99,162950.14,0,11.43,12.16,0.14
1456,0,17806625,15536,142.30,163092.44,2,17809802,3177,17806625,15536,142.30,112.01,163092.44,1,10.42,11.78,0.21
1457,0,17837386,30761,281.75,163374.19,2,17837386,0,17837386,30761,281.74,112.13,163374.19,0,11.78,11.78,0.09
1458,0,17840060,2674,24.49,163398.69,2,17848928,8868,17840060,2674,24.49,112.07,163398.69,1,12.11,11.11,0.16
1459,0,17840060,0,0.00,163398.69,2,17855517,15457,17840060,0,0.00,111.99,163398.69,0,12.57,11.57,0.13
1460,0,17840060,0,0.00,163398.69,2,17859225,19165,17840060,0,0.00,111.92,163398.69,0,12.71,11.71,0.20
1461,0,17840784,724,6.63,163405.31,2,17862911,22127,17840784,724,6.63,111.84,163405.31,1,10.43,11.89,0.27
1462,0,17848166,7382,67.61,163472.92,2,17866602,18436,17848166,7382,67.61,111.81,163472.92,0,10.72,11.89,0.14
1463,0,17855908,7742,70.91,163543.83,2,17870473,14565,17855908,7742,70.91,111.79,163543.83,1,9.34,11.89,0.21
1464,0,17865300,9392,86.02,163629.86,2,17875169,9869,17865300,9392,86.02,111.77,163629.86,1,8.45,11.89,0.17
1465,0,17888438,23138,211.92,163841.78,2,17888438,0,17888438,23138,211.92,111.84,163841.78,0,9.08,11.89,0.13
1466,0,17920308,31870,291.90,164133.69,2,17920308,0,17920308,31870,291.90,111.96,164133.69,1,10.09,11.89,0.20
1467,0,17951161,30853,282.58,164416.25,2,17951161,0,17951161,30853,282.59,112.08,164416.25,1,10.55,11.89,0.14
1468,0,17982373,31212,285.87,164702.12,2,17982373,0,17982373,31212,285.87,112.19,164702.12,0,10.95,11.89,0.10
1469,0,18013974,31601,289.45,164991.58,2,18013974,0,18013974,31601,289.44,112.32,164991.58,1,10.63,11.89,0.17
1470,0,18045150,31176,285.54,165277.12,2,18045150,0,18045150,31176,285.54,112.43,165277.12,0,11.77,11.89,0.10
1471,0,18059942,14792,135.48,165412.59,2,18061378,1436,18059942,14792,135.48,112.45,165412.59,1,11.99,10.99,0.17
1472,0,18060204,262,2.40,165415.00,2,18071234,11030,18060204,262,2.40,112.37,165415.00,1,11.85,12.27,0.08
1473,0,18069620,9416,86.24,165501.23,2,18079887,10267,18069620,9416,86.24,112.36,165501.23,0,12.43,11.43,0.07
1474,0,18069620,0,0.00,165501.23,2,18084910,15290,18069620,0,0.00,112.28,165501.23,0,13.66,12.66,0.14
1475,0,18075027,5407,49.53,165550.78,2,18089075,14048,18075027,5407,49.52,112.24,165550.78,1,11.13,12.66,0.20
1476,0,18088867,13840,126.76,165677.53,2,18095995,7128,18088867,13840,126.76,112.25,165677.53,0,12.04,12.66,0.07
1477,0,18116135,27268,249.75,165927.28,2,18116135,0,18116135,27268,249.75,112.34,165927.28,1,12.19,12.66,0.14
1478,0,18120746,4611,42.22,165969.52,2,18129590,8844,18120746,4611,42.23,112.29,165969.52,0,13.86,12.86,0.07
1479,0,18121294,548,5.02,165974.53,2,18136066,14772,18121294,548,5.02,112.22,165974.53,1,11.34,13.48,0.14
1480,0,18134350,13056,119.58,166094.11,2,18142594,8244,18134350,13056,119.58,112.23,166094.11,0,12.49,13.48,0.07
1481,0,18156824,22474,205.84,166299.95,2,18156824,0,18156824,22474,205.84,112.29,166299.95,1,11.91,13.48,0.14
1482,0,18188242,31418,287.76,166587.72,2,18188242,0,18188242,31418,287.76,112.41,166587.72,0,12.40,13.48,0.08
1483,0,18218039,29797,272.92,166860.64,2,18218039,0,18218039,29797,272.91,112.52,166860.64,1,12.34,12.54,0.15
1484,0,18218039,0,0.00,166860.64,2,18228564,10525,18218039,0,0.00,112.44,166860.64,0,13.11,12.11,0.07
1485,0,18221979,3940,36.09,166896.72,2,18234559,12580,18221979,3940,36.09,112.39,166896.72,1,11.24,12.74,0.13
1486,0,18237329,15350,140.57,167037.30,2,18242234,4905,18237329,15350,140.59,112.41,167037.30,0,12.11,12.74,0.07
1487,0,18265813,28484,260.89,167298.19,2,18265813,0,18265813,28484,260.89,112.51,167298.19,1,10.47,12.74,0.13
1488,0,18294016,28203,258.32,167556.50,2,18295443,1427,18294016,28203,258.31,112.61,167556.50,0,13.09,12.09,0.07
1489,0,18294016,0,0.00,167556.50,2,18305159,11143,18294016,0,0.00,112.53,167556.50,0,14.13,13.13,0.13
1490,0,18306598,12582,115.24,167671.75,2,18312350,5752,18306598,12582,115.24,112.53,167671.75,1,12.92,13.37,0.20
1491,0,18309897,3299,30.21,167701.95,2,18321225,11328,18309897,3299,30.22,112.48,167701.95,0,14.36,13.36,0.08
1492,0,18328009,18112,165.89,167867.84,2,18330285,2276,18328009,18112,165.89,112.51,167867.84,1,12.90,13.39,0.15
1493,0,18345709,17700,162.12,168029.95,2,18345709,0,18345709,17700,162.12,112.55,168029.95,1,11.92,12.56,0.07
1494,0,18355199,9490,86.94,168116.89,2,18362837,7638,18355199,9490,86.92,112.53,168116.89,0,12.92,11.92,0.07
1495,0,18366985,11786,107.93,168224.83,2,18371532,4547,18366985,11786,107.95,112.52,168224.83,1,12.48,11.48,0.13
1496,0,18366985,0,0.00,168224.83,2,18379471,12486,18366985,0,0.00,112.45,168224.83,0,13.70,12.70,0.07
1497,0,18371619,4634,42.46,168267.28,2,18384745,13126,18371619,4634,42.44,112.40,168267.28,1,12.14,13.18,0.14
1498,0,18382837,11218,102.73,168370.02,2,18392232,9395,18382837,11218,102.75,112.40,168370.02,0,13.30,12.30,0.07
1499,0,18383493,656,6.01,168376.03,2,18398510,15017,18383493,656,6.01,112.33,168376.03,1,12.17,12.67,0.13
1500,0,18394459,10966,100.46,168476.48,2,18403993,9534,18394459,10966,100.44,112.32,168476.48,0,12.39,12.67,0.09
1501,0,18412253,17794,162.96,168639.44,2,18412890,637,18412253,17794,162.98,112.35,168639.44,1,10.85,12.67,0.15
1502,0,18443331,31078,284.66,168924.11,2,18443331,0,18443331,31078,284.65,112.47,168924.11,0,12.15,12.67,0.08
1503,0,18471810,28479,260.83,169184.94,2,18472963,1153,18471810,28479,260.84,112.56,169184.94,1,12.70,11.70,0.15
1504,0,18471810,0,0.00,169184.94,2,18482950,11140,18471810,0,0.00,112.49,169184.94,0,13.95,12.95,0.12
1505,0,18482770,10960,100.38,169285.31,2,18490108,7338,18482770,10960,100.38,112.48,169285.31,1,11.96,12.95,0.19
1506,0,18508376,25606,234.53,169519.84,2,18508376,0,18508376,25606,234.53,112.56,169519.84,0,12.57,12.95,0.08
1507,0,18539001,30625,280.49,169800.33,2,18539001,0,18539001,30625,280.50,112.67,169800.33,1,11.04,12.95,0.14
1508,0,18569646,30645,280.69,170081.03,2,18569646,0,18569646,30645,280.68,112.79,170081.03,0,12.53,12.95,0.07
1509,0,18583177,13531,123.92,170204.95,2,18589265,6088,18583177,13531,123.93,112.79,170204.95,1,13.25,12.25,0.13
1510,0,18583177,0,0.00,170204.95,2,18596408,13231,18583177,0,0.00,112.72,170204.95,0,14.19,13.19,0.07
1511,0,18584451,1274,11.69,170216.64,2,18601379,16928,18584451,1274,11.67,112.65,170216.64,1,11.78,13.56,0.13
1512,0,18594145,9694,88.77,170305.41,2,18606226,12081,18594145,9694,88.79,112.64,170305.41,0,12.00,13.56,0.07
1513,0,18609403,15258,139.77,170445.17,2,18613855,4452,18609403,15258,139.75,112.65,170445.17,1,10.93,13.56,0.13
1514,0,18639030,29627,271.35,170716.52,2,18639030,0,18639030,29627,271.36,112.76,170716.52,0,11.95,13.56,0.07
1515,0,18669393,30363,278.09,170994.61,2,18669393,0,18669393,30363,278.10,112.87,170994.61,1,11.71,13.56,0.13
1516,0,18692805,23412,214.43,171209.05,2,18696103,3298,18692805,23412,214.43,112.93,171209.05,0,14.07,13.07,0.07
1517,0,18692805,0,0.00,171209.05,2,18704453,11648,18692805,0,0.00,112.86,171209.05,0,14.85,13.85,0.13
1518,0,18710355,17550,160.76,171369.80,2,18713587,3232,18710355,17550,160.74,112.89,171369.80,1,13.85,14.14,0.20
1519,0,18710685,330,3.00,171372.80,2,18722299,11614,18710685,330,3.02,112.82,171372.80,0,14.83,13.83,0.10
1520,0,18710685,0,0.00,171372.80,2,18727332,16647,18710685,0,0.00,112.75,171372.80,0,14.99,13.99,0.17
1521,0,18714729,4044,37.04,171409.84,2,18731009,16280,18714729,4044,37.04,112.70,171409.84,1,13.02,14.06,0.23
1522,0,18724833,10104,92.54,171502.39,2,18736061,11228,18724833,10104,92.54,112.68,171502.39,0,13.41,14.06,0.15
1523,0,18743591,18758,171.82,171674.22,2,18745440,1849,18743591,18758,171.81,112.72,171674.22,1,11.78,14.06,0.21
1524,0,18774545,30954,283.49,171957.70,2,18774545,0,18774545,30954,283.51,112.83,171957.70,0,12.38,14.06,0.11
1525,0,18805154,30609,280.36,172238.06,2,18805154,0,18805154,30609,280.35,112.94,172238.06,1,13.96,14.06,0.18
1526,0,18807577,2423,22.18,172260.25,2,18815813,8236,18807577,2423,22.19,112.88,172260.25,1,14.91,13.91,0.12
1527,0,18807577,0,0.00,172260.25,2,18821917,14340,18807577,0,0.00,112.81,172260.25,0,15.31,14.31,0.09
1528,0,18811707,4130,37.85,172298.09,2,18826460,14753,18811707,4130,37.83,112.76,172298.09,1,13.69,14.49,0.15
1529,0,18823357,11650,106.69,172404.78,2,18832285,8928,18823357,11650,106.70,112.76,172404.78,0,14.07,14.49,0.08
1530,0,18848156,24799,227.15,172631.92,2,18848156,0,18848156,24799,227.14,112.83,172631.92,1,13.37,14.49,0.14
1531,0,18878200,30044,275.18,172907.09,2,18878200,0,18878200,30044,275.18,112.94,172907.09,1,12.88,14.49,0.11
1532,0,18909336,31136,285.18,173192.28,2,18909336,0,18909336,31136,285.18,113.05,173192.28,0,14.30,14.49,0.07
1533,0,18917569,8233,75.40,173267.67,2,18921683,4114,18917569,8233,75.41,113.03,173267.67,1,14.87,13.87,0.14
1534,0,18917569,0,0.00,173267.67,2,18930166,12597,18917569,0,0.00,112.95,173267.67,0,16.08,15.08,0.07
1535,0,18932382,14813,135.68,173403.36,2,18937894,5512,18932382,14813,135.67,112.97,173403.36,1,15.35,15.37,0.14
1536,0,18932382,0,0.00,173403.36,2,18945534,13152,18932382,0,0.00,112.89,173403.36,0,15.69,14.69,0.09
1537,0,18937988,5606,51.35,173454.70,2,18950102,12114,18937988,5606,51.35,112.85,173454.70,1,13.62,14.75,0.15
1538,0,18954674,16686,152.83,173607.53,2,18958445,3771,18954674,16686,152.83,112.88,173607.53,0,14.16,14.75,0.07
1539,0,18984494,29820,273.12,173880.66,2,18984494,0,18984494,29820,273.12,112.98,173880.66,0,14.49,14.75,0.13
1540,0,18997512,13018,119.23,173999.89,2,18997512,0,18997512,13018,119.23,112.99,173999.89,1,13.26,13.76,0.19
1541,0,19005238,7726,70.76,174070.66,2,19013319,8081,19005238,7726,70.76,112.96,174070.66,0,16.90,15.90,0.15
1542,0,19016192,10954,100.33,174170.98,2,19021768,5576,19016192,10954,100.33,112.95,174170.98,1,16.39,16.67,0.21
1543,0,19021334,5142,47.10,174218.08,2,19031790,10456,19021334,5142,47.10,112.91,174218.08,0,16.98,15.98,0.11
1544,0,19027534,6200,56.79,174274.86,2,19038485,10951,19027534,6200,56.79,112.87,174274.86,1,15.56,16.41,0.18
1545,0,19043800,16266,148.98,174423.84,2,19046618,2818,19043800,16266,148.98,112.90,174423.84,1,14.91,16.41,0.10
1546,0,19073647,29847,273.38,174697.22,2,19073647,0,19073647,29847,273.37,113.00,174697.22,0,15.47,16.41,0.07
1547,0,19088395,14748,135.08,174832.30,2,19091246,2851,19088395,14748,135.08,113.01,174832.30,1,15.37,15.97,0.13
1548,0,19104820,16425,150.43,174982.73,2,19110388,5568,19104820,16425,150.44,113.04,174982.73,0,16.84,15.84,0.06
1549,0,19117200,12380,113.39,175096.12,2,19120798,3598,19117200,12380,113.39,113.04,175096.12,1,16.28,15.28,0.13
1550,0,19117200,0,0.00,175096.12,2,19129768,12568,19117200,0,0.00,112.97,175096.12,0,16.89,15.89,0.07
1551,0,19122608,5408,49.53,175145.66,2,19135276,12668,19122608,5408,49.53,112.92,175145.66,1,14.85,15.89,0.14
1552,0,19135204,12596,115.37,175261.02,2,19141574,6370,19135204,12596,115.37,112.93,175261.02,0,15.15,15.89,0.06
1553,0,19162467,27263,249.71,175510.73,2,19162467,0,19162467,27263,249.70,113.01,175510.73,1,14.49,15.89,0.13
1554,0,19179987,17520,160.47,175671.20,2,19185671,5684,19179987,17520,160.47,113.04,175671.20,0,16.49,15.49,0.08
1555,0,19197462,17475,160.05,175831.25,2,19197462,0,19197462,17475,160.06,113.07,175831.25,1,15.35,15.93,0.14
1556,0,19203305,5843,53.51,175884.75,2,19212127,8822,19203305,5843,53.52,113.04,175884.75,0,16.94,15.94,0.06
1557,0,19214087,10782,98.77,175983.53,2,19220349,6262,19214087,10782,98.75,113.03,175983.53,1,15.26,16.08,0.13
1558,0,19243563,29476,269.97,176253.50,2,19243563,0,19243563,29476,269.97,113.13,176253.50,0,15.35,16.08,0.06
1559,0,19267167,23604,216.19,176469.69,2,19267167,0,19267167,23604,216.19,113.19,176469.69,1,15.10,15.48,0.13
1560,0,19268067,900,8.24,176477.94,2,19278054,9987,19268067,900,8.24,113.13,176477.94,0,16.74,15.74,0.06
1561,0,19274733,6666,61.04,176538.97,2,19284684,9951,19274733,6666,61.05,113.09,176538.97,1,15.78,16.32,0.13
1562,0,19295900,21167,193.88,176732.84,2,19295900,0,19295900,21167,193.87,113.15,176732.84,0,16.12,16.32,0.06
1563,0,19318568,22668,207.62,176940.47,2,19318864,296,19318568,22668,207.62,113.21,176940.47,1,16.26,15.26,0.13
1564,0,19318568,0,0.00,176940.47,2,19329195,10627,19318568,0,0.00,113.13,176940.47,0,17.23,16.23,0.06
1565,0,19326543,7975,73.05,177013.52,2,19335682,9139,19326543,7975,73.04,113.11,177013.52,1,15.73,16.40,0.13
1566,0,19346206,19663,180.09,177193.61,2,19347861,1655,19346206,19663,180.10,113.15,177193.61,0,16.65,15.65,0.06
1567,0,19358352,12146,111.25,177304.86,2,19362740,4388,19358352,12146,111.25,113.15,177304.86,1,16.23,15.23,0.13
1568,0,19358352,0,0.00,177304.86,2,19370545,12193,19358352,0,0.00,113.08,177304.86,0,16.91,15.91,0.06
1569,0,19364324,5972,54.70,177359.55,2,19375831,11507,19364324,5972,54.70,113.04,177359.55,1,14.63,15.91,0.13
1570,0,19382874,18550,169.90,177529.45,2,19385106,2232,19382874,18550,169.90,113.08,177529.45,0,14.86,15.91,0.06
1571,0,19413790,30916,283.16,177812.61,2,19413790,0,19413790,30916,283.16,113.18,177812.61,1,15.24,15.91,0.13
1572,0,19423346,9556,87.52,177900.14,2,19431010,7664,19423346,9556,87.52,113.17,177900.14,0,17.08,16.08,0.07
1573,0,19427736,4390,40.21,177940.34,2,19438054,10318,19427736,4390,40.21,113.12,177940.34,1,15.16,16.73,0.13
1574,0,19449870,22134,202.73,178143.08,2,19449870,0,19449870,22134,202.73,113.18,178143.08,0,15.69,16.73,0.06
1575,0,19472811,22941,210.13,178353.20,2,19472811,0,19472811,22941,210.12,113.24,178353.20,1,15.77,15.99,0.13
1576,0,19487408,14597,133.69,178486.89,2,19493308,5900,19487408,14597,133.70,113.25,178486.89,0,16.48,15.48,0.09
1577,0,19487494,86,0.79,178487.67,2,19501064,13570,19487494,86,0.79,113.18,178487.67,1,14.79,16.17,0.15
1578,0,19502292,14798,135.54,178623.22,2,19508463,6171,19502292,14798,135.54,113.20,178623.22,0,15.00,16.17,0.06
1579,0,19527838,25546,233.98,178857.19,2,19529243,1405,19527838,25546,233.98,113.27,178857.19,0,16.53,15.53,0.13
1580,0,19527838,0,0.00,178857.19,2,19538320,10482,19527838,0,0.00,113.20,178857.19,0,18.09,17.09,0.19
1581,0,19543060,15222,139.42,178996.61,2,19546842,3782,19543060,15222,139.42,113.22,178996.61,1,16.71,17.09,0.25
1582,0,19555585,12525,114.71,179111.31,2,19561073,5488,19555585,12525,114.72,113.22,179111.31,1,15.72,16.40,0.19
1583,0,19583625,28040,256.82,179368.14,2,19583625,0,19583625,28040,256.82,113.31,179368.14,0,16.27,16.40,0.13
1584,0,19587577,3952,36.20,179404.33,2,19593789,6212,19587577,3952,36.20,113.26,179404.33,1,16.60,17.38,0.19
1585,0,19604348,16771,153.62,179557.95,2,19608715,4367,19604348,16771,153.61,113.29,179557.95,1,16.77,15.77,0.09
1586,0,19604348,0,0.00,179557.95,2,19617146,12798,19604348,0,0.00,113.21,179557.95,0,17.41,16.41,0.09
1587,0,19608992,4644,42.53,179600.48,2,19621968,12976,19608992,4644,42.53,113.17,179600.48,1,16.12,16.51,0.16
1588,0,19619109,10117,92.65,179693.14,2,19628820,9711,19619109,10117,92.66,113.16,179693.14,0,16.63,15.63,0.11
1589,0,19634845,15736,144.13,179837.27,2,19637727,2882,19634845,15736,144.13,113.18,179837.27,1,15.23,15.72,0.17
1590,0,19646734,11889,108.90,179946.17,2,19653506,6772,19646734,11889,108.89,113.17,179946.17,0,16.59,15.59,0.11
1591,0,19662922,16188,148.27,180094.44,2,19663820,898,19662922,16188,148.27,113.20,180094.44,1,15.16,15.70,0.17
1592,0,19672912,9990,91.50,180185.94,2,19681065,8153,19672912,9990,91.50,113.18,180185.94,0,16.87,15.87,0.08
1593,0,19682936,10024,91.81,180277.75,2,19688847,5911,19682936,10024,91.81,113.17,180277.75,1,15.68,16.67,0.15
1594,0,19702056,19120,175.12,180452.88,2,19706638,4582,19702056,19120,175.12,113.21,180452.88,0,16.91,15.91,0.06
1595,0,19724319,22263,203.92,180656.78,2,19724319,0,19724319,22263,203.91,113.26,180656.78,1,15.70,16.23,0.13
1596,0,19731530,7211,66.04,180722.83,2,19740225,8695,19731530,7211,66.05,113.23,180722.83,0,16.43,15.43,0.06
1597,0,19734108,2578,23.61,180746.44,2,19746488,12380,19734108,2578,23.61,113.18,180746.44,1,14.33,16.04,0.13
1598,0,19751952,17844,163.43,180909.88,2,19755410,3458,19751952,17844,163.43,113.21,180909.88,0,14.92,16.04,0.06
1599,0,19779851,27899,255.54,181165.41,2,19782349,2498,19779851,27899,255.53,113.30,181165.41,0,16.37,15.37,0.13
1600,0,19784556,4705,43.08,181208.48,2,19791751,7195,19784556,4705,43.09,113.26,181208.48,1,15.58,16.34,0.19
1601,0,19810727,26171,239.71,181448.20,2,19810727,0,19810727,26171,239.70,113.33,181448.20,0,16.31,16.34,0.12
1602,0,19810727,0,0.00,181448.20,2,19820226,9499,19810727,0,0.00,113.26,181448.20,0,17.37,16.37,0.18
1603,0,19830995,20268,185.64,181633.84,2,19830995,0,19830995,20268,185.64,113.31,181633.84,1,15.58,16.58,0.24
1604,0,19849177,18182,166.51,181800.36,2,19851384,2207,19849177,18182,166.53,113.34,181800.36,1,15.55,16.35,0.14
1605,0,19875254,26077,238.85,182039.20,2,19878138,2884,19875254,26077,238.84,113.42,182039.20,0,16.52,15.52,0.07
1606,0,19882439,7185,65.82,182105.02,2,19889055,6616,19882439,7185,65.81,113.39,182105.02,1,16.18,16.73,0.13
1607,0,19913033,30594,280.19,182385.22,2,19913033,0,19913033,30594,280.21,113.49,182385.22,0,16.54,16.73,0.07
1608,0,19919037,6004,54.99,182440.20,2,19925805,6768,19919037,6004,54.99,113.46,182440.20,1,17.12,16.12,0.14
1609,0,19920067,1030,9.45,182449.66,2,19932980,12913,19920067,1030,9.43,113.39,182449.66,1,15.85,16.46,0.10
1610,0,19935521,15454,141.53,182591.19,2,19940707,5186,19935521,15454,141.54,113.41,182591.19,0,16.36,16.46,0.06
1611,0,19942899,7378,67.59,182658.78,2,19949371,6472,19942899,7378,67.58,113.38,182658.78,1,15.70,16.03,0.12
1612,0,19944515,1616,14.80,182673.58,2,19957630,13115,19944515,1616,14.80,113.32,182673.58,0,16.64,15.64,0.08
1613,0,19951040,6525,59.75,182733.33,2,19963193,12153,19951040,6525,59.76,113.29,182733.33,1,15.73,14.73,0.14
1614,0,19951040,0,0.00,182733.33,2,19968121,17081,19951040,0,0.00,113.22,182733.33,0,16.47,15.47,0.08
1615,0,19956338,5298,48.52,182781.86,2,19971569,15231,19956338,5298,48.52,113.18,182781.86,1,14.76,15.48,0.14
1616,0,19967600,11262,103.15,182885.02,2,19977200,9600,19967600,11262,103.15,113.17,182885.02,0,14.91,15.48,0.07
1617,0,19989641,22041,201.87,183086.88,2,19989641,0,19989641,22041,201.88,113.23,183086.88,1,13.62,15.48,0.14
1618,0,20022090,32449,297.21,183384.09,2,20022090,0,20022090,32449,297.20,113.34,183384.09,0,14.98,15.48,0.06
1619,0,20039548,17458,159.90,183543.98,2,20039548,0,20039548,17458,159.90,113.37,183543.98,1,14.50,14.52,0.12
1620,0,20039548,0,0.00,183543.98,2,20050628,11080,20039548,0,0.00,113.30,183543.98,0,15.62,14.62,0.08
1621,0,20048506,8958,82.05,183626.03,2,20057603,9097,20048506,8958,82.05,113.28,183626.03,1,13.58,14.92,0.14
1622,0,20072621,24115,220.86,183846.89,2,20072621,0,20072621,24115,220.87,113.35,183846.89,1,11.82,14.92,0.06
1623,0,20104989,32368,296.46,184143.36,2,20104989,0,20104989,32368,296.46,113.46,184143.36,0,13.31,14.92,0.06
1624,0,20124895,19906,182.34,184325.70,2,20130126,5231,20124895,19906,182.32,113.50,184325.70,0,15.57,14.57,0.12
1625,0,20141537,16642,152.41,184478.11,2,20141537,0,20141537,16642,152.43,113.52,184478.11,1,14.39,15.03,0.18
1626,0,20149922,8385,76.81,184554.91,2,20159190,9268,20149922,8385,76.80,113.50,184554.91,0,16.08,15.08,0.06
1627,0,20153786,3864,35.39,184590.30,2,20165630,11844,20153786,3864,35.39,113.45,184590.30,1,14.07,15.24,0.12
1628,0,20171988,18202,166.71,184757.02,2,20174731,2743,20171988,18202,166.71,113.49,184757.02,0,14.21,15.24,0.06
1629,0,20204502,32514,297.80,185054.81,2,20204502,0,20204502,32514,297.80,113.60,185054.81,1,13.14,15.24,0.12
1630,0,20229105,24603,225.33,185280.14,2,20232675,3570,20229105,24603,225.34,113.67,185280.14,0,15.61,14.61,0.06
1631,0,20236597,7492,68.62,185348.77,2,20243425,6828,20236597,7492,68.62,113.64,185348.77,1,15.13,14.13,0.12
1632,0,20236597,0,0.00,185348.77,2,20250998,14401,20236597,0,0.00,113.57,185348.77,0,15.49,14.49,0.06
1633,0,20247617,11020,100.93,185449.70,2,20256984,9367,20247617,11020,100.93,113.56,185449.70,1,13.63,14.49,0.12
1634,0,20257349,9732,89.14,185538.83,2,20265830,8481,20257349,9732,89.14,113.55,185538.83,0,14.87,13.87,0.06
1635,0,20262781,5432,49.75,185588.59,2,20273002,10221,20262781,5432,49.75,113.51,185588.59,1,12.89,14.68,0.12
1636,0,20284142,21361,195.66,185784.25,2,20284142,0,20284142,21361,195.65,113.56,185784.25,0,13.35,14.68,0.06
1637,0,20317011,32869,301.06,186085.30,2,20317011,0,20317011,32869,301.05,113.67,186085.30,1,12.26,14.68,0.12
1638,0,20341244,24233,221.94,186307.25,2,20344946,3702,20341244,24233,221.95,113.74,186307.25,0,15.22,14.22,0.06
1639,0,20341244,0,0.00,186307.25,2,20353737,12493,20341244,0,0.00,113.67,186307.25,0,16.12,15.12,0.12
1640,0,20345889,4645,42.53,186349.78,2,20359334,13445,20345889,4645,42.54,113.63,186349.78,1,13.97,15.12,0.19
1641,0,20360305,14416,132.04,186481.81,2,20366542,6237,20360305,14416,132.04,113.64,186481.81,0,14.01,15.12,0.10
1642,0,20391213,30908,283.09,186764.91,2,20391213,0,20391213,30908,283.09,113.74,186764.91,1,13.63,15.12,0.16
1643,0,20424094,32881,301.17,187066.08,2,20424094,0,20424094,32881,301.16,113.86,187066.08,0,15.01,15.12,0.08
1644,0,20439951,15857,145.24,187211.33,2,20444275,4324,20439951,15857,145.24,113.88,187211.33,1,15.22,14.22,0.14
1645,0,20440445,494,4.51,187215.83,2,20452458,12013,20440445,494,4.52,113.81,187215.83,1,15.38,15.66,0.07
1646,0,20449140,8695,79.65,187295.47,2,20459852,10712,20449140,8695,79.64,113.79,187295.47,0,16.08,15.08,0.06
1647,0,20455764,6624,60.67,187356.14,2,20466106,10342,20455764,6624,60.67,113.76,187356.14,1,15.11,15.24,0.12
1648,0,20459010,3246,29.73,187385.88,2,20473263,14253,20459010,3246,29.73,113.71,187385.88,0,15.54,14.54,0.07
1649,0,20465270,6260,57.34,187443.22,2,20478087,12817,20465270,6260,57.34,113.67,187443.22,1,13.79,14.61,0.13
1650,0,20479416,14146,129.56,187572.78,2,20485160,5744,20479416,14146,129.56,113.68,187572.78,0,13.94,14.61,0.06
1651,0,20508578,29162,267.10,187839.88,2,20508578,0,20508578,29162,267.10,113.77,187839.88,1,13.31,14.61,0.12
1652,0,20541318,32740,299.87,188139.73,2,20541318,0,20541318,32740,299.87,113.89,188139.73,0,14.51,14.61,0.06
1653,0,20547401,6083,55.71,188195.45,2,20552344,4943,20547401,6083,55.71,113.85,188195.45,1,14.83,15.98,0.12
1654,0,20562036,14635,134.05,188329.50,2,20568475,6439,20562036,14635,134.04,113.86,188329.50,0,16.47,15.47,0.06
1655,0,20572894,10858,99.45,188428.95,2,20577831,4937,20572894,10858,99.45,113.85,188428.95,1,15.15,15.67,0.12
1656,0,20596963,24069,220.46,188649.41,2,20599679,2716,20596963,24069,220.45,113.92,188649.41,0,15.75,14.75,0.06
1657,0,20617300,20337,186.26,188835.67,2,20617300,0,20617300,20337,186.27,113.96,188835.67,1,14.03,15.14,0.12
1658,0,20625568,8268,75.73,188911.39,2,20634135,8567,20625568,8268,75.73,113.94,188911.39,0,16.56,15.56,0.06
1659,0,20625568,0,0.00,188911.39,2,20640672,15104,20625568,0,0.00,113.87,188911.39,0,17.61,16.61,0.12
1660,0,20625570,2,0.02,188911.41,2,20645114,19544,20625570,2,0.02,113.80,188911.41,1,15.71,17.19,0.18
1661,0,20634226,8656,79.28,188990.69,2,20649442,15216,20634226,8656,79.28,113.78,188990.69,0,16.32,17.19,0.07
1662,0,20643730,9504,87.05,189077.75,2,20654194,10464,20643730,9504,87.05,113.77,189077.75,1,14.89,17.19,0.13
1663,0,20665277,21547,197.34,189275.08,2,20665277,0,20665277,21547,197.35,113.82,189275.08,0,15.56,17.19,0.07
1664,0,20697356,32079,293.82,189568.91,2,20697356,0,20697356,32079,293.81,113.92,189568.91,1,14.64,17.19,0.13
1665,0,20729402,32046,293.51,189862.42,2,20729402,0,20729402,32046,293.51,114.03,189862.42,1,15.15,17.19,0.06
1666,0,20762202,32800,300.42,190162.84,2,20762202,0,20762202,32800,300.42,114.14,190162.84,0,16.61,17.19,0.06
1667,0,20773806,11604,106.28,190269.12,2,20778610,4804,20773806,11604,106.28,114.14,190269.12,1,16.83,15.83,0.12
1668,0,20773806,0,0.00,190269.12,2,20786846,13040,20773806,0,0.00,114.07,190269.12,0,16.99,15.99,0.08
1669,0,20788133,14327,131.21,190400.33,2,20794573,6440,20788133,14327,131.22,114.08,190400.33,1,15.82,16.00,0.14
1670,0,20788359,226,2.09,190402.42,2,20801938,13579,20788359,226,2.07,114.01,190402.42,0,16.33,15.33,0.10
1671,0,20796919,8560,78.40,190480.83,2,20807404,10485,20796919,8560,78.40,113.99,190480.83,1,14.03,15.45,0.16
1672,0,20819176,22257,203.84,190684.67,2,20819176,0,20819176,22257,203.85,114.05,190684.67,0,14.11,15.45,0.06
1673,0,20853069,33893,310.42,190995.09,2,20853069,0,20853069,33893,310.43,114.16,190995.09,1,15.15,15.45,0.12
1674,0,20853069,0,0.00,190995.09,2,20863858,10789,20853069,0,0.00,114.10,190995.09,0,16.53,15.53,0.06
1675,0,20855553,2484,22.75,191017.84,2,20869509,13956,20855553,2484,22.75,114.04,191017.84,1,15.05,16.36,0.12
1676,0,20865099,9546,87.45,191105.30,2,20876248,11149,20865099,9546,87.43,114.02,191105.30,0,16.95,15.95,0.06
1677,0,20869800,4701,43.05,191148.34,2,20881563,11763,20869800,4701,43.06,113.98,191148.34,1,15.47,16.18,0.12
1678,0,20888136,18336,167.94,191316.28,2,20890938,2802,20888136,18336,167.94,114.01,191316.28,0,16.29,15.29,0.06
1679,0,20888136,0,0.00,191316.28,2,20899576,11440,20888136,0,0.00,113.95,191316.28,0,16.97,15.97,0.12
1680,0,20888136,0,0.00,191316.28,2,20904744,16608,20888136,0,0.00,113.88,191316.28,0,17.16,16.16,0.18
1681,0,20894562,6426,58.86,191375.14,2,20908695,14133,20894562,6426,58.86,113.85,191375.14,1,14.84,16.16,0.24
1682,0,20907908,13346,122.24,191497.38,2,20915368,7460,20907908,13346,122.24,113.85,191497.38,0,15.05,16.16,0.13
1683,0,20932475,24567,225.02,191722.39,2,20932475,0,20932475,24567,225.01,113.92,191722.39,1,14.19,16.16,0.19
1684,0,20960740,28265,258.87,191981.27,2,20960740,0,20960740,28265,258.88,114.00,191981.27,0,15.98,16.16,0.10
1685,0,20979026,18286,167.48,192148.75,2,20979026,0,20979026,18286,167.48,114.03,192148.75,1,14.98,15.72,0.16
1686,0,21012599,33573,307.51,192456.25,2,21012599,0,21012599,33573,307.50,114.15,192456.25,1,14.52,15.72,0.06
1687,0,21034411,21812,199.78,192656.03,2,21039014,4603,21034411,21812,199.78,114.20,192656.03,0,15.91,14.91,0.06
1688,0,21041825,7414,67.89,192723.92,2,21048456,6631,21041825,7414,67.91,114.17,192723.92,1,15.01,15.32,0.12
1689,0,21055664,13839,126.76,192850.69,2,21061318,5654,21055664,13839,126.75,114.18,192850.69,0,15.32,14.32,0.09
1690,0,21065384,9720,89.03,192939.70,2,21070554,5170,21065384,9720,89.03,114.17,192939.70,1,13.99,14.45,0.14
1691,0,21066244,860,7.88,192947.58,2,21079243,12999,21066244,860,7.88,114.10,192947.58,0,16.04,15.04,0.08
1692,0,21073466,7222,66.15,193013.73,2,21086508,13042,21073466,7222,66.15,114.07,193013.73,1,15.54,14.54,0.14
1693,0,21074696,1230,11.27,193025.00,2,21090932,16236,21074696,1230,11.27,114.01,193025.00,1,14.43,14.87,0.10
1694,0,21079277,4581,41.95,193066.95,2,21095587,16310,21079277,4581,41.96,113.97,193066.95,0,15.01,14.01,0.06
1695,0,21081487,2210,20.26,193087.20,2,21099204,17717,21081487,2210,20.24,113.92,193087.20,1,13.89,14.34,0.12
1696,0,21090239,8752,80.16,193167.36,2,21103580,13341,21090239,8752,80.16,113.90,193167.36,0,14.19,14.34,0.06
1697,0,21099719,9480,86.83,193254.19,2,21109639,9920,21099719,9480,86.83,113.88,193254.19,1,13.54,13.56,0.12
1698,0,21099719,0,0.00,193254.19,2,21115573,15854,21099719,0,0.00,113.81,193254.19,0,14.56,13.56,0.07
1699,0,21099719,0,0.00,193254.19,2,21119204,19485,21099719,0,0.00,113.75,193254.19,0,14.85,13.85,0.13
1700,0,21105059,5340,48.91,193303.11,2,21122214,17155,21105059,5340,48.91,113.71,193303.11,1,13.27,13.85,0.19
1701,0,21114059,9000,82.43,193385.53,2,21126714,12655,21114059,9000,82.43,113.69,193385.53,1,12.50,13.85,0.11
1702,0,21130079,16020,146.73,193532.27,2,21134724,4645,21130079,16020,146.73,113.71,193532.27,0,12.87,13.85,0.07
1703,0,21161721,31642,289.79,193822.06,2,21161721,0,21161721,31642,289.81,113.81,193822.06,1,12.02,13.85,0.13
1704,0,21194985,33264,304.67,194126.72,2,21194985,0,21194985,33264,304.67,113.92,194126.72,0,13.52,13.85,0.07
1705,0,21214392,19407,177.76,194304.48,2,21214392,0,21214392,19407,177.75,113.96,194304.48,1,12.72,13.31,0.13
1706,0,21238467,24075,220.51,194525.00,2,21242528,4061,21238467,24075,220.51,114.02,194525.00,0,13.38,12.38,0.06
1707,0,21261582,23115,211.70,194736.70,2,21261582,0,21261582,23115,211.71,114.08,194736.70,1,12.50,12.59,0.12
1708,0,21261582,0,0.00,194736.70,2,21272842,11260,21261582,0,0.00,114.01,194736.70,0,13.81,12.81,0.06
1709,0,21267490,5908,54.11,194790.81,2,21279306,11816,21267490,5908,54.11,113.98,194790.81,1,11.77,13.11,0.12
1710,0,21282792,15302,140.15,194930.97,2,21286957,4165,21282792,15302,140.15,113.99,194930.97,0,12.64,13.11,0.06
1711,0,21303196,20404,186.88,195117.84,2,21308322,5126,21303196,20404,186.88,114.04,195117.84,1,13.72,12.72,0.12
1712,0,21303196,0,0.00,195117.84,2,21316504,13308,21303196,0,0.00,113.97,195117.84,0,13.90,12.90,0.07
1713,0,21308707,5511,50.48,195168.33,2,21322136,13429,21308707,5511,50.48,113.93,195168.33,1,12.37,13.47,0.13
1714,0,21322855,14148,129.58,195297.92,2,21329210,6355,21322855,14148,129.58,113.94,195297.92,1,11.86,13.47,0.06
1715,0,21351181,28326,259.42,195557.34,2,21352040,859,21351181,28326,259.44,114.03,195557.34,0,13.70,12.70,0.06
1716,0,21351181,0,0.00,195557.34,2,21362054,10873,21351181,0,0.00,113.96,195557.34,0,14.24,13.24,0.12
1717,0,21368641,17460,159.92,195717.25,2,21371072,2431,21368641,17460,159.92,113.99,195717.25,1,12.15,13.24,0.17
1718,0,21391954,23313,213.53,195930.80,2,21395788,3834,21391954,23313,213.53,114.05,195930.80,0,13.73,12.73,0.10
1719,0,21391954,0,0.00,195930.80,2,21404720,12766,21391954,0,0.00,113.98,195930.80,0,15.09,14.09,0.15
1720,0,21393606,1652,15.13,195945.92,2,21410084,16478,21393606,1652,15.13,113.92,195945.92,1,13.78,14.73,0.21
1721,0,21403538,9932,90.97,196036.89,2,21415207,11669,21403538,9932,90.97,113.91,196036.89,0,14.77,13.77,0.14
1722,0,21405779,2241,20.53,196057.42,2,21420057,14278,21405779,2241,20.53,113.85,196057.42,1,12.93,13.92,0.20
1723,0,21417201,11422,104.60,196162.02,2,21425768,8567,21417201,11422,104.62,113.85,196162.02,0,13.09,13.92,0.12
1724,0,21443296,26095,239.02,196401.03,2,21443296,0,21443296,26095,239.01,113.92,196401.03,1,11.98,13.92,0.18
1725,0,21475775,32479,297.49,196698.53,2,21475775,0,21475775,32479,297.48,114.03,196698.53,0,13.06,13.92,0.11
1726,0,21508141,32366,296.42,196994.95,2,21508141,0,21508141,32366,296.44,114.13,196994.95,1,13.52,13.92,0.17
1727,0,21511374,3233,29.62,197024.58,2,21521260,9886,21511374,3233,29.61,114.08,197024.58,0,15.24,14.24,0.15
1728,0,21522870,11496,105.29,197129.86,2,21528960,6090,21522870,11496,105.29,114.08,197129.86,1,14.15,14.27,0.21
1729,0,21532331,9461,86.66,197216.53,2,21540045,7714,21532331,9461,86.65,114.06,197216.53,0,14.83,13.83,0.16
1730,0,21547031,14700,134.64,197351.17,2,21549161,2130,21547031,14700,134.64,114.08,197351.17,1,13.04,13.92,0.21
1731,0,21571181,24150,221.17,197572.34,2,21572193,1012,21571181,24150,221.19,114.14,197572.34,1,12.90,13.38,0.15
1732,0,21573175,1994,18.28,197590.62,2,21583134,9959,21573175,1994,18.26,114.08,197590.62,0,15.24,14.24,0.11
1733,0,21581433,8258,75.62,197666.23,2,21590070,8637,21581433,8258,75.64,114.06,197666.23,1,14.38,14.43,0.17
1734,0,21581433,0,0.00,197666.23,2,21596576,15143,21581433,0,0.00,113.99,197666.23,0,15.33,14.33,0.12
1735,0,21586431,4998,45.80,197712.03,2,21600758,14327,21586431,4998,45.78,113.96,197712.03,1,13.98,14.33,0.18
1736,0,21593555,7124,65.25,197777.28,2,21605857,12302,21593555,7124,65.25,113.93,197777.28,0,14.88,13.88,0.13
1737,0,21604361,10806,98.95,197876.23,2,21612418,8057,21604361,10806,98.97,113.92,197876.23,1,13.36,13.97,0.18
1738,0,21628159,23798,217.99,198094.22,2,21630092,1933,21628159,23798,217.97,113.98,198094.22,0,14.25,13.25,0.12
1739,0,21628159,0,0.00,198094.22,2,21639614,11455,21628159,0,0.00,113.91,198094.22,0,15.52,14.52,0.18
1740,0,21628159,0,0.00,198094.22,2,21645249,17090,21628159,0,0.00,113.85,198094.22,0,15.71,14.71,0.24
1741,0,21636885,8726,79.90,198174.12,2,21650156,13271,21636885,8726,79.92,113.83,198174.12,1,13.83,14.71,0.29
1742,0,21650949,14064,128.81,198302.94,2,21657188,6239,21650949,14064,128.81,113.84,198302.94,1,13.56,14.71,0.21
1743,0,21677418,26469,242.44,198545.38,2,21679113,1695,21677418,26469,242.43,113.91,198545.38,0,14.73,13.73,0.18
1744,0,21694380,16962,155.36,198700.73,2,21694380,0,21694380,16962,155.36,113.93,198700.73,1,12.74,13.97,0.24
1745,0,21727299,32919,301.52,199002.25,2,21727299,0,21727299,32919,301.51,114.04,199002.25,1,13.15,13.97,0.15
1746,0,21744148,16849,154.31,199156.56,2,21750004,5856,21744148,16849,154.32,114.06,199156.56,0,14.82,13.82,0.15
1747,0,21753316,9168,83.97,199240.53,2,21759048,5732,21753316,9168,83.97,114.05,199240.53,1,14.51,14.65,0.21
1748,0,21759646,6330,57.98,199298.52,2,21769024,9378,21759646,6330,57.98,114.02,199298.52,0,14.95,13.95,0.16
1749,0,21775494,15848,145.15,199443.67,2,21778277,2783,21775494,15848,145.15,114.03,199443.67,1,13.70,14.01,0.22
1750,0,21788642,13148,120.42,199564.09,2,21796175,7533,21788642,13148,120.42,114.04,199564.09,0,14.27,13.27,0.16
1751,0,21812850,24208,221.72,199785.81,2,21812850,0,21812850,24208,221.72,114.10,199785.81,1,12.60,13.39,0.22
1752,0,21831731,18881,172.94,199958.75,2,21837148,5417,21831731,18881,172.93,114.13,199958.75,0,15.32,14.32,0.16
1753,0,21839837,8106,74.23,200032.98,2,21847126,7289,21839837,8106,74.24,114.11,200032.98,1,15.34,14.34,0.21
1754,0,21839837,0,0.00,200032.98,2,21854343,14506,21839837,0,0.00,114.04,200032.98,0,16.56,15.56,0.15
1755,0,21843515,3678,33.71,200066.69,2,21858231,14716,21843515,3678,33.69,114.00,200066.69,1,14.31,15.84,0.20
1756,0,21853515,10000,91.59,200158.28,2,21863231,9716,21853515,10000,91.59,113.99,200158.28,0,14.91,15.84,0.10
1757,0,21871993,18478,169.22,200327.50,2,21872470,477,21871993,18478,169.24,114.02,200327.50,1,13.91,15.84,0.15
1758,0,21900034,28041,256.84,200584.34,2,21900034,0,21900034,28041,256.83,114.10,200584.34,0,14.97,15.84,0.11
1759,0,21920323,20289,185.84,200770.17,2,21923703,3380,21920323,20289,185.83,114.14,200770.17,0,16.18,15.18,0.16
1760,0,21924729,4406,40.34,200810.52,2,21932387,7658,21924729,4406,40.35,114.10,200810.52,1,14.29,15.80,0.22
1761,0,21949094,24365,223.17,201033.69,2,21949094,0,21949094,24365,223.16,114.16,201033.69,0,15.26,15.80,0.10
1762,0,21978927,29833,273.25,201306.94,2,21978927,0,21978927,29833,273.24,114.25,201306.94,1,14.06,15.80,0.16
1763,0,22010959,32032,293.38,201600.33,2,22010959,0,22010959,32032,293.38,114.35,201600.33,0,15.48,15.80,0.11
1764,0,22025235,14276,130.76,201731.08,2,22031241,6006,22025235,14276,130.76,114.36,201731.08,1,15.61,14.61,0.16
1765,0,22026463,1228,11.25,201742.33,2,22039586,13123,22026463,1228,11.25,114.30,201742.33,1,15.46,15.93,0.09
1766,0,22038852,12389,113.46,201855.78,2,22047848,8996,22038852,12389,113.47,114.30,201855.78,0,16.39,15.39,0.06
1767,0,22042294,3442,31.53,201887.31,2,22053654,11360,22042294,3442,31.53,114.25,201887.31,1,15.01,15.87,0.11
1768,0,22061934,19640,179.88,202067.20,2,22063474,1540,22061934,19640,179.88,114.29,202067.20,0,15.43,15.87,0.06
1769,0,22077910,15976,146.33,202213.53,2,22077910,0,22077910,15976,146.33,114.31,202213.53,1,14.84,15.04,0.11
1770,0,22086318,8408,77.01,202290.53,2,22093707,7389,22086318,8408,77.01,114.29,202290.53,0,16.74,15.74,0.06
1771,0,22092008,5690,52.12,202342.64,2,22100993,8985,22092008,5690,52.12,114.25,202342.64,1,15.63,16.18,0.11
1772,0,22097366,5358,49.07,202391.72,2,22108716,11350,22097366,5358,49.07,114.22,202391.72,0,16.83,15.83,0.06
1773,0,22099988,2622,24.02,202415.73,2,22113126,13138,22099988,2622,24.02,114.17,202415.73,1,15.45,16.16,0.11
1774,0,22111132,11144,102.07,202517.81,2,22118698,7566,22111132,11144,102.07,114.16,202517.81,0,15.76,16.16,0.06
1775,0,22135483,24351,223.04,202740.84,2,22135483,0,22135483,24351,223.03,114.22,202740.84,1,13.97,16.16,0.11
1776,0,22163283,27800,254.62,202995.47,2,22163283,0,22163283,27800,254.62,114.30,202995.47,0,15.89,16.16,0.06
1777,0,22183044,19761,180.98,203176.45,2,22183459,415,22183044,19761,180.99,114.34,203176.45,1,15.44,14.44,0.11
1778,0,22183044,0,0.00,203176.45,2,22193833,10789,22183044,0,0.00,114.27,203176.45,0,16.95,15.95,0.06
1779,0,22189455,6411,58.73,203235.19,2,22200455,11000,22189455,6411,58.72,114.24,203235.19,1,15.25,15.95,0.11
1780,0,22208761,19306,176.81,203411.98,2,22210108,1347,22208761,19306,176.83,114.28,203411.98,0,15.59,15.95,0.06
1781,0,22239198,30437,278.78,203690.78,2,22239198,0,22239198,30437,278.78,114.37,203690.78,1,14.95,15.00,0.11
1782,0,22239578,380,3.48,203694.25,2,22249638,10060,22239578,380,3.48,114.31,203694.25,1,14.09,14.80,0.06
1783,0,22253118,13540,124.01,203818.27,2,22259601,6483,22253118,13540,124.01,114.31,203818.27,0,15.17,14.17,0.06
1784,0,22253118,0,0.00,203818.27,2,22267106,13988,22253118,0,0.00,114.25,203818.27,0,16.02,15.02,0.11
1785,0,22260424,7306,66.92,203885.19,2,22272212,11788,22260424,7306,66.92,114.22,203885.19,1,14.72,15.49,0.17
1786,0,22275302,14878,136.27,204021.45,2,22279651,4349,22275302,14878,136.27,114.23,204021.45,0,15.42,15.49,0.06
1787,0,22281408,6106,55.93,204077.38,2,22288129,6721,22281408,6106,55.93,114.20,204077.38,1,13.61,14.69,0.12
1788,0,22308145,26737,244.88,204322.25,2,22308145,0,22308145,26737,244.89,114.27,204322.25,0,13.93,14.69,0.06
1789,0,22328661,20516,187.91,204510.17,2,22330327,1666,22328661,20516,187.91,114.32,204510.17,1,13.71,12.71,0.11
1790,0,22328661,0,0.00,204510.17,2,22339789,11128,22328661,0,0.00,114.25,204510.17,0,15.04,14.04,0.06
1791,0,22328661,0,0.00,204510.17,2,22345728,17067,22328661,0,0.00,114.19,204510.17,0,15.92,14.92,0.11
1792,0,22337713,9052,82.91,204593.08,2,22350710,12997,22337713,9052,82.91,114.17,204593.08,1,12.91,14.92,0.17
1793,0,22350791,13078,119.80,204712.88,2,22357249,6458,22350791,13078,119.78,114.17,204712.88,1,11.62,14.92,0.06
1794,0,22379658,28867,264.39,204977.27,2,2